KlassementKey,BeginDateKey,EindeDateKey,TeamKey,Stand,AantalGespeeld,AantalGewonnen,AantalGelijk,AantalVerloren,DoelpuntenVoor,DoelpuntenTegen,DoelpuntenSaldo,PuntenVoor2ptn,PuntenTegen2ptn,PuntenVoor3ptn
1,127,133,28,14,16,5,3,8,13,23,-10,13,19,18
2,127,133,50,15,16,2,5,9,15,31,-16,9,23,11
3,127,133,43,5,16,7,5,4,29,19,10,19,13,26
4,127,133,34,7,16,7,3,6,30,35,-5,17,15,24
5,127,133,19,8,16,7,2,7,32,24,8,16,16,23
6,127,133,17,10,16,7,1,8,22,31,-9,15,17,22
7,127,133,41,3,16,7,8,1,23,16,7,22,10,29
8,127,133,49,1,16,9,4,3,29,15,14,22,10,31
9,127,133,7,2,16,9,2,5,28,21,7,20,12,29
10,127,133,4,9,16,6,5,5,28,20,8,17,15,23
11,127,133,21,13,16,5,3,8,26,28,-2,13,19,18
12,127,133,53,4,16,8,3,5,30,22,8,19,13,27
13,127,133,1,11,16,4,7,5,21,23,-2,15,17,19
14,127,133,18,12,16,4,7,5,15,22,-7,15,17,19
15,127,133,39,6,16,8,1,7,29,22,7,17,15,25
16,127,133,29,16,16,2,3,11,11,29,-18,7,25,9
17,610,728,39,8,30,10,6,14,36,39,-3,26,34,36
18,610,728,1,5,30,13,9,8,41,34,7,35,25,48
19,610,728,18,14,30,8,9,13,37,39,-2,25,35,33
20,610,728,53,11,30,8,11,11,32,36,-4,27,33,35
21,610,728,21,3,30,15,10,5,67,43,24,40,20,55
22,610,728,7,6,30,11,8,11,46,47,-1,30,30,41
23,610,728,4,7,30,11,7,12,41,48,-7,29,31,40
24,610,728,49,2,30,18,4,8,57,31,26,40,20,58
25,610,728,41,4,30,13,10,7,34,24,10,36,24,49
26,610,728,43,1,30,21,7,2,75,29,46,49,11,70
27,610,728,57,13,30,9,6,15,39,64,-25,24,36,33
28,610,728,34,16,30,6,5,19,25,62,-37,17,43,23
29,610,728,17,9,30,10,6,14,49,58,-9,26,34,36
30,610,728,19,15,30,8,8,14,43,61,-18,24,36,32
31,610,728,28,10,30,9,9,12,50,45,5,27,33,36
32,610,728,36,12,30,9,7,14,40,52,-12,25,35,34
33,813,826,28,6,11,5,2,4,21,15,6,12,10,17
34,813,826,36,11,11,4,2,5,13,16,-3,10,12,14
35,813,826,48,12,11,4,2,5,9,12,-3,10,12,14
36,813,826,43,1,11,5,4,2,19,12,7,14,8,19
37,813,826,57,7,11,5,2,4,18,16,2,12,10,17
38,813,826,41,2,11,6,0,5,17,13,4,12,10,18
39,813,826,17,4,11,5,3,3,14,15,-1,13,9,18
40,813,826,8,5,11,5,2,4,25,16,9,12,10,17
41,813,826,49,3,11,5,3,3,18,9,9,13,9,18
42,813,826,7,9,11,5,2,4,16,18,-2,12,10,17
43,813,826,21,10,11,5,1,5,16,22,-6,11,11,16
44,813,826,4,13,11,4,2,5,20,24,-4,10,12,14
45,813,826,53,14,11,3,3,5,10,12,-2,9,13,12
46,813,826,1,8,11,5,2,4,14,13,1,12,10,17
47,813,826,18,15,11,2,4,5,11,17,-6,8,14,10
48,813,826,39,16,11,2,2,7,11,22,-11,6,16,8
49,967,973,39,16,22,5,5,12,23,39,-16,15,29,20
50,967,973,1,6,22,10,5,7,29,24,5,25,19,35
51,967,973,18,15,22,5,5,12,19,30,-11,15,29,20
52,967,973,53,14,22,5,8,9,19,21,-2,18,26,23
53,967,973,21,2,22,13,1,8,40,34,6,27,17,40
54,967,973,7,4,22,11,2,9,35,32,3,24,20,35
55,967,973,4,5,22,11,2,9,43,42,1,24,20,35
56,967,973,49,1,22,13,4,5,33,17,16,30,14,43
57,967,973,17,3,22,11,3,8,32,30,2,25,19,36
58,967,973,8,12,22,8,3,11,33,34,-1,19,25,27
59,967,973,41,7,22,11,1,10,34,30,4,23,21,34
60,967,973,43,8,22,9,6,7,34,27,7,24,20,33
61,967,973,57,11,22,8,5,9,24,30,-6,21,23,29
62,967,973,36,9,22,9,4,9,29,31,-2,22,22,31
63,967,973,28,10,22,8,7,7,30,23,7,23,21,31
64,967,973,48,13,22,7,3,12,16,29,-13,17,27,24
65,1212,1218,36,6,15,8,3,4,24,17,7,19,11,27
66,1212,1218,48,10,15,4,4,7,12,21,-9,12,18,16
67,1212,1218,28,15,15,2,6,7,20,29,-9,10,20,12
68,1212,1218,43,1,15,11,3,1,45,12,33,25,5,36
69,1212,1218,57,11,15,4,3,8,12,25,-13,11,19,15
70,1212,1218,24,16,15,1,3,11,10,30,-20,5,25,6
71,1212,1218,8,3,15,8,5,2,22,15,7,21,9,29
72,1212,1218,17,12,15,3,6,6,18,19,-1,12,18,15
73,1212,1218,49,2,15,8,5,2,28,14,14,21,9,29
74,1212,1218,41,5,15,8,3,4,24,16,8,19,11,27
75,1212,1218,21,7,15,5,6,4,20,16,4,16,14,21
76,1212,1218,4,8,15,6,2,7,22,27,-5,14,16,20
77,1212,1218,7,14,15,2,7,6,15,26,-11,11,19,13
78,1212,1218,53,4,15,8,4,3,30,17,13,20,10,28
79,169,175,28,13,22,7,5,10,19,29,-10,19,25,26
80,169,175,50,16,22,2,7,13,20,45,-25,11,33,13
81,169,175,43,2,22,11,7,4,44,23,21,29,15,40
82,169,175,34,6,22,9,6,7,40,49,-9,24,20,33
83,169,175,41,4,22,9,10,3,33,19,14,28,16,37
84,169,175,49,1,22,12,7,3,44,22,22,31,13,43
85,169,175,19,7,22,10,2,10,43,35,8,22,22,32
86,169,175,17,9,22,8,5,9,28,37,-9,21,23,29
87,169,175,7,5,22,10,6,6,34,27,7,26,18,36
88,169,175,4,11,22,7,7,8,36,30,6,21,23,28
89,169,175,21,12,22,7,6,9,36,35,1,20,24,27
90,169,175,53,3,22,11,4,7,40,31,9,26,18,37
91,169,175,1,8,22,7,9,6,34,31,3,23,21,30
92,169,175,18,14,22,5,10,7,19,29,-10,20,24,25
93,169,175,39,10,22,9,1,12,31,38,-7,19,25,28
94,169,175,29,15,22,4,4,14,16,37,-21,12,32,16
95,218,224,29,15,26,5,5,16,21,44,-23,15,37,20
96,218,224,1,10,26,8,10,8,40,42,-2,26,26,34
97,218,224,18,14,26,5,12,9,22,38,-16,22,30,27
98,218,224,39,12,26,10,2,14,37,46,-9,22,30,32
99,218,224,53,5,26,11,5,10,40,35,5,27,25,38
100,218,224,7,4,26,12,7,7,40,32,8,31,21,43
101,218,224,21,9,26,9,7,10,41,39,2,25,27,34
102,218,224,4,13,26,8,8,10,41,36,5,24,28,32
103,218,224,19,6,26,11,4,11,46,38,8,26,26,37
104,218,224,17,11,26,9,6,11,37,46,-9,24,28,33
105,218,224,49,1,26,15,8,3,50,23,27,38,14,53
106,218,224,41,2,26,13,10,3,43,20,23,36,16,49
107,218,224,43,3,26,13,7,6,48,27,21,33,19,46
108,218,224,34,7,26,9,9,8,44,55,-11,27,25,36
109,218,224,28,8,26,10,5,11,27,32,-5,25,27,35
110,218,224,50,16,26,4,7,15,24,48,-24,15,37,19
111,540,560,36,9,24,8,6,10,29,37,-8,22,26,30
112,540,560,28,11,24,7,6,11,38,36,2,20,28,27
113,540,560,43,1,24,20,3,1,65,19,46,43,5,63
114,540,560,57,15,24,6,5,13,34,55,-21,17,31,23
115,540,560,34,16,24,5,5,14,21,45,-24,15,33,20
116,540,560,41,5,24,10,7,7,25,20,5,27,21,37
117,540,560,49,2,24,14,3,7,43,23,20,31,17,45
118,540,560,17,10,24,8,4,12,39,45,-6,20,28,28
119,540,560,19,14,24,6,7,11,33,49,-16,19,29,25
120,540,560,21,3,24,11,8,5,46,35,11,30,18,41
121,540,560,4,6,24,9,7,8,32,38,-6,25,23,34
122,540,560,7,7,24,8,8,8,36,36,0,24,24,32
123,540,560,53,12,24,6,9,9,25,32,-7,21,27,27
124,540,560,1,4,24,11,7,6,34,26,8,29,19,40
125,540,560,18,13,24,7,5,12,28,31,-3,19,29,26
126,540,560,39,8,24,9,4,11,30,31,-1,22,26,31
127,561,567,39,8,25,9,4,12,31,33,-2,22,28,31
128,561,567,1,4,25,11,7,7,35,28,7,29,21,40
129,561,567,18,13,25,7,5,13,28,33,-5,19,31,26
130,561,567,53,12,25,6,9,10,25,34,-9,21,29,27
131,561,567,21,3,25,12,8,5,48,36,12,32,18,44
132,561,567,4,6,25,10,7,8,34,38,-4,27,23,37
133,561,567,7,7,25,8,8,9,36,38,-2,24,26,32
134,561,567,17,9,25,9,4,12,41,46,-5,22,28,31
135,561,567,19,15,25,6,8,11,34,50,-16,20,30,26
136,561,567,49,2,25,14,3,8,44,25,19,31,19,45
137,561,567,41,5,25,11,7,7,27,20,7,29,21,40
138,561,567,43,1,25,21,3,1,67,19,48,45,5,66
139,561,567,57,14,25,7,5,13,36,56,-20,19,31,26
140,561,567,34,16,25,6,5,14,24,47,-23,17,33,23
141,561,567,36,10,25,8,6,11,31,40,-9,22,28,30
142,561,567,28,11,25,7,7,11,39,37,2,21,29,28
143,750,756,28,8,4,2,0,2,8,8,0,4,4,6
144,750,756,48,10,4,2,0,2,4,6,-2,4,4,6
145,750,756,36,12,4,1,1,2,5,5,0,3,5,4
146,750,756,43,2,4,2,2,0,7,3,4,6,2,8
147,750,756,57,5,4,2,1,1,7,6,1,5,3,7
148,750,756,41,7,4,2,0,2,9,7,2,4,4,6
149,750,756,49,13,4,1,1,2,3,4,-1,3,5,4
150,750,756,8,3,4,2,1,1,14,7,7,5,3,7
151,750,756,17,6,4,2,1,1,5,6,-1,5,3,7
152,750,756,4,1,4,3,0,1,11,7,4,6,2,9
153,750,756,21,4,4,2,1,1,8,7,1,5,3,7
154,750,756,7,11,4,2,0,2,7,10,-3,4,4,6
155,750,756,53,15,4,0,2,2,4,8,-4,2,6,2
156,750,756,1,9,4,2,0,2,3,3,0,4,4,6
157,750,756,18,14,4,1,1,2,2,6,-4,3,5,4
158,85,91,34,3,10,6,1,3,22,22,0,13,7,19
159,85,91,43,4,10,5,3,2,26,12,14,13,7,18
160,85,91,28,14,10,2,2,6,7,18,-11,6,14,8
161,85,91,50,16,10,1,2,7,8,23,-15,4,16,5
162,85,91,17,8,10,5,0,5,13,20,-7,10,10,15
163,85,91,19,10,10,4,2,4,18,14,4,10,10,14
164,85,91,49,1,10,7,2,1,20,7,13,16,4,23
165,85,91,41,2,10,6,3,1,14,8,6,15,5,21
166,85,91,7,5,10,5,2,3,19,17,2,12,8,17
167,85,91,4,11,10,4,2,4,17,13,4,10,10,14
168,85,91,21,13,10,2,2,6,16,20,-4,6,14,8
169,85,91,53,6,10,5,1,4,20,15,5,11,9,16
170,85,91,18,9,10,4,3,3,12,13,-1,11,9,15
171,85,91,1,12,10,2,5,3,12,15,-3,9,11,11
172,85,91,39,7,10,5,0,5,17,13,4,10,10,15
173,85,91,29,15,10,1,2,7,7,18,-11,4,16,5
174,8,14,29,11,2,0,1,1,2,3,-1,1,3,1
175,8,14,39,3,2,2,0,0,5,1,4,4,0,6
176,8,14,7,4,2,2,0,0,5,3,2,4,0,6
177,8,14,4,7,2,1,0,1,4,2,2,2,2,3
178,8,14,21,13,2,0,0,2,4,6,-2,0,4,0
179,8,14,53,9,2,1,0,1,1,3,-2,2,2,3
180,8,14,41,4,2,2,0,0,5,3,2,4,0,6
181,8,14,49,2,2,2,0,0,5,0,5,4,0,6
182,8,14,50,14,2,0,0,2,1,4,-3,0,4,0
183,8,14,28,15,2,0,0,2,0,5,-5,0,4,0
184,8,14,19,1,2,2,0,0,8,1,7,4,0,6
185,8,14,17,10,2,1,0,1,1,5,-4,2,2,3
186,8,14,43,6,2,1,0,1,9,3,6,2,2,3
187,8,14,34,8,2,1,0,1,3,5,-2,2,2,3
188,8,14,1,11,2,0,1,1,2,3,-1,1,3,1
189,8,14,18,16,2,0,0,2,0,8,-8,0,4,0
190,162,168,1,8,21,7,8,6,32,29,3,22,20,29
191,162,168,18,14,21,4,10,7,18,29,-11,18,24,22
192,162,168,43,2,21,11,6,4,43,22,21,28,14,39
193,162,168,34,7,21,9,5,7,38,47,-9,23,19,32
194,162,168,28,13,21,7,5,9,19,28,-9,19,23,26
195,162,168,50,16,21,2,6,13,18,43,-25,10,32,12
196,162,168,49,1,21,12,6,3,43,21,22,30,12,42
197,162,168,19,6,21,10,2,9,43,33,10,22,20,32
198,162,168,17,10,21,8,4,9,27,36,-9,20,22,28
199,162,168,41,5,21,8,10,3,32,19,13,26,16,34
200,162,168,53,4,21,10,4,7,38,30,8,24,18,34
201,162,168,7,3,21,10,6,5,33,25,8,26,16,36
202,162,168,4,11,21,7,6,8,35,29,6,20,22,27
203,162,168,21,12,21,7,5,9,34,33,1,19,23,26
204,162,168,39,9,21,9,1,11,31,37,-6,19,23,28
205,162,168,29,15,21,3,4,14,14,37,-23,10,32,13
206,225,231,29,15,27,5,5,17,23,47,-24,15,39,20
207,225,231,39,13,27,10,2,15,37,49,-12,22,32,32
208,225,231,1,11,27,8,10,9,41,46,-5,26,28,34
209,225,231,18,14,27,6,12,9,24,38,-14,24,30,30
210,225,231,7,4,27,12,7,8,40,35,5,31,23,43
211,225,231,4,9,27,9,8,10,45,37,8,26,28,35
212,225,231,21,10,27,9,7,11,41,41,0,25,29,34
213,225,231,53,5,27,12,5,10,43,37,6,29,25,41
214,225,231,41,2,27,14,10,3,44,20,24,38,16,52
215,225,231,19,6,27,12,4,11,47,38,9,28,26,40
216,225,231,17,12,27,9,6,12,37,52,-15,24,30,33
217,225,231,49,1,27,16,8,3,56,23,33,40,14,56
218,225,231,28,7,27,11,5,11,30,32,-2,27,27,38
219,225,231,50,16,27,4,7,16,24,49,-25,15,39,19
220,225,231,43,3,27,14,7,6,51,27,24,35,19,49
221,225,231,34,8,27,9,9,9,44,56,-12,27,27,36
222,22,35,43,4,4,2,1,1,12,4,8,5,3,7
223,22,35,34,5,4,2,1,1,7,5,2,5,3,7
224,22,35,19,6,4,2,0,2,9,5,4,4,4,6
225,22,35,17,13,4,1,0,3,4,12,-8,2,6,3
226,22,35,28,12,4,1,0,3,2,8,-6,2,6,3
227,22,35,50,16,4,0,1,3,2,9,-7,1,7,1
228,22,35,49,3,4,3,1,0,8,0,8,7,1,10
229,22,35,41,2,4,4,0,0,8,4,4,8,0,12
230,22,35,53,9,4,2,0,2,5,7,-2,4,4,6
231,22,35,7,1,4,4,0,0,12,7,5,8,0,12
232,22,35,4,7,4,2,0,2,8,5,3,4,4,6
233,22,35,21,10,4,1,1,2,5,6,-1,3,5,4
234,22,35,18,11,4,1,1,2,4,9,-5,3,5,4
235,22,35,1,14,4,0,3,1,3,4,-1,3,5,3
236,22,35,39,8,4,2,0,2,6,4,2,4,4,6
237,22,35,29,15,4,0,1,3,2,8,-6,1,7,1
238,36,42,29,15,5,0,1,4,2,10,-8,1,9,1
239,120,126,19,7,15,7,2,6,31,21,10,16,14,23
240,120,126,17,10,15,6,1,8,19,30,-11,13,17,19
241,120,126,41,2,15,7,7,1,22,15,7,21,9,28
242,120,126,28,12,15,5,3,7,13,22,-9,13,17,18
243,120,126,50,15,15,2,4,9,15,31,-16,8,22,10
244,120,126,43,5,15,7,4,4,28,18,10,18,12,25
245,120,126,34,6,15,7,3,5,29,30,-1,17,13,24
246,120,126,49,1,15,8,4,3,28,15,13,20,10,28
247,120,126,53,3,15,8,2,5,30,22,8,18,12,26
248,120,126,7,4,15,8,2,5,27,21,6,18,12,26
249,120,126,4,9,15,6,4,5,27,19,8,16,14,22
250,120,126,21,14,15,4,3,8,21,27,-6,11,19,15
251,120,126,1,11,15,4,7,4,20,19,1,15,15,19
252,120,126,18,13,15,4,6,5,14,21,-7,14,16,18
253,120,126,39,8,15,7,1,7,25,21,4,15,15,22
254,120,126,29,16,15,2,3,10,11,28,-17,7,23,9
255,183,203,29,15,24,5,4,15,20,41,-21,14,34,19
256,183,203,39,13,24,9,1,14,34,44,-10,19,29,28
257,183,203,1,8,24,8,9,7,37,35,2,25,23,33
258,183,203,18,14,24,5,11,8,20,33,-13,21,27,26
259,183,203,53,5,24,11,4,9,40,34,6,26,22,37
260,183,203,7,4,24,12,6,6,39,30,9,30,18,42
261,183,203,21,10,24,8,7,9,39,37,2,23,25,31
262,183,203,4,12,24,7,8,9,37,33,4,22,26,29
263,183,203,49,1,24,14,7,3,47,22,25,35,13,49
264,183,203,43,2,24,12,7,5,46,24,22,31,17,43
265,183,203,34,6,24,9,7,8,42,53,-11,25,23,34
266,183,203,28,9,24,9,5,10,26,30,-4,23,25,32
267,183,203,50,16,24,3,7,14,22,47,-25,13,35,16
268,183,203,41,3,24,11,10,3,38,20,18,32,16,43
269,183,203,19,7,24,10,3,11,44,37,7,23,25,33
270,183,203,17,11,24,8,6,10,31,42,-11,22,26,30
271,442,448,19,15,11,2,3,6,16,30,-14,7,15,9
272,442,448,17,16,11,1,2,8,18,29,-11,4,18,5
273,442,448,41,3,11,6,2,3,17,10,7,14,8,20
274,442,448,36,9,11,4,2,5,16,18,-2,10,12,14
275,442,448,28,12,11,3,3,5,20,18,2,9,13,12
276,442,448,43,1,11,8,2,1,29,9,20,18,4,26
277,442,448,34,10,11,4,2,5,13,18,-5,10,12,14
278,442,448,57,11,11,4,1,6,21,30,-9,9,13,13
279,442,448,49,2,11,7,2,2,27,12,15,16,6,23
280,442,448,4,6,11,5,3,3,17,21,-4,13,9,18
281,442,448,21,7,11,4,3,4,21,19,2,11,11,15
282,442,448,7,13,11,2,4,5,15,21,-6,8,14,10
283,442,448,53,5,11,5,5,1,14,9,5,15,7,20
284,442,448,39,14,11,2,3,6,11,16,-5,7,15,9
285,442,448,1,4,11,6,2,3,15,12,3,14,8,20
286,442,448,18,8,11,4,3,4,15,13,2,11,11,15
287,456,462,1,3,13,7,3,3,19,13,6,17,9,24
288,456,462,18,8,13,4,4,5,17,17,0,12,14,16
289,456,462,39,15,13,3,3,7,15,19,-4,9,17,12
290,456,462,53,5,13,5,6,2,16,14,2,16,10,21
291,456,462,4,4,13,7,3,3,21,21,0,17,9,24
292,456,462,21,9,13,4,4,5,23,25,-2,12,14,16
293,456,462,7,12,13,3,5,5,19,24,-5,11,15,14
294,456,462,49,2,13,9,2,2,31,12,19,20,6,29
295,456,462,43,1,13,10,2,1,34,10,24,22,4,32
296,456,462,34,10,13,4,2,7,13,21,-8,10,16,14
297,456,462,57,11,13,4,2,7,22,34,-12,10,16,14
298,456,462,36,7,13,5,2,6,17,21,-4,12,14,17
299,456,462,28,13,13,3,4,6,20,20,0,10,16,13
300,456,462,41,6,13,6,2,5,17,13,4,14,12,20
301,456,462,19,14,13,3,4,6,19,31,-12,10,16,13
302,456,462,17,16,13,2,2,9,24,32,-8,6,20,8
303,484,490,19,15,16,3,4,9,20,38,-18,10,22,13
304,484,490,17,16,16,3,2,11,26,36,-10,8,24,11
305,484,490,36,6,16,7,3,6,21,22,-1,17,15,24
306,484,490,28,13,16,4,4,8,24,24,0,12,20,16
307,484,490,43,1,16,13,2,1,46,13,33,28,4,41
308,484,490,34,11,16,5,2,9,15,28,-13,12,20,17
309,484,490,57,12,16,5,2,9,27,41,-14,12,20,17
310,484,490,49,2,16,10,3,3,32,14,18,23,9,33
311,484,490,4,5,16,7,5,4,21,22,-1,19,13,26
312,484,490,21,7,16,6,5,5,27,26,1,17,15,23
313,484,490,7,9,16,5,6,5,26,25,1,16,16,21
314,484,490,53,8,16,5,7,4,17,20,-3,17,15,22
315,484,490,1,3,16,9,3,4,23,15,8,21,11,30
316,484,490,18,14,16,4,4,8,18,22,-4,12,20,16
317,484,490,41,4,16,8,3,5,19,13,6,19,13,27
318,92,98,28,14,11,2,2,7,7,20,-13,6,16,8
319,92,98,50,15,11,1,3,7,10,25,-15,5,17,6
320,92,98,34,3,11,7,1,3,24,22,2,15,7,22
321,92,98,43,4,11,6,3,2,27,12,15,15,7,21
322,92,98,19,5,11,5,2,4,23,14,9,12,10,17
323,92,98,17,9,11,5,0,6,14,22,-8,10,12,15
324,92,98,49,1,11,7,3,1,20,7,13,17,5,24
325,92,98,41,2,11,7,3,1,17,10,7,17,5,24
326,92,98,7,6,11,5,2,4,19,18,1,12,10,17
327,92,98,4,10,11,4,3,4,19,15,4,11,11,15
328,92,98,21,13,11,3,2,6,18,21,-3,8,14,11
329,92,98,53,7,11,5,1,5,22,18,4,11,11,16
330,92,98,18,11,11,4,3,4,12,18,-6,11,11,15
331,92,98,1,12,11,3,5,3,14,15,-1,11,11,14
332,92,98,39,8,11,5,1,5,17,13,4,11,11,16
333,92,98,29,16,11,1,2,8,7,20,-13,4,18,5
334,463,469,39,11,14,4,3,7,18,20,-2,11,17,15
335,463,469,1,3,14,8,3,3,20,13,7,19,9,27
336,463,469,18,10,14,4,4,6,18,19,-1,12,16,16
337,463,469,53,6,14,5,6,3,17,19,-2,16,12,21
338,463,469,4,4,14,7,4,3,21,21,0,18,10,25
339,463,469,21,8,14,5,4,5,25,26,-1,14,14,19
340,463,469,7,9,14,4,5,5,24,24,0,13,15,17
341,463,469,41,5,14,7,2,5,18,13,5,16,12,23
342,463,469,49,2,14,9,3,2,31,12,19,21,7,30
343,463,469,19,15,14,3,4,7,19,32,-13,10,18,13
344,463,469,17,16,14,2,2,10,25,35,-10,6,22,8
345,463,469,36,7,14,6,2,6,19,22,-3,14,14,20
346,463,469,28,14,14,3,4,7,20,21,-1,10,18,13
347,463,469,43,1,14,11,2,1,39,11,28,24,4,35
348,463,469,34,12,14,4,2,8,14,23,-9,10,18,14
349,463,469,57,13,14,4,2,8,22,39,-17,10,18,14
350,498,504,36,6,18,8,3,7,26,26,0,19,17,27
351,498,504,28,12,18,5,4,9,29,28,1,14,22,19
352,498,504,43,1,18,15,2,1,50,15,35,32,4,47
353,498,504,57,11,18,6,2,10,31,43,-12,14,22,20
354,498,504,34,13,18,5,3,10,18,35,-17,13,23,18
355,498,504,17,14,18,5,2,11,30,38,-8,12,24,17
356,498,504,19,16,18,3,6,9,24,42,-18,12,24,15
357,498,504,49,2,18,12,3,3,36,14,22,27,9,39
358,498,504,41,5,18,8,3,7,19,17,2,19,17,27
359,498,504,4,4,18,8,6,4,26,24,2,22,14,30
360,498,504,21,7,18,7,6,5,31,28,3,20,16,27
361,498,504,7,9,18,5,7,6,28,29,-1,17,19,22
362,498,504,53,8,18,5,8,5,19,23,-4,18,18,23
363,498,504,1,3,18,9,4,5,24,19,5,22,14,31
364,498,504,18,15,18,4,4,10,18,24,-6,12,24,16
365,498,504,39,10,18,6,3,9,22,26,-4,15,21,21
366,533,539,39,9,23,8,4,11,28,31,-3,20,26,28
367,533,539,1,4,23,10,7,6,33,26,7,27,19,37
368,533,539,18,13,23,6,5,12,26,31,-5,17,29,23
369,533,539,53,11,23,6,9,8,25,31,-6,21,25,27
370,533,539,21,3,23,11,7,5,44,33,11,29,17,40
371,533,539,4,6,23,9,7,7,31,36,-5,25,21,34
372,533,539,7,7,23,8,7,8,36,36,0,23,23,31
373,533,539,41,5,23,10,6,7,25,20,5,26,20,36
374,533,539,49,2,23,14,3,6,43,21,22,31,15,45
375,533,539,17,12,23,7,4,12,37,44,-7,18,28,25
376,533,539,19,15,23,5,7,11,31,49,-18,17,29,22
377,533,539,43,1,23,19,3,1,63,19,44,41,5,60
378,533,539,57,14,23,6,5,12,34,53,-19,17,29,23
379,533,539,34,16,23,5,5,13,21,43,-22,15,31,20
380,533,539,36,8,23,8,5,10,27,35,-8,21,25,29
381,533,539,28,10,23,7,6,10,38,34,4,20,26,27
382,400,406,28,11,6,1,2,3,10,10,0,4,8,5
383,400,406,36,16,6,0,1,5,3,11,-8,1,11,1
384,400,406,43,1,6,5,1,0,18,4,14,11,1,16
385,400,406,34,2,6,4,1,1,11,6,5,9,3,13
386,400,406,57,10,6,2,0,4,11,19,-8,4,8,6
387,400,406,19,13,6,1,2,3,8,15,-7,4,8,5
388,400,406,17,15,6,0,2,4,10,16,-6,2,10,2
389,400,406,49,6,6,3,2,1,9,7,2,8,4,11
390,400,406,41,9,6,2,1,3,7,7,0,5,7,7
391,400,406,4,4,6,4,1,1,13,11,2,9,3,13
392,400,406,21,7,6,3,1,2,15,10,5,7,5,10
393,400,406,7,14,6,0,4,2,7,12,-5,4,8,4
394,400,406,53,5,6,3,3,0,9,5,4,9,3,12
395,400,406,1,3,6,4,1,1,9,6,3,9,3,13
396,400,406,18,8,6,3,0,3,12,10,2,6,6,9
397,134,140,28,12,17,6,3,8,14,23,-9,15,19,21
398,134,140,50,15,17,2,5,10,15,35,-20,9,25,11
399,134,140,43,5,17,7,6,4,29,19,10,20,14,27
400,134,140,34,8,17,7,4,6,33,38,-5,18,16,25
401,134,140,7,3,17,9,3,5,29,22,7,21,13,30
402,134,140,4,10,17,6,5,6,28,22,6,17,17,23
403,134,140,21,14,17,5,4,8,27,29,-2,14,20,19
404,134,140,19,6,17,8,2,7,36,24,12,18,16,26
405,134,140,17,9,17,7,2,8,22,31,-9,16,18,23
406,134,140,41,4,17,7,9,1,23,16,7,23,11,30
407,134,140,49,1,17,9,5,3,32,18,14,23,11,32
408,134,140,53,2,17,9,3,5,32,22,10,21,13,30
409,134,140,1,11,17,5,7,5,24,24,0,17,17,22
410,134,140,18,13,17,4,8,5,15,22,-7,16,18,20
411,134,140,39,7,17,8,1,8,29,23,6,17,17,25
412,134,140,29,16,17,2,3,12,12,32,-20,7,27,9
413,148,154,29,16,19,2,4,13,12,36,-24,8,30,10
414,148,154,39,9,19,8,1,10,30,35,-5,17,21,25
415,148,154,1,8,19,6,8,5,28,25,3,20,18,26
416,148,154,18,14,19,4,8,7,16,27,-11,16,22,20
417,148,154,53,2,19,10,4,5,36,24,12,24,14,34
418,148,154,49,1,19,11,5,3,38,18,20,27,11,38
419,148,154,41,5,19,8,9,2,32,17,15,25,13,33
420,148,154,19,6,19,9,2,8,39,28,11,20,18,29
421,148,154,17,11,19,7,4,8,25,34,-9,18,20,25
422,148,154,7,3,19,10,4,5,32,24,8,24,14,34
423,148,154,4,12,19,6,5,8,30,26,4,17,21,23
424,148,154,21,13,19,6,5,8,31,31,0,17,21,23
425,148,154,43,4,19,9,6,4,40,21,19,24,14,33
426,148,154,34,7,19,8,4,7,34,45,-11,20,18,28
427,148,154,28,10,19,7,4,8,17,25,-8,18,20,25
428,148,154,50,15,19,2,5,12,15,39,-24,9,29,11
429,155,161,28,12,20,7,4,9,17,26,-9,18,22,25
430,155,161,50,15,20,2,6,12,18,42,-24,10,30,12
431,155,161,43,2,20,10,6,4,41,21,20,26,14,36
432,155,161,34,7,20,9,4,7,36,45,-9,22,18,31
433,155,161,7,3,20,10,5,5,32,24,8,25,15,35
434,155,161,21,9,20,7,5,8,34,31,3,19,21,26
435,155,161,4,13,20,6,6,8,31,27,4,18,22,24
436,155,161,19,6,20,10,2,8,41,29,12,22,18,32
437,155,161,17,8,20,8,4,8,26,34,-8,20,20,28
438,155,161,41,5,20,8,10,2,32,17,15,26,14,34
439,155,161,49,1,20,11,6,3,41,21,20,28,12,39
440,155,161,53,4,20,10,4,6,36,27,9,24,16,34
441,155,161,1,10,20,6,8,6,29,27,2,20,20,26
442,155,161,18,14,20,4,9,7,17,28,-11,17,23,21
443,155,161,39,11,20,8,1,11,30,37,-7,17,23,25
444,155,161,29,16,20,2,4,14,12,37,-25,8,32,10
445,15,21,29,14,3,0,1,2,2,5,-3,1,5,1
446,15,21,39,5,3,2,0,1,5,2,3,4,2,6
447,15,21,1,13,3,0,2,1,3,4,-1,2,4,2
448,15,21,18,16,3,0,1,2,0,8,-8,1,5,1
449,15,21,53,6,3,2,0,1,4,3,1,4,2,6
450,15,21,49,3,3,2,1,0,5,0,5,5,1,7
451,15,21,41,2,3,3,0,0,6,3,3,6,0,9
452,15,21,19,4,3,2,0,1,8,2,6,4,2,6
453,15,21,17,12,3,1,0,2,1,8,-7,2,4,3
454,15,21,7,1,3,3,0,0,8,4,4,6,0,9
455,15,21,4,9,3,1,0,2,5,5,0,2,4,3
456,15,21,21,10,3,1,0,2,5,6,-1,2,4,3
457,15,21,43,7,3,1,1,1,9,3,6,3,3,4
458,15,21,34,8,3,1,1,1,3,5,-2,3,3,4
459,15,21,28,11,3,1,0,2,2,5,-3,2,4,3
460,15,21,50,14,3,0,1,2,2,5,-3,1,5,1
461,526,532,36,8,22,8,4,10,27,35,-8,20,24,28
462,526,532,28,10,22,7,6,9,36,31,5,20,24,27
463,526,532,43,1,22,18,3,1,60,19,41,39,5,57
464,526,532,57,13,22,6,5,11,34,50,-16,17,27,23
465,526,532,34,15,22,5,5,12,20,40,-20,15,29,20
466,526,532,21,3,22,10,7,5,41,31,10,27,17,37
467,526,532,4,6,22,9,6,7,31,36,-5,24,20,33
468,526,532,7,9,22,7,7,8,35,36,-1,21,23,28
469,526,532,17,12,22,7,3,12,37,44,-7,17,27,24
470,526,532,19,16,22,4,7,11,29,49,-20,15,29,19
471,526,532,41,5,22,10,5,7,25,20,5,25,19,35
472,526,532,49,2,22,13,3,6,40,20,20,29,15,42
473,526,532,53,11,22,6,9,7,25,29,-4,21,23,27
474,526,532,1,4,22,10,6,6,31,24,7,26,18,36
475,526,532,18,14,22,6,4,12,24,29,-5,16,28,22
476,526,532,39,7,22,8,4,10,28,30,-2,20,24,28
477,141,147,28,13,18,6,4,8,14,23,-9,16,20,22
478,141,147,50,15,18,2,5,11,15,38,-23,9,27,11
479,141,147,43,4,18,8,6,4,36,19,17,22,14,30
480,141,147,34,8,18,7,4,7,33,45,-12,18,18,25
481,141,147,19,6,18,9,2,7,37,24,13,20,16,29
482,141,147,17,10,18,7,3,8,23,32,-9,17,19,24
483,141,147,41,5,18,7,9,2,23,17,6,23,13,30
484,141,147,49,1,18,10,5,3,34,18,16,25,11,35
485,141,147,7,2,18,10,3,5,30,22,8,23,13,33
486,141,147,4,11,18,6,5,7,28,23,5,17,19,23
487,141,147,21,12,18,6,4,8,30,30,0,16,20,22
488,141,147,53,3,18,9,4,5,33,23,10,22,14,31
489,141,147,1,9,18,6,7,5,27,24,3,19,17,25
490,141,147,18,14,18,4,8,6,15,24,-9,16,20,20
491,141,147,39,7,18,8,1,9,30,26,4,17,19,25
492,141,147,29,16,18,2,4,12,12,32,-20,8,28,10
493,176,182,29,15,23,4,4,15,17,40,-23,12,34,16
494,176,182,39,13,23,9,1,13,34,42,-8,19,27,28
495,176,182,1,7,23,8,9,6,37,31,6,25,21,33
496,176,182,18,14,23,5,10,8,19,32,-13,20,26,25
497,176,182,53,5,23,11,4,8,40,32,8,26,20,37
498,176,182,49,1,23,13,7,3,45,22,23,33,13,46
499,176,182,41,3,23,10,10,3,36,20,16,30,16,40
500,176,182,7,4,23,11,6,6,38,30,8,28,18,39
501,176,182,21,9,23,8,6,9,37,35,2,22,24,30
502,176,182,4,12,23,7,8,8,37,31,6,22,24,29
503,176,182,19,8,23,10,2,11,43,36,7,22,24,32
504,176,182,17,11,23,8,5,10,29,40,-11,21,25,29
505,176,182,43,2,23,12,7,4,46,23,23,31,15,43
506,176,182,34,6,23,9,7,7,41,50,-9,25,21,34
507,176,182,28,10,23,8,5,10,22,30,-8,21,25,29
508,176,182,50,16,23,2,7,14,20,47,-27,11,35,13
509,204,217,28,10,25,9,5,11,26,32,-6,23,27,32
510,204,217,50,16,25,4,7,14,24,47,-23,15,35,19
511,204,217,43,2,25,13,7,5,47,24,23,33,17,46
512,204,217,34,7,25,9,8,8,44,55,-11,26,24,35
513,204,217,19,6,25,11,3,11,46,38,8,25,25,36
514,204,217,17,12,25,8,6,11,31,44,-13,22,28,30
515,204,217,7,4,25,12,6,7,40,32,8,30,20,42
516,204,217,21,8,25,9,7,9,41,37,4,25,25,34
517,204,217,4,13,25,7,8,10,38,35,3,22,28,29
518,204,217,41,3,25,12,10,3,40,20,20,34,16,46
519,204,217,49,1,25,14,8,3,48,23,25,36,14,50
520,204,217,53,5,25,11,4,10,40,35,5,26,24,37
521,204,217,1,9,25,8,10,7,38,36,2,26,24,34
522,204,217,18,14,25,5,12,8,22,35,-13,22,28,27
523,204,217,39,11,25,10,1,14,36,45,-9,21,29,31
524,204,217,29,15,25,5,4,16,20,43,-23,14,36,19
525,491,497,39,9,17,6,3,8,21,23,-2,15,19,21
526,491,497,1,3,17,9,3,5,23,18,5,21,13,30
527,491,497,18,14,17,4,4,9,18,23,-5,12,22,16
528,491,497,41,4,17,8,3,6,19,16,3,19,15,27
529,491,497,49,2,17,11,3,3,35,14,21,25,9,36
530,491,497,4,5,17,7,6,4,23,24,-1,20,14,27
531,491,497,21,6,17,7,5,5,30,27,3,19,15,26
532,491,497,7,10,17,5,6,6,27,28,-1,16,18,21
533,491,497,53,8,17,5,7,5,18,22,-4,17,17,22
534,491,497,17,15,17,4,2,11,28,37,-9,10,24,14
535,491,497,19,16,17,3,5,9,22,40,-18,11,23,14
536,491,497,36,7,17,7,3,7,23,25,-2,17,17,24
537,491,497,28,12,17,5,4,8,29,25,4,14,20,19
538,491,497,43,1,17,14,2,1,49,15,34,30,4,44
539,491,497,57,11,17,6,2,9,30,41,-11,14,20,20
540,491,497,34,13,17,5,2,10,16,33,-17,12,22,17
541,505,511,43,1,19,16,2,1,53,17,36,34,4,50
542,505,511,57,12,19,6,3,10,32,44,-12,15,23,21
543,505,511,34,14,19,5,4,10,18,35,-17,14,24,19
544,505,511,36,7,19,8,3,8,26,28,-2,19,19,27
545,505,511,28,10,19,6,4,9,31,28,3,16,22,22
546,505,511,17,15,19,5,2,12,32,41,-9,12,26,17
547,505,511,19,16,19,3,6,10,25,44,-19,12,26,15
548,505,511,53,9,19,5,9,5,19,23,-4,19,19,24
549,505,511,21,5,19,8,6,5,33,29,4,22,16,30
550,505,511,4,6,19,8,6,5,27,26,1,22,16,30
551,505,511,7,11,19,5,7,7,28,32,-4,17,21,22
552,505,511,49,2,19,12,3,4,36,15,21,27,11,39
553,505,511,41,4,19,9,3,7,20,17,3,21,17,30
554,505,511,1,3,19,9,5,5,25,20,5,23,15,32
555,484,490,39,10,16,5,3,8,20,23,-3,13,19,18
556,379,385,39,14,3,0,1,2,1,3,-2,1,5,1
557,379,385,1,2,3,3,0,0,6,3,3,6,0,9
558,379,385,18,4,3,2,0,1,8,5,3,4,2,6
559,379,385,53,7,3,1,2,0,5,4,1,4,2,5
560,379,385,4,3,3,2,1,0,6,3,3,5,1,7
561,379,385,21,5,3,2,0,1,8,6,2,4,2,6
562,379,385,7,13,3,0,2,1,4,7,-3,2,4,2
563,379,385,43,1,3,3,0,0,13,2,11,6,0,9
564,379,385,34,6,3,2,0,1,6,5,1,4,2,6
565,379,385,57,11,3,1,0,2,5,11,-6,2,4,3
566,379,385,49,12,3,0,2,1,4,5,-1,2,4,2
567,379,385,28,9,3,1,0,2,6,5,1,2,4,3
568,379,385,36,16,3,0,0,3,1,7,-6,0,6,0
569,379,385,19,10,3,1,0,2,6,11,-5,2,4,3
570,379,385,17,15,3,0,1,2,6,9,-3,1,5,1
571,379,385,41,8,3,1,1,1,4,3,1,3,3,4
572,414,420,41,8,8,4,1,3,11,9,2,9,7,13
573,414,420,19,11,8,2,2,4,11,19,-8,6,10,8
574,414,420,17,15,8,1,2,5,15,20,-5,4,12,5
575,414,420,28,10,8,3,2,3,17,12,5,8,8,11
576,414,420,36,12,8,2,1,5,8,13,-5,5,11,7
577,414,420,49,3,8,4,2,2,16,10,6,10,6,14
578,414,420,43,1,8,6,2,0,21,5,16,14,2,20
579,414,420,34,7,8,4,1,3,13,10,3,9,7,13
580,414,420,57,13,8,2,1,5,12,26,-14,5,11,7
581,414,420,4,2,8,4,3,1,13,11,2,11,5,15
582,414,420,21,6,8,4,1,3,18,14,4,9,7,13
583,414,420,7,16,8,0,4,4,8,17,-9,4,12,4
584,414,420,53,9,8,3,4,1,10,7,3,10,6,13
585,414,420,1,4,8,4,2,2,10,10,0,10,6,14
586,414,420,18,5,8,4,1,3,15,10,5,9,7,13
587,414,420,39,14,8,1,3,4,5,10,-5,5,11,6
588,939,945,39,16,18,4,3,11,17,32,-15,11,25,15
589,939,945,1,3,18,9,4,5,26,19,7,22,14,31
590,939,945,18,14,18,4,5,9,16,24,-8,13,23,17
591,939,945,53,15,18,3,7,8,13,19,-6,13,23,16
592,939,945,4,6,18,9,2,7,34,34,0,20,16,29
593,939,945,21,7,18,9,1,8,29,31,-2,19,17,28
594,939,945,7,12,18,7,2,9,25,31,-6,16,20,23
595,939,945,49,1,18,10,4,4,26,12,14,24,12,34
596,939,945,28,8,18,7,4,7,26,21,5,18,18,25
597,939,945,36,11,18,7,3,8,25,28,-3,17,19,24
598,939,945,48,13,18,6,3,9,14,21,-7,15,21,21
599,939,945,43,2,18,9,6,3,32,19,13,24,12,33
600,939,945,57,9,18,7,4,7,23,22,1,18,18,25
601,939,945,41,4,18,10,0,8,28,24,4,20,16,30
602,939,945,17,5,18,9,3,6,23,24,-1,21,15,30
603,939,945,8,10,18,7,3,8,30,26,4,17,19,24
604,764,777,41,7,6,3,0,3,11,9,2,6,6,9
605,764,777,17,3,6,3,2,1,8,7,1,8,4,11
606,764,777,8,9,6,2,2,2,14,9,5,6,6,8
607,764,777,57,1,6,4,1,1,12,8,4,9,3,13
608,764,777,43,2,6,3,2,1,10,5,5,8,4,11
609,764,777,48,6,6,3,1,2,5,6,-1,7,5,10
610,764,777,36,10,6,2,1,3,8,8,0,5,7,7
611,764,777,28,11,6,2,1,3,9,10,-1,5,7,7
612,764,777,49,4,6,3,1,2,8,4,4,7,5,10
613,764,777,4,5,6,3,1,2,13,13,0,7,5,10
614,764,777,21,13,6,2,1,3,10,13,-3,5,7,7
615,764,777,7,14,6,2,1,3,8,12,-4,5,7,7
616,764,777,53,16,6,0,3,3,4,9,-5,3,9,3
617,764,777,39,12,6,2,1,3,5,7,-2,5,7,7
618,764,777,1,8,6,3,0,3,7,7,0,6,6,9
619,764,777,18,15,6,1,2,3,5,10,-5,4,8,5
620,1100,1106,53,5,1,1,0,0,1,0,1,2,0,3
621,1100,1106,44,8,1,0,1,0,1,1,0,1,1,1
622,1100,1106,4,1,1,1,0,0,2,0,2,2,0,3
623,1100,1106,21,3,1,1,0,0,2,1,1,2,0,3
624,1100,1106,7,15,1,0,0,1,0,2,-2,0,2,0
625,1100,1106,49,3,1,1,0,0,2,1,1,2,0,3
626,1100,1106,28,8,1,0,1,0,1,1,0,1,1,1
627,1100,1106,36,12,1,0,0,1,1,2,-1,0,2,0
628,1100,1106,48,15,1,0,0,1,0,2,-2,0,2,0
629,1100,1106,43,1,1,1,0,0,2,0,2,2,0,3
630,1100,1106,57,8,1,0,1,0,1,1,0,1,1,1
631,1100,1106,24,12,1,0,0,1,1,2,-1,0,2,0
632,1100,1106,8,6,1,0,1,0,2,2,0,1,1,1
633,1100,1106,17,14,1,0,0,1,0,1,-1,0,2,0
634,1100,1106,41,6,1,0,1,0,2,2,0,1,1,1
635,1100,1106,1,8,1,0,1,0,1,1,0,1,1,1
636,1114,1120,1,14,3,0,1,2,1,6,-5,1,5,1
637,589,602,39,7,28,10,6,12,35,34,1,26,30,36
638,589,602,1,4,28,13,8,7,39,30,9,34,22,47
639,589,602,18,14,28,7,8,13,31,36,-5,22,34,29
640,589,602,53,12,28,7,10,11,28,35,-7,24,32,31
641,589,602,49,2,28,17,3,8,55,31,24,37,19,54
642,589,602,41,5,28,12,9,7,31,22,9,33,23,45
643,589,602,17,10,28,9,6,13,47,54,-7,24,32,33
644,589,602,19,15,28,7,8,13,39,58,-19,22,34,29
645,589,602,21,3,28,14,9,5,60,43,17,37,19,51
646,589,602,4,6,28,10,7,11,37,45,-8,27,29,37
647,589,602,7,9,28,9,8,11,40,46,-6,26,30,35
648,589,602,43,1,28,21,5,2,71,25,46,47,9,68
649,589,602,57,13,28,8,6,14,38,60,-22,22,34,30
650,589,602,34,16,28,6,5,17,25,54,-29,17,39,23
651,589,602,28,8,28,9,8,11,46,40,6,26,30,35
652,589,602,36,11,28,9,6,13,38,47,-9,24,32,33
653,393,399,28,11,5,1,1,3,8,8,0,3,7,4
654,393,399,36,16,5,0,0,5,1,9,-8,0,10,0
655,393,399,43,1,5,5,0,0,17,3,14,10,0,15
656,393,399,34,3,5,4,0,1,10,5,5,8,2,12
657,393,399,57,10,5,2,0,3,11,17,-6,4,6,6
658,393,399,4,2,5,4,1,0,11,5,6,9,1,13
659,393,399,21,7,5,2,1,2,9,8,1,5,5,7
660,393,399,7,14,5,0,4,1,6,9,-3,4,6,4
661,393,399,19,13,5,1,1,3,7,14,-7,3,7,4
662,393,399,17,15,5,0,1,4,9,15,-6,1,9,1
663,393,399,41,8,5,2,1,2,6,5,1,5,5,7
664,393,399,49,6,5,2,2,1,7,6,1,6,4,8
665,393,399,53,4,5,3,2,0,8,4,4,8,2,11
666,393,399,1,5,5,3,1,1,7,6,1,7,3,10
667,393,399,18,9,5,2,0,3,9,9,0,4,6,6
668,393,399,39,12,5,1,1,3,2,5,-3,3,7,4
669,925,931,39,16,16,2,3,11,13,32,-19,7,25,9
670,925,931,1,6,16,7,4,5,20,17,3,18,14,25
671,925,931,18,14,16,4,5,7,15,21,-6,13,19,17
672,925,931,53,15,16,3,6,7,12,17,-5,12,20,15
673,925,931,49,4,16,8,4,4,22,11,11,20,12,28
674,925,931,41,5,16,9,0,7,23,20,3,18,14,27
675,925,931,17,2,16,9,3,4,21,18,3,21,11,30
676,925,931,8,10,16,6,3,7,29,25,4,15,17,21
677,925,931,21,3,16,9,1,6,28,26,2,19,13,28
678,925,931,4,9,16,7,2,7,31,33,-2,16,16,23
679,925,931,7,11,16,6,2,8,22,26,-4,14,18,20
680,925,931,43,1,16,9,4,3,31,18,13,22,10,31
681,925,931,57,8,16,7,3,6,21,19,2,17,15,24
682,925,931,28,7,16,7,3,6,25,19,6,17,15,24
683,925,931,48,12,16,6,2,8,14,18,-4,14,18,20
684,925,931,36,13,16,5,3,8,20,27,-7,13,19,18
685,932,938,28,8,17,7,4,6,26,20,6,18,16,25
686,932,938,36,11,17,6,3,8,21,27,-6,15,19,21
687,932,938,48,13,17,6,2,9,14,21,-7,14,20,20
688,932,938,43,1,17,9,5,3,32,19,13,23,11,32
689,932,938,57,9,17,7,4,6,22,20,2,18,16,25
690,932,938,21,5,17,9,1,7,28,27,1,19,15,28
691,932,938,4,7,17,8,2,7,32,33,-1,18,16,26
692,932,938,7,12,17,6,2,9,23,30,-7,14,20,20
693,932,938,17,4,17,9,3,5,22,20,2,21,13,30
694,932,938,8,10,17,6,3,8,29,26,3,15,19,21
695,932,938,41,3,17,10,0,7,27,21,6,20,14,30
696,932,938,49,2,17,9,4,4,23,11,12,22,12,31
697,932,938,53,15,17,3,7,7,13,18,-5,13,21,16
698,932,938,1,6,17,8,4,5,22,18,4,20,14,28
699,932,938,18,14,17,4,5,8,15,22,-7,13,21,17
700,932,938,39,16,17,3,3,11,16,32,-16,9,25,12
701,953,959,39,16,20,4,5,11,20,35,-15,13,27,17
702,953,959,1,2,20,10,5,5,29,20,9,25,15,35
703,953,959,18,14,20,5,5,10,18,27,-9,15,25,20
704,953,959,53,15,20,4,8,8,16,19,-3,16,24,20
705,953,959,49,1,20,11,4,5,29,16,13,26,14,37
706,953,959,41,4,20,11,0,9,31,25,6,22,18,33
707,953,959,17,5,20,10,3,7,24,27,-3,23,17,33
708,953,959,8,12,20,7,3,10,31,30,1,17,23,24
709,953,959,21,3,20,11,1,8,33,32,1,23,17,34
710,953,959,4,8,20,9,2,9,35,37,-2,20,20,29
711,953,959,7,9,20,9,2,9,30,32,-2,20,20,29
712,953,959,43,6,20,9,6,5,33,23,10,24,16,33
713,953,959,57,11,20,7,5,8,23,24,-1,19,21,26
714,953,959,36,7,20,9,3,8,28,29,-1,21,19,30
715,953,959,28,10,20,8,5,7,30,23,7,21,19,29
716,106,112,28,14,13,3,3,7,9,21,-12,9,17,12
717,106,112,50,15,13,2,4,7,12,25,-13,8,18,10
718,106,112,43,2,13,7,4,2,28,12,16,18,8,25
719,106,112,34,5,13,7,2,4,27,27,0,16,10,23
720,106,112,19,4,13,7,2,4,29,15,14,16,10,23
721,106,112,17,9,13,6,0,7,17,25,-8,12,14,18
722,106,112,7,7,13,6,2,5,22,20,2,14,12,20
723,106,112,4,8,13,5,4,4,21,16,5,14,12,19
724,106,112,21,12,13,4,3,6,20,22,-2,11,15,15
725,106,112,41,1,13,7,5,1,20,13,7,19,7,26
726,106,112,49,3,13,7,3,3,22,12,10,17,9,24
727,106,112,53,6,13,6,2,5,26,20,6,14,12,20
728,106,112,18,11,13,4,4,5,12,19,-7,12,14,16
729,106,112,1,13,13,3,6,4,14,16,-2,12,14,15
730,106,112,39,10,13,5,1,7,18,20,-2,11,15,16
731,106,112,29,16,13,1,3,9,8,22,-14,5,21,6
732,113,119,29,16,14,2,3,9,11,24,-13,7,21,9
733,113,119,39,8,14,6,1,7,21,21,0,13,15,19
734,113,119,18,11,14,4,5,5,13,20,-7,13,15,17
735,113,119,1,12,14,3,7,4,16,18,-2,13,15,16
736,113,119,53,6,14,7,2,5,27,20,7,16,12,23
737,113,119,49,3,14,7,4,3,24,14,10,18,10,25
738,113,119,41,1,14,7,6,1,21,14,7,20,8,27
739,113,119,7,7,14,7,2,5,25,20,5,16,12,23
740,113,119,4,10,14,5,4,5,22,19,3,14,14,19
741,113,119,21,13,14,4,3,7,20,23,-3,11,17,15
742,113,119,19,5,14,7,2,5,29,18,11,16,12,23
743,113,119,17,9,14,6,1,7,18,26,-8,13,15,19
744,113,119,43,2,14,7,4,3,28,13,15,18,10,25
745,113,119,34,4,14,7,3,4,28,28,0,17,11,24
746,113,119,28,14,14,4,3,7,10,21,-11,11,17,15
747,113,119,50,15,14,2,4,8,14,28,-14,8,20,10
748,43,49,50,14,6,1,1,4,5,14,-9,3,9,4
749,43,49,28,15,6,1,1,4,4,13,-9,3,9,4
750,43,49,19,8,6,2,2,2,11,7,4,6,6,8
751,43,49,17,12,6,2,0,4,6,16,-10,4,8,6
752,43,49,43,4,6,3,2,1,18,6,12,8,4,11
753,43,49,34,5,6,3,1,2,12,10,2,7,5,10
754,43,49,7,3,6,4,1,1,14,10,4,9,3,13
755,43,49,4,9,6,2,2,2,11,8,3,6,6,8
756,43,49,21,13,6,1,2,3,8,10,-2,4,8,5
757,43,49,41,2,6,4,2,0,9,5,4,10,2,14
758,43,49,49,1,6,4,2,0,13,2,11,10,2,14
759,43,49,53,7,6,3,0,3,9,11,-2,6,6,9
760,43,49,18,10,6,2,2,2,7,11,-4,6,6,8
761,43,49,1,11,6,1,4,1,6,6,0,6,6,7
762,43,49,39,6,6,3,0,3,11,7,4,6,6,9
763,43,49,29,16,6,0,2,4,4,12,-8,2,10,2
764,50,63,29,15,7,1,2,4,6,13,-7,4,10,5
765,50,63,39,5,7,4,0,3,12,7,5,8,6,12
766,50,63,18,12,7,2,2,3,7,12,-5,6,8,8
767,50,63,1,14,7,1,4,2,7,9,-2,6,8,7
768,50,63,53,7,7,3,1,3,9,11,-2,7,7,10
769,50,63,49,1,7,5,2,0,15,3,12,12,2,17
770,50,63,41,3,7,4,2,1,9,6,3,10,4,14
771,50,63,7,2,7,4,2,1,14,10,4,10,4,14
772,50,63,4,10,7,2,2,3,11,9,2,6,8,8
773,50,63,21,11,7,2,2,3,12,11,1,6,8,8
774,50,63,34,4,7,4,1,2,15,11,4,9,5,13
775,50,63,43,6,7,3,2,2,19,8,11,8,6,11
776,50,63,17,8,7,3,0,4,7,16,-9,6,8,9
777,50,63,19,9,7,2,2,3,12,9,3,6,8,8
778,50,63,28,13,7,2,1,4,5,13,-8,5,9,7
779,50,63,50,16,7,1,1,5,6,18,-12,3,11,4
780,372,378,36,15,2,0,0,2,1,6,-5,0,4,0
781,372,378,28,6,2,1,0,1,5,3,2,2,2,3
782,372,378,43,1,2,2,0,0,9,1,8,4,0,6
783,372,378,34,3,2,2,0,0,6,4,2,4,0,6
784,372,378,57,8,2,1,0,1,3,4,-1,2,2,3
785,372,378,17,11,2,0,1,1,4,5,-1,1,3,1
786,372,378,19,16,2,0,0,2,2,9,-7,0,4,0
787,372,378,7,13,2,0,1,1,3,6,-3,1,3,1
788,372,378,21,2,2,2,0,0,7,2,5,4,0,6
789,372,378,4,5,2,1,1,0,5,3,2,3,1,4
790,372,378,41,7,2,1,0,1,4,3,1,2,2,3
791,372,378,49,12,2,0,1,1,3,4,-1,1,3,1
792,372,378,53,10,2,0,2,0,3,3,0,2,2,2
793,372,378,18,9,2,1,0,1,1,3,-2,2,2,3
794,372,378,1,4,2,2,0,0,5,3,2,4,0,6
795,372,378,39,14,2,0,0,2,1,3,-2,0,4,0
796,568,581,39,8,26,9,5,12,31,33,-2,23,29,32
797,505,511,18,13,19,5,4,10,21,24,-3,14,24,19
798,505,511,39,8,19,7,3,9,24,27,-3,17,21,24
799,512,518,39,9,20,7,3,10,24,29,-5,17,23,24
800,512,518,1,3,20,10,5,5,29,20,9,25,15,35
801,512,518,18,13,20,5,4,11,21,27,-6,14,26,19
802,512,518,41,5,20,9,4,7,22,19,3,22,18,31
803,512,518,49,2,20,13,3,4,38,15,23,29,11,42
804,512,518,4,4,20,9,6,5,29,27,2,24,16,33
805,512,518,21,6,20,8,7,5,34,30,4,23,17,31
806,512,518,7,8,20,6,7,7,31,33,-2,19,21,25
807,512,518,53,10,20,5,9,6,20,26,-6,19,21,24
808,512,518,17,15,20,5,3,12,33,42,-9,13,27,18
809,512,518,19,16,20,3,7,10,27,46,-19,13,27,16
810,512,518,36,7,20,8,3,9,26,32,-6,19,21,27
811,512,518,28,11,20,6,5,9,31,28,3,17,23,23
812,512,518,43,1,20,17,2,1,56,17,39,36,4,53
813,512,518,57,12,20,6,4,10,32,44,-12,16,24,22
814,512,518,34,14,20,5,4,11,19,37,-18,14,26,19
815,729,735,28,9,1,0,0,1,1,2,-1,0,2,0
816,729,735,36,12,1,0,0,1,0,2,-2,0,2,0
817,729,735,48,15,1,0,0,1,2,5,-3,0,2,0
818,729,735,57,4,1,1,0,0,3,1,2,2,0,3
819,729,735,43,5,1,1,0,0,2,0,2,2,0,3
820,729,735,8,2,1,1,0,0,5,2,3,2,0,3
821,729,735,17,16,1,0,0,1,0,5,-5,0,2,0
822,729,735,41,1,1,1,0,0,5,0,5,2,0,3
823,729,735,53,12,1,0,0,1,0,2,-2,0,2,0
824,729,735,49,8,1,1,0,0,2,1,1,2,0,3
825,729,735,21,3,1,1,0,0,5,3,2,2,0,3
826,729,735,7,5,1,1,0,0,2,0,2,2,0,3
827,729,735,4,10,1,0,0,1,3,5,-2,0,2,0
828,729,735,1,5,1,1,0,0,2,0,2,2,0,3
829,729,735,18,12,1,0,0,1,0,2,-2,0,2,0
830,729,735,39,11,1,0,0,1,1,3,-2,0,2,0
831,827,833,39,16,12,2,2,8,12,24,-12,6,18,8
832,827,833,1,6,12,6,2,4,16,14,2,14,10,20
833,827,833,18,15,12,2,4,6,11,18,-7,8,16,10
834,827,833,53,14,12,3,3,6,10,13,-3,9,15,12
835,827,833,21,7,12,6,1,5,21,23,-2,13,11,19
836,827,833,4,10,12,5,2,5,24,26,-2,12,12,17
837,827,833,7,11,12,5,2,5,16,19,-3,12,12,17
838,827,833,49,1,12,6,3,3,19,9,10,15,9,21
839,827,833,41,9,12,6,0,6,18,18,0,12,12,18
840,827,833,17,2,12,6,3,3,16,16,0,15,9,21
841,827,833,8,3,12,6,2,4,26,16,10,14,10,20
842,827,833,57,5,12,6,2,4,19,16,3,14,10,20
843,827,833,43,8,12,5,4,3,20,14,6,14,10,19
844,827,833,28,4,12,6,2,4,22,15,7,14,10,20
845,827,833,48,12,12,4,2,6,9,13,-4,10,14,14
846,827,833,36,13,12,4,2,6,15,20,-5,10,14,14
847,981,983,28,9,25,9,8,8,36,32,4,26,24,35
848,981,983,36,12,25,9,5,11,29,33,-4,23,27,32
849,981,983,48,13,25,8,4,13,19,31,-12,20,30,28
850,981,983,43,3,25,12,6,7,40,29,11,30,20,42
851,981,983,57,10,25,9,6,10,27,33,-6,24,26,33
852,981,983,17,6,25,12,3,10,33,33,0,27,23,39
853,981,983,8,11,25,9,5,11,34,34,0,23,27,32
854,981,983,49,1,25,15,4,6,37,18,19,34,16,49
855,981,983,41,7,25,12,2,11,35,33,2,26,24,38
856,981,983,21,2,25,14,2,9,46,40,6,30,20,44
857,981,983,4,4,25,13,2,10,49,44,5,28,22,41
858,981,983,7,5,25,13,2,10,39,34,5,28,22,41
859,981,983,53,14,25,6,10,9,21,22,-1,22,28,28
860,981,983,1,8,25,10,5,10,30,29,1,25,25,35
861,981,983,18,16,25,5,6,14,21,34,-13,16,34,21
862,981,983,39,15,25,6,6,13,25,42,-17,18,32,24
863,1009,1099,39,14,30,9,6,15,34,46,-12,24,36,33
864,1009,1099,1,9,30,12,6,12,35,39,-4,30,30,42
865,1009,1099,18,16,30,6,7,17,28,45,-17,19,41,25
866,1009,1099,21,2,30,19,2,9,57,44,13,40,20,59
867,1009,1099,4,4,30,15,4,11,55,52,3,34,26,49
868,1009,1099,7,5,30,14,4,12,46,41,5,32,28,46
869,1009,1099,53,15,30,7,12,11,30,30,0,26,34,33
870,1009,1099,41,6,30,14,2,14,42,41,1,30,30,44
871,1009,1099,49,1,30,20,4,6,51,21,30,44,16,64
872,1009,1099,17,8,30,13,3,14,37,42,-5,29,31,42
873,1009,1099,8,12,30,10,5,15,40,49,-9,25,35,35
874,1009,1099,43,3,30,15,7,8,54,34,20,37,23,52
875,1009,1099,57,11,30,10,6,14,33,44,-11,26,34,36
876,953,959,48,13,20,6,3,11,14,25,-11,15,25,21
877,757,763,57,2,5,3,1,1,9,7,2,7,3,10
878,757,763,43,7,5,2,2,1,7,4,3,6,4,8
879,757,763,48,5,5,3,0,2,5,6,-1,6,4,9
880,757,763,28,8,5,2,1,2,8,8,0,5,5,7
881,757,763,36,14,5,1,1,3,6,8,-2,3,7,4
882,757,763,4,1,5,3,1,1,13,9,4,7,3,10
883,757,763,21,10,5,2,1,2,9,10,-1,5,5,7
884,757,763,7,12,5,2,0,3,8,12,-4,4,6,6
885,757,763,41,11,5,2,0,3,9,8,1,4,6,6
886,757,763,17,3,5,3,1,1,8,7,1,7,3,10
887,757,763,8,6,5,2,2,1,14,7,7,6,4,8
888,757,763,49,9,5,2,1,2,4,4,0,5,5,7
889,757,763,53,16,5,0,2,3,4,9,-5,2,8,2
890,757,763,1,4,5,3,0,2,6,4,2,6,4,9
891,757,763,18,13,5,1,2,2,4,8,-4,4,6,5
892,757,763,39,15,5,1,1,3,3,6,-3,3,7,4
893,1205,1211,1,13,14,3,3,8,13,26,-13,9,19,12
894,1205,1211,53,2,14,8,4,2,30,15,15,20,8,28
895,1205,1211,44,9,14,4,5,5,13,18,-5,13,15,17
896,1205,1211,49,3,14,8,4,2,26,12,14,20,8,28
897,1205,1211,41,6,14,7,3,4,21,16,5,17,11,24
898,1205,1211,8,4,14,7,5,2,20,15,5,19,9,26
899,1205,1211,17,11,14,3,6,5,18,17,1,12,16,15
900,1205,1211,21,7,14,5,6,3,20,15,5,16,12,21
901,1205,1211,4,8,14,6,2,6,19,23,-4,14,14,20
902,1205,1211,7,12,14,2,7,5,15,23,-8,11,17,13
903,1205,1211,43,1,14,10,3,1,43,12,31,23,5,33
904,1205,1211,57,14,14,3,3,8,11,25,-14,9,19,12
905,1205,1211,24,16,14,1,2,11,10,30,-20,4,24,5
906,1205,1211,36,5,14,7,3,4,22,16,6,17,11,24
907,1205,1211,48,10,14,4,4,6,11,19,-8,12,16,16
908,1205,1211,28,15,14,1,6,7,16,26,-10,8,20,9
909,1324,1330,36,7,29,13,7,9,43,38,5,33,25,46
910,1324,1330,48,11,29,8,6,15,29,47,-18,22,36,30
911,1324,1330,28,13,29,7,8,14,35,50,-15,22,36,29
912,1324,1330,43,1,29,18,9,2,75,24,51,45,13,63
913,1324,1330,57,10,29,7,10,12,21,41,-20,24,34,31
914,1324,1330,24,16,29,3,10,16,20,45,-25,16,42,19
915,1324,1330,21,6,29,13,9,7,41,35,6,35,23,48
916,1324,1330,4,8,29,10,6,13,37,46,-9,26,32,36
917,1324,1330,7,12,29,7,9,13,38,47,-9,23,35,30
918,1324,1330,8,2,29,15,9,5,44,30,14,39,19,54
919,1324,1330,17,9,29,8,10,11,39,40,-1,26,32,34
920,1324,1330,41,5,29,14,6,9,37,27,10,34,24,48
921,1324,1330,49,3,29,15,8,6,56,28,28,38,20,53
922,1324,1330,53,4,29,12,13,4,47,24,23,37,21,49
923,1324,1330,44,15,29,6,10,13,26,50,-24,22,36,28
924,1324,1330,1,14,29,7,8,14,32,48,-16,22,36,29
925,1541,1547,1,12,10,2,4,4,13,11,2,8,12,10
926,1541,1547,53,5,10,4,3,3,16,9,7,11,9,15
927,1541,1547,49,2,10,6,3,1,23,10,13,15,5,21
928,1541,1547,30,6,10,4,3,3,20,14,6,11,9,15
929,1541,1547,41,7,10,4,3,3,18,14,4,11,9,15
930,1541,1547,17,3,10,6,1,3,22,18,4,13,7,19
931,1541,1547,8,8,10,4,2,4,19,21,-2,10,10,14
932,1541,1547,43,1,10,10,0,0,33,8,25,20,0,30
933,1541,1547,57,13,10,2,3,5,10,25,-15,7,13,9
934,1541,1547,4,9,10,3,4,3,16,15,1,10,10,13
935,1541,1547,21,11,10,3,2,5,10,21,-11,8,12,11
936,1541,1547,7,14,10,2,2,6,9,24,-15,6,14,8
937,1541,1547,28,4,10,5,2,3,17,11,6,12,8,17
938,1541,1547,48,15,10,1,2,7,7,24,-17,4,16,5
939,1541,1547,36,16,10,0,5,5,12,19,-7,5,15,5
940,1541,1547,39,10,10,3,3,4,13,14,-1,9,11,12
941,1590,1596,39,14,16,3,5,8,19,30,-11,11,21,14
942,1590,1596,28,8,16,6,5,5,26,25,1,17,15,23
943,1590,1596,36,12,16,3,7,6,21,25,-4,13,19,16
944,1590,1596,48,16,16,2,4,10,12,33,-21,8,24,10
945,1590,1596,43,1,16,15,0,1,54,11,43,30,2,45
946,1590,1596,57,9,16,4,5,7,20,35,-15,13,19,17
947,1590,1596,4,10,16,3,8,5,17,19,-2,14,18,17
948,1590,1596,21,11,16,4,4,8,15,38,-23,12,20,16
949,1590,1596,7,15,16,2,6,8,12,32,-20,10,22,12
950,1590,1596,17,3,16,9,1,6,33,30,3,19,13,28
951,1590,1596,8,7,16,7,3,6,28,35,-7,17,15,24
952,1590,1596,41,5,16,7,5,4,24,17,7,19,13,26
953,1590,1596,30,6,16,7,4,5,34,19,15,18,14,25
954,1590,1596,49,2,16,10,4,2,34,16,18,24,8,34
955,1590,1596,53,4,16,8,3,5,29,14,15,19,13,27
956,1114,1120,41,3,3,2,1,0,5,2,3,5,1,7
957,1114,1120,8,7,3,1,2,0,8,5,3,4,2,5
958,1114,1120,17,8,3,1,1,1,6,6,0,3,3,4
959,1114,1120,43,1,3,2,1,0,6,1,5,5,1,7
960,1114,1120,57,12,3,0,2,1,2,4,-2,2,4,2
961,1114,1120,24,13,3,0,1,2,2,6,-4,1,5,1
962,1114,1120,28,11,3,0,3,0,5,5,0,3,3,3
963,1114,1120,48,14,3,0,1,2,1,6,-5,1,5,1
964,1114,1120,36,16,3,0,0,3,1,6,-5,0,6,0
965,1114,1120,49,4,3,2,0,1,7,4,3,4,2,6
966,1114,1120,4,5,3,2,0,1,4,2,2,4,2,6
967,1114,1120,21,6,3,2,0,1,3,2,1,4,2,6
968,1114,1120,7,9,3,1,1,1,5,5,0,3,3,4
969,1114,1120,53,2,3,2,1,0,5,1,4,5,1,7
970,1114,1120,44,10,3,1,1,1,3,3,0,3,3,4
971,1128,1134,53,5,5,2,2,1,10,7,3,6,4,8
972,1128,1134,44,10,5,1,3,1,4,4,0,5,5,6
973,1128,1134,21,6,5,2,2,1,5,4,1,6,4,8
974,1128,1134,4,7,5,2,0,3,5,6,-1,4,6,6
975,1128,1134,7,9,5,1,3,1,7,7,0,5,5,6
976,1128,1134,49,2,5,4,0,1,11,5,6,8,2,12
977,1128,1134,36,8,5,2,0,3,9,12,-3,4,6,6
978,1128,1134,48,13,5,1,1,3,4,9,-5,3,7,4
979,1128,1134,28,14,5,0,3,2,6,10,-4,3,7,3
980,1128,1134,43,1,5,4,1,0,14,1,13,9,1,13
981,1128,1134,57,12,5,1,2,2,5,7,-2,4,6,5
982,1128,1134,24,15,5,0,2,3,4,9,-5,2,8,2
983,1128,1134,8,3,5,3,2,0,11,6,5,8,2,11
984,1128,1134,17,11,5,1,2,2,8,9,-1,4,6,5
985,1128,1134,41,4,5,3,2,0,7,3,4,8,2,11
986,1128,1134,1,16,5,0,1,4,2,13,-11,1,9,1
987,1149,1155,1,14,7,1,1,5,4,16,-12,3,11,4
988,1149,1155,41,5,7,4,2,1,9,5,4,10,4,14
989,1149,1155,8,2,7,5,2,0,16,6,10,12,2,17
990,1149,1155,17,13,7,1,3,3,9,11,-2,5,9,6
991,1149,1155,43,1,7,6,1,0,21,1,20,13,1,19
992,1149,1155,57,10,7,2,2,3,7,10,-3,6,8,8
993,1149,1155,24,16,7,0,2,5,5,14,-9,2,12,2
994,1149,1155,36,6,7,3,1,3,12,13,-1,7,7,10
995,1149,1155,48,11,7,2,1,4,6,11,-5,5,9,7
996,1149,1155,28,15,7,0,3,4,7,14,-7,3,11,3
997,1149,1155,49,3,7,5,1,1,14,6,8,11,3,16
998,1149,1155,7,7,7,2,3,2,9,9,0,7,7,9
999,1149,1155,21,9,7,2,3,2,6,8,-2,7,7,9
1000,1149,1155,4,12,7,2,0,5,6,16,-10,4,10,6
1001,1149,1155,53,4,7,4,2,1,18,9,9,10,4,14
1002,1149,1155,44,8,7,2,3,2,6,6,0,7,7,9
1003,1562,1568,53,5,13,6,3,4,22,13,9,15,11,21
1004,1562,1568,4,10,13,3,6,4,17,18,-1,12,14,15
1005,1562,1568,21,12,13,3,3,7,12,33,-21,9,17,12
1006,1562,1568,7,16,13,2,3,8,11,31,-20,7,19,9
1007,1562,1568,49,2,13,8,4,1,28,10,18,20,6,28
1008,1562,1568,28,4,13,6,4,3,25,18,7,16,10,22
1009,1562,1568,36,14,13,2,5,6,18,23,-5,9,17,11
1010,1562,1568,48,15,13,2,3,8,10,26,-16,7,19,9
1011,1562,1568,43,1,13,13,0,0,43,10,33,26,0,39
1012,1562,1568,57,9,13,4,4,5,16,29,-13,12,14,16
1013,1562,1568,17,7,13,6,1,6,25,27,-2,13,13,19
1014,1562,1568,8,8,13,5,3,5,25,27,-2,13,13,18
1015,1562,1568,30,3,13,6,4,3,33,16,17,16,10,22
1016,1562,1568,41,6,13,6,3,4,22,16,6,15,11,21
1017,1562,1568,1,13,13,2,5,6,17,19,-2,9,17,11
1018,1562,1568,39,11,13,3,3,7,16,24,-8,9,17,12
1019,1618,1624,39,11,20,5,5,10,22,39,-17,15,25,20
1020,1618,1624,30,4,20,9,6,5,41,23,18,24,16,33
1021,1618,1624,41,5,20,9,6,5,34,19,15,24,16,33
1022,1618,1624,17,3,20,11,2,7,41,36,5,24,16,35
1023,1618,1624,8,8,20,9,3,8,33,41,-8,21,19,30
1024,1618,1624,57,13,20,4,5,11,22,43,-21,13,27,17
1025,1618,1624,36,14,20,3,8,9,26,39,-13,14,26,17
1026,1618,1624,48,16,20,3,7,10,18,37,-19,13,27,16
1027,1618,1624,28,7,20,8,7,5,38,30,8,23,17,31
1028,1618,1624,43,1,20,17,2,1,64,15,49,36,4,53
1029,1618,1624,49,2,20,11,6,3,37,21,16,28,12,39
1030,1618,1624,4,10,20,4,9,7,25,28,-3,17,23,21
1031,1618,1624,21,12,20,5,5,10,17,44,-27,15,25,20
1032,1618,1624,7,15,20,3,8,9,15,39,-24,14,26,17
1033,1618,1624,53,6,20,9,5,6,34,17,17,23,17,32
1034,1618,1624,1,9,20,5,6,9,30,26,4,16,24,21
1035,1667,1673,1,9,26,8,7,11,45,33,12,23,29,31
1036,1667,1673,8,8,26,10,4,12,39,54,-15,24,28,34
1037,36,42,39,4,5,3,0,2,11,6,5,6,4,9
1038,36,42,18,11,5,1,2,2,5,10,-5,4,6,5
1039,36,42,1,14,5,0,4,1,3,4,-1,4,6,4
1040,36,42,7,2,5,4,1,0,13,8,5,9,1,13
1041,36,42,4,8,5,2,1,2,9,6,3,5,5,7
1042,36,42,21,12,5,1,1,3,6,8,-2,3,7,4
1043,36,42,53,5,5,3,0,2,7,8,-1,6,4,9
1044,36,42,41,3,5,4,1,0,9,5,4,9,1,13
1045,36,42,49,1,5,4,1,0,13,2,11,9,1,13
1046,36,42,28,13,5,1,1,3,4,10,-6,3,7,4
1047,36,42,50,16,5,0,1,4,4,14,-10,1,9,1
1048,36,42,19,7,5,2,1,2,9,5,4,5,5,7
1049,36,42,17,10,5,2,0,3,6,12,-6,4,6,6
1050,36,42,43,6,5,2,2,1,14,6,8,6,4,8
1051,36,42,34,9,5,2,1,2,9,10,-1,5,5,7
1052,64,70,34,2,8,5,1,2,17,12,5,11,5,16
1053,64,70,43,7,8,3,3,2,21,10,11,9,7,12
1054,64,70,28,14,8,2,1,5,5,15,-10,5,11,7
1055,64,70,50,16,8,1,2,5,8,20,-12,4,12,5
1056,64,70,49,1,8,6,2,0,17,4,13,14,2,20
1057,64,70,17,6,8,4,0,4,9,16,-7,8,8,12
1058,64,70,19,8,8,3,2,3,15,10,5,8,8,11
1059,64,70,41,4,8,4,3,1,10,7,3,11,5,15
1060,64,70,7,5,8,4,2,2,15,13,2,10,6,14
1061,64,70,4,11,8,2,2,4,12,11,1,6,10,8
1062,64,70,21,12,8,2,2,4,13,14,-1,6,10,8
1063,64,70,18,9,8,3,2,3,8,12,-4,8,8,11
1064,64,70,1,13,8,1,5,2,8,10,-2,7,9,8
1065,64,70,53,10,8,3,1,4,10,13,-3,7,9,10
1066,64,70,39,3,8,5,0,3,15,8,7,10,6,15
1067,64,70,29,15,8,1,2,5,6,14,-8,4,12,5
1068,365,371,39,12,1,0,0,1,1,2,-1,0,2,0
1069,365,371,1,6,1,1,0,0,2,1,1,2,0,3
1070,365,371,18,15,1,0,0,1,0,3,-3,0,2,0
1071,365,371,21,3,1,1,0,0,3,1,2,2,0,3
1072,365,371,7,7,1,0,1,0,2,2,0,1,1,1
1073,365,371,4,7,1,0,1,0,2,2,0,1,1,1
1074,365,371,53,9,1,0,1,0,1,1,0,1,1,1
1075,365,371,41,13,1,0,0,1,1,3,-2,0,2,0
1076,365,371,17,11,1,0,0,1,2,3,-1,0,2,0
1077,365,371,19,16,1,0,0,1,1,6,-5,0,2,0
1078,365,371,49,9,1,0,1,0,1,1,0,1,1,1
1079,365,371,28,2,1,1,0,0,3,0,3,2,0,3
1080,365,371,36,13,1,0,0,1,1,3,-2,0,2,0
1081,365,371,43,1,1,1,0,0,6,1,5,2,0,3
1082,365,371,57,3,1,1,0,0,3,1,2,2,0,3
1083,365,371,34,5,1,1,0,0,3,2,1,2,0,3
1084,449,455,43,1,12,9,2,1,32,10,22,20,4,29
1085,449,455,34,10,12,4,2,6,13,19,-6,10,14,14
1086,449,455,57,11,12,4,2,6,21,30,-9,10,14,14
1087,449,455,36,9,12,4,2,6,16,21,-5,10,14,14
1088,449,455,28,12,12,3,4,5,20,18,2,10,14,13
1089,449,455,49,2,12,8,2,2,29,12,17,18,6,26
1090,449,455,19,13,12,3,3,6,18,30,-12,9,15,12
1091,449,455,17,16,12,2,2,8,23,30,-7,6,18,8
1092,449,455,41,6,12,6,2,4,17,12,5,14,10,20
1093,449,455,53,5,12,5,6,1,16,11,5,16,8,21
1094,449,455,4,4,12,6,3,3,18,21,-3,15,9,21
1095,449,455,21,8,12,4,3,5,22,24,-2,11,13,15
1096,449,455,7,14,12,2,5,5,17,23,-6,9,15,11
1097,449,455,1,3,12,7,2,3,18,12,6,16,8,23
1098,449,455,18,7,12,4,3,5,16,16,0,11,13,15
1099,449,455,39,15,12,2,3,7,11,18,-7,7,17,9
1100,946,952,39,16,19,4,4,11,19,34,-15,12,26,16
1101,946,952,21,5,19,10,1,8,32,32,0,21,17,31
1102,946,952,4,7,19,9,2,8,35,36,-1,20,18,29
1103,946,952,7,9,19,8,2,9,27,31,-4,18,20,26
1104,946,952,53,14,19,4,7,8,16,19,-3,15,23,19
1105,946,952,41,3,19,11,0,8,31,24,7,22,16,33
1106,946,952,17,6,19,9,3,7,23,27,-4,21,17,30
1107,946,952,8,12,19,7,3,9,31,28,3,17,21,24
1108,946,952,49,1,19,11,4,4,28,13,15,26,12,37
1109,946,952,36,8,19,8,3,8,27,29,-2,19,19,27
1110,946,952,28,10,19,7,5,7,28,23,5,19,19,26
1111,946,952,48,13,19,6,3,10,14,23,-9,15,23,21
1112,946,952,43,4,19,9,6,4,33,22,11,24,14,33
1113,946,952,57,11,19,7,4,8,23,24,-1,18,20,25
1114,946,952,1,2,19,10,4,5,28,19,9,24,14,34
1115,946,952,18,15,19,4,5,10,16,27,-11,13,25,17
1116,736,742,1,10,2,1,0,1,2,2,0,2,2,3
1117,736,742,18,16,2,0,0,2,0,5,-5,0,4,0
1118,750,756,39,16,4,0,1,3,2,6,-4,1,7,1
1119,785,798,39,14,8,2,2,4,8,11,-3,6,10,8
1120,785,798,1,5,8,4,1,3,13,11,2,9,7,13
1121,785,798,18,16,8,1,3,4,5,12,-7,5,11,6
1122,785,798,53,13,8,2,3,3,8,9,-1,7,9,9
1123,785,798,4,6,8,4,1,3,17,18,-1,9,7,13
1124,785,798,21,12,8,3,1,4,11,16,-5,7,9,10
1125,785,798,7,15,8,2,2,4,9,16,-7,6,10,8
1126,785,798,17,1,8,5,2,1,11,8,3,12,4,17
1127,785,798,8,8,8,3,2,3,18,11,7,8,8,11
1128,785,798,49,3,8,4,1,3,12,8,4,9,7,13
1129,785,798,41,7,8,4,0,4,14,12,2,8,8,12
1130,785,798,43,2,8,4,3,1,15,8,7,11,5,15
1131,785,798,57,4,8,4,1,3,14,12,2,9,7,13
1132,785,798,28,9,8,3,2,3,14,11,3,8,8,11
1133,785,798,36,10,8,3,1,4,12,15,-3,7,9,10
1134,785,798,48,11,8,3,1,4,5,8,-3,7,9,10
1135,1247,1253,36,7,20,9,4,7,29,25,4,22,18,31
1136,1247,1253,28,12,20,5,6,9,29,38,-9,16,24,21
1137,1247,1253,48,15,20,4,4,12,16,35,-19,12,28,16
1138,1247,1253,43,1,20,14,5,1,56,16,40,33,7,47
1139,1247,1253,57,9,20,6,5,9,16,29,-13,17,23,23
1140,1247,1253,24,16,20,2,5,13,16,39,-23,9,31,11
1141,1247,1253,41,6,20,9,4,7,26,21,5,22,18,31
1142,1247,1253,49,3,20,11,5,4,45,22,23,27,13,38
1143,1247,1253,8,2,20,12,6,2,29,17,12,30,10,42
1144,1247,1253,17,11,20,5,6,9,27,30,-3,16,24,21
1145,1247,1253,21,5,20,9,6,5,29,25,4,24,16,33
1146,1247,1253,4,8,20,9,3,8,31,34,-3,21,19,30
1147,1247,1253,7,10,20,5,7,8,23,31,-8,17,23,22
1148,1247,1253,53,4,20,10,6,4,37,20,17,26,14,36
1149,1247,1253,44,13,20,4,7,9,15,27,-12,15,25,19
1150,1247,1253,1,14,20,4,5,11,21,36,-15,13,27,17
1151,1310,1316,53,5,27,11,12,4,44,24,20,34,20,45
1152,1310,1316,44,13,27,6,9,12,24,47,-23,21,33,27
1153,1310,1316,21,7,27,11,9,7,36,33,3,31,23,42
1154,1310,1316,4,8,27,10,6,11,36,42,-6,26,28,36
1155,1310,1316,7,12,27,6,9,12,33,45,-12,21,33,27
1156,1310,1316,8,2,27,14,9,4,43,27,16,37,17,51
1157,1310,1316,17,9,27,7,9,11,36,38,-2,23,31,30
1158,1310,1316,49,3,27,14,8,5,52,25,27,36,18,50
1159,1310,1316,41,6,27,12,6,9,33,27,6,30,24,42
1160,1310,1316,43,1,27,18,8,1,73,21,52,44,10,62
1161,1310,1316,57,10,27,7,9,11,20,38,-18,23,31,30
1162,1310,1316,24,16,27,3,8,16,19,44,-25,14,40,17
1163,1310,1316,36,4,27,13,6,8,42,32,10,32,22,45
1164,1310,1316,48,14,27,7,5,15,26,45,-19,19,35,26
1165,1310,1316,28,15,27,6,8,13,33,48,-15,20,34,26
1166,1310,1316,1,11,27,7,7,13,31,45,-14,21,33,28
1167,1121,1127,48,11,4,1,1,2,3,7,-4,3,5,4
1168,1121,1127,36,12,4,1,0,3,3,7,-4,2,6,3
1169,1121,1127,28,13,4,0,3,1,6,7,-1,3,5,3
1170,1121,1127,43,1,4,3,1,0,11,1,10,7,1,10
1171,1121,1127,57,14,4,0,2,2,3,6,-3,2,6,2
1172,1121,1127,24,15,4,0,2,2,4,8,-4,2,6,2
1173,1121,1127,49,2,4,3,0,1,9,5,4,6,2,9
1174,1121,1127,41,5,4,2,2,0,5,2,3,6,2,8
1175,1121,1127,8,3,4,2,2,0,10,6,4,6,2,8
1176,1121,1127,17,10,4,1,1,2,7,8,-1,3,5,4
1177,1121,1127,21,6,4,2,1,1,4,3,1,5,3,7
1178,1121,1127,4,7,4,2,0,2,5,4,1,4,4,6
1179,1121,1127,7,8,4,1,2,1,7,7,0,4,4,5
1180,1121,1127,53,4,4,2,2,0,5,1,4,6,2,8
1181,1121,1127,44,9,4,1,2,1,4,4,0,4,4,5
1182,1121,1127,1,16,4,0,1,3,1,11,-10,1,7,1
1183,1163,1169,53,3,9,5,3,1,20,9,11,13,5,18
1184,1163,1169,44,6,9,3,4,2,8,7,1,10,8,13
1185,1163,1169,21,7,9,3,4,2,9,9,0,10,8,13
1186,1163,1169,7,10,9,2,4,3,10,12,-2,8,10,10
1187,1163,1169,4,11,9,3,0,6,8,19,-11,6,12,9
1188,1163,1169,8,2,9,6,3,0,18,6,12,15,3,21
1189,1163,1169,17,13,9,1,4,4,9,13,-4,6,12,7
1190,1163,1169,49,5,9,5,2,2,14,8,6,12,6,17
1191,1163,1169,41,4,9,5,3,1,12,6,6,13,5,18
1192,1163,1169,43,1,9,7,1,1,25,5,20,15,3,22
1193,1163,1169,57,12,9,2,3,4,8,12,-4,7,11,9
1194,1163,1169,24,14,9,1,2,6,8,17,-9,4,14,5
1195,1163,1169,36,8,9,3,2,4,12,14,-2,8,10,11
1196,1163,1169,48,9,9,3,2,4,8,12,-4,8,10,11
1197,1163,1169,28,16,9,0,5,4,9,16,-7,5,13,5
1198,1163,1169,1,15,9,1,2,6,6,19,-13,4,14,5
1199,1009,1099,28,7,30,11,11,8,41,35,6,33,27,44
1200,1009,1099,36,10,30,10,6,14,34,42,-8,26,34,36
1201,1009,1099,48,13,30,10,5,15,26,38,-12,25,35,35
1202,778,784,28,7,7,3,1,3,14,11,3,7,7,10
1203,778,784,48,9,7,3,1,3,5,7,-2,7,7,10
1204,778,784,36,13,7,2,1,4,9,13,-4,5,9,7
1205,778,784,57,3,7,4,1,2,12,9,3,9,5,13
1206,778,784,43,5,7,3,3,1,11,6,5,9,5,12
1207,778,784,17,1,7,4,2,1,9,7,2,10,4,14
1208,778,784,8,6,7,3,2,2,17,9,8,8,6,11
1209,778,784,41,10,7,3,0,4,11,10,1,6,8,9
1210,778,784,4,4,7,4,1,2,14,13,1,9,5,13
1211,778,784,7,12,7,2,2,3,9,13,-4,6,8,8
1212,778,784,21,14,7,2,1,4,10,16,-6,5,9,7
1213,778,784,49,2,7,4,1,2,10,4,6,9,5,13
1214,778,784,1,8,7,3,1,3,8,8,0,7,7,10
1215,778,784,18,16,7,1,2,4,5,12,-7,4,10,5
1216,778,784,53,15,7,1,3,3,5,9,-4,5,9,6
1217,778,784,39,11,7,2,2,3,6,8,-2,6,8,8
1218,1135,1148,1,14,6,1,1,4,3,13,-10,3,9,4
1219,1135,1148,53,4,6,3,2,1,14,8,6,8,4,11
1220,1135,1148,44,13,6,1,3,2,4,6,-2,5,7,6
1221,1135,1148,21,7,6,2,2,2,5,7,-2,6,6,8
1222,1135,1148,4,10,6,2,0,4,6,10,-4,4,8,6
1223,1135,1148,7,12,6,1,3,2,7,8,-1,5,7,6
1224,1135,1148,49,2,6,5,0,1,13,5,8,10,2,15
1225,1135,1148,41,5,6,3,2,1,7,4,3,8,4,11
1226,1135,1148,8,3,6,4,2,0,14,6,8,10,2,14
1227,1135,1148,17,11,6,1,3,2,8,9,-1,5,7,6
1228,1135,1148,43,1,6,5,1,0,15,1,14,11,1,16
1229,1135,1148,57,6,6,2,2,2,7,8,-1,6,6,8
1230,1135,1148,24,16,6,0,2,4,4,10,-6,2,10,2
1231,1135,1148,36,8,6,2,1,3,9,12,-3,5,7,7
1232,1135,1148,48,9,6,2,1,3,5,9,-4,5,7,7
1233,1135,1148,28,15,6,0,3,3,7,12,-5,3,9,3
1234,1569,1575,28,6,14,6,4,4,26,20,6,16,12,22
1235,1569,1575,36,13,14,2,6,6,18,23,-5,10,18,12
1236,1569,1575,48,15,14,2,4,8,11,27,-16,8,20,10
1237,1569,1575,43,1,14,14,0,0,50,10,40,28,0,42
1238,1569,1575,57,9,14,4,5,5,17,30,-13,13,15,17
1239,1569,1575,8,8,14,5,3,6,25,34,-9,13,15,18
1240,1569,1575,17,4,14,7,1,6,27,28,-1,15,13,22
1241,1569,1575,30,5,14,6,4,4,33,18,15,16,12,22
1242,1569,1575,41,7,14,6,4,4,23,17,6,16,12,22
1243,1569,1575,4,10,14,3,7,4,17,18,-1,13,15,16
1244,1569,1575,21,12,14,3,4,7,12,33,-21,10,18,13
1245,1569,1575,7,16,14,2,4,8,11,31,-20,8,20,10
1246,1569,1575,49,2,14,9,4,1,30,11,19,22,6,31
1247,1569,1575,1,14,14,2,5,7,18,21,-3,9,19,11
1248,1569,1575,53,3,14,7,3,4,24,13,11,17,11,24
1249,1569,1575,39,11,14,3,4,7,17,25,-8,10,18,13
1250,1576,1589,39,13,15,3,5,7,17,25,-8,11,19,14
1251,1576,1589,53,5,15,7,3,5,24,14,10,17,13,24
1252,1576,1589,1,12,15,3,5,7,22,21,1,11,19,14
1253,1576,1589,4,10,15,3,8,4,17,18,-1,14,16,17
1254,1576,1589,21,11,15,4,4,7,15,34,-19,12,18,16
1255,1576,1589,7,15,15,2,5,8,12,32,-20,9,21,11
1256,1576,1589,49,2,15,9,4,2,31,14,17,22,8,31
1257,1576,1589,30,4,15,7,4,4,34,18,16,18,12,25
1258,1576,1589,41,7,15,6,5,4,23,17,6,17,13,23
1259,1576,1589,17,3,15,8,1,6,28,28,0,17,13,25
1260,1576,1589,8,8,15,6,3,6,27,35,-8,15,15,21
1261,1576,1589,43,1,15,14,0,1,50,11,39,28,2,42
1262,1576,1589,57,9,15,4,5,6,18,32,-14,13,17,17
1263,1576,1589,28,6,15,6,5,4,26,20,6,17,13,23
1264,1576,1589,36,14,15,2,7,6,19,24,-5,11,19,13
1265,1576,1589,48,16,15,2,4,9,11,31,-20,8,22,10
1266,1625,1631,28,7,21,8,7,6,38,31,7,23,19,31
1267,1625,1631,48,15,21,4,7,10,20,37,-17,15,27,19
1268,1625,1631,36,16,21,3,8,10,26,40,-14,14,28,17
1269,1625,1631,43,1,21,18,2,1,65,15,50,38,4,56
1270,1625,1631,57,13,21,5,5,11,23,43,-20,15,27,20
1271,1625,1631,30,4,21,9,7,5,42,24,18,25,17,34
1272,1625,1631,41,5,21,9,7,5,35,20,15,25,17,34
1273,1625,1631,17,3,21,11,2,8,41,37,4,24,18,35
1274,1625,1631,8,8,21,9,3,9,33,43,-10,21,21,30
1275,1625,1631,4,10,21,4,10,7,27,30,-3,18,24,22
1276,1625,1631,21,11,21,5,6,10,17,44,-27,16,26,21
1277,1625,1631,7,14,21,4,8,9,18,40,-22,16,26,20
1278,1625,1631,49,2,21,12,6,3,38,21,17,30,12,42
1279,400,406,39,12,6,1,2,3,3,6,-3,4,8,5
1280,407,413,39,13,7,1,2,4,4,9,-5,4,10,5
1281,407,413,1,6,7,4,1,2,10,10,0,9,5,13
1282,407,413,18,8,7,3,1,3,12,10,2,7,7,10
1283,407,413,53,7,7,3,3,1,10,7,3,9,5,12
1284,407,413,4,3,7,4,2,1,13,11,2,10,4,14
1285,407,413,21,4,7,4,1,2,18,11,7,9,5,13
1286,407,413,7,16,7,0,4,3,7,14,-7,4,10,4
1287,407,413,41,9,7,3,1,3,9,8,1,7,7,10
1288,407,413,49,2,7,4,2,1,16,8,8,10,4,14
1289,407,413,17,12,7,1,2,4,14,17,-3,4,10,5
1290,407,413,19,14,7,1,2,4,9,19,-10,4,10,5
1291,407,413,43,1,7,6,1,0,20,4,16,13,1,19
1292,407,413,34,5,7,4,1,2,12,8,4,9,5,13
1293,407,413,57,11,7,2,0,5,12,26,-14,4,10,6
1294,407,413,28,10,7,2,2,3,14,11,3,6,8,8
1295,407,413,36,15,7,1,1,5,5,12,-7,3,11,4
1296,806,812,36,10,10,4,2,4,13,15,-2,10,10,14
1297,806,812,48,12,10,4,1,5,8,11,-3,9,11,13
1298,806,812,28,8,10,4,2,4,18,14,4,10,10,14
1299,806,812,43,1,10,5,4,1,18,9,9,14,6,19
1300,806,812,57,4,10,5,2,3,17,13,4,12,8,17
1301,806,812,41,2,10,6,0,4,17,12,5,12,8,18
1302,806,812,49,6,10,4,3,3,13,9,4,11,9,15
1303,806,812,17,3,10,5,3,2,13,12,1,13,7,18
1304,806,812,8,7,10,4,2,4,22,15,7,10,10,14
1305,806,812,7,11,10,4,2,4,13,17,-4,10,10,14
1306,806,812,4,13,10,4,1,5,19,23,-4,9,11,13
1307,806,812,21,5,10,5,1,4,15,18,-3,11,9,16
1308,806,812,53,14,10,2,3,5,9,12,-3,7,13,9
1309,806,812,18,16,10,1,4,5,7,16,-9,6,14,7
1310,806,812,1,9,10,4,2,4,13,13,0,10,10,14
1311,806,812,39,15,10,2,2,6,11,17,-6,6,14,8
1312,960,966,39,16,21,4,5,12,21,38,-17,13,29,17
1313,960,966,1,3,21,10,5,6,29,21,8,25,17,35
1314,960,966,18,14,21,5,5,11,18,28,-10,15,27,20
1315,960,966,53,15,21,4,8,9,16,21,-5,16,26,20
1316,960,966,21,2,21,12,1,8,36,33,3,25,17,37
1317,960,966,7,7,21,10,2,9,32,32,0,22,20,32
1318,960,966,4,8,21,10,2,9,38,39,-1,22,20,32
1319,960,966,41,4,21,11,1,9,31,25,6,23,19,34
1320,960,966,17,5,21,10,3,8,26,30,-4,23,19,33
1321,960,966,8,12,21,8,3,10,32,30,2,19,23,27
1322,960,966,49,1,21,12,4,5,31,16,15,28,14,40
1323,960,966,43,6,21,9,6,6,33,25,8,24,18,33
1324,960,966,57,11,21,8,5,8,24,24,0,21,21,29
1325,960,966,36,9,21,9,3,9,29,31,-2,21,21,30
1326,960,966,28,10,21,8,6,7,30,23,7,22,20,30
1327,960,966,48,13,21,7,3,11,16,26,-10,17,25,24
1328,988,994,28,9,27,10,9,8,38,33,5,29,25,39
1329,988,994,36,12,27,9,5,13,29,37,-8,23,31,32
1330,988,994,48,13,27,8,5,14,19,34,-15,21,33,29
1331,988,994,43,4,27,13,6,8,44,32,12,32,22,45
1332,988,994,57,10,27,10,6,11,30,37,-7,26,28,36
1333,988,994,49,1,27,17,4,6,41,18,23,38,16,55
1334,988,994,17,7,27,13,3,11,35,35,0,29,25,42
1335,988,994,8,11,27,9,5,13,35,38,-3,23,31,32
1336,988,994,41,6,27,14,2,11,40,34,6,30,24,44
1337,988,994,21,2,27,16,2,9,51,42,9,34,20,50
1338,988,994,4,3,27,14,3,10,51,45,6,31,23,45
1339,988,994,7,5,27,14,2,11,42,36,6,30,24,44
1340,988,994,53,14,27,6,11,10,22,24,-2,23,31,29
1341,988,994,1,8,27,12,5,10,33,30,3,29,25,41
1342,988,994,18,16,27,5,6,16,24,40,-16,16,38,21
1343,988,994,39,15,27,6,6,15,26,45,-19,18,36,24
1344,743,749,39,16,3,0,0,3,1,5,-4,0,6,0
1345,743,749,1,13,3,1,0,2,2,3,-1,2,4,3
1346,743,749,18,14,3,1,0,2,1,5,-4,2,4,3
1347,743,749,53,15,3,0,1,2,3,7,-4,1,5,1
1348,743,749,4,4,3,2,0,1,8,7,1,4,2,6
1349,743,749,21,5,3,2,0,1,7,6,1,4,2,6
1350,743,749,7,8,3,2,0,1,6,8,-2,4,2,6
1351,743,749,49,12,3,1,0,2,3,4,-1,2,4,3
1352,743,749,41,3,3,2,0,1,8,4,4,4,2,6
1353,743,749,8,2,3,2,0,1,14,7,7,4,2,6
1354,743,749,17,6,3,2,0,1,4,5,-1,4,2,6
1355,743,749,57,1,3,2,1,0,7,3,4,5,1,7
1356,743,749,43,9,3,1,2,0,4,2,2,4,2,5
1357,743,749,48,6,3,2,0,1,4,5,-1,4,2,6
1358,743,749,36,10,3,1,0,2,4,4,0,2,4,3
1359,568,581,1,5,26,12,7,7,37,29,8,31,21,43
1360,568,581,18,13,26,7,6,13,30,35,-5,20,32,27
1361,568,581,53,11,26,7,9,10,28,34,-6,23,29,30
1362,568,581,49,2,26,15,3,8,46,25,21,33,19,48
1363,568,581,41,4,26,12,7,7,29,20,9,31,21,43
1364,568,581,21,3,26,12,9,5,50,38,12,33,19,45
1365,568,581,4,6,26,10,7,9,35,40,-5,27,25,37
1366,568,581,7,7,26,9,8,9,37,38,-1,26,26,35
1367,568,581,17,9,26,9,5,12,44,49,-5,23,29,32
1368,568,581,19,15,26,6,8,12,34,52,-18,20,32,26
1369,568,581,43,1,26,21,4,1,67,19,48,46,6,67
1370,568,581,57,14,26,7,5,14,36,59,-23,19,33,26
1371,568,581,34,16,26,6,5,15,24,49,-25,17,35,23
1372,568,581,36,10,26,8,6,12,31,41,-10,22,30,30
1373,568,581,28,12,26,7,8,11,42,40,2,22,30,29
1374,603,609,28,10,29,9,8,12,47,42,5,26,32,35
1375,603,609,36,11,29,9,7,13,40,49,-9,25,33,34
1376,603,609,43,1,29,21,6,2,72,26,46,48,10,69
1377,603,609,57,14,29,8,6,15,38,64,-26,22,36,30
1378,603,609,34,16,29,6,5,18,25,61,-36,17,41,23
1379,603,609,17,9,29,10,6,13,48,54,-6,26,32,36
1380,603,609,19,12,29,8,8,13,42,59,-17,24,34,32
1381,603,609,21,3,29,15,9,5,67,43,24,39,19,54
1382,603,609,7,6,29,10,8,11,44,46,-2,28,30,38
1383,603,609,4,7,29,10,7,12,37,47,-10,27,31,37
1384,603,609,41,4,29,13,9,7,33,23,10,35,23,48
1385,603,609,49,2,29,18,3,8,57,31,26,39,19,57
1386,603,609,53,13,29,7,11,11,29,36,-7,25,33,32
1387,603,609,1,5,29,13,8,8,40,33,7,34,24,47
1388,603,609,18,15,29,7,9,13,33,38,-5,23,35,30
1389,603,609,39,8,29,10,6,13,35,35,0,26,32,36
1390,386,392,39,15,4,0,1,3,1,5,-4,1,7,1
1391,386,392,1,4,4,3,0,1,6,5,1,6,2,9
1392,386,392,18,8,4,2,0,2,8,7,1,4,4,6
1393,386,392,53,5,4,2,2,0,7,4,3,6,2,8
1394,386,392,49,9,4,1,2,1,5,5,0,4,4,5
1395,386,392,4,2,4,3,1,0,9,4,5,7,1,10
1396,386,392,21,6,4,2,1,1,9,7,2,5,3,7
1397,386,392,7,13,4,0,3,1,5,8,-3,3,5,3
1398,386,392,41,7,4,2,1,1,5,3,2,5,3,7
1399,386,392,19,11,4,1,1,2,7,12,-5,3,5,4
1400,386,392,17,14,4,0,1,3,6,10,-4,1,7,1
1401,386,392,43,1,4,4,0,0,15,2,13,8,0,12
1402,386,392,34,3,4,3,0,1,8,5,3,6,2,9
1403,386,392,57,12,4,1,0,3,6,14,-8,2,6,3
1404,386,392,28,10,4,1,1,2,7,6,1,3,5,4
1405,386,392,36,16,4,0,0,4,1,8,-7,0,8,0
1406,421,427,28,10,9,3,2,4,18,14,4,8,10,11
1407,421,427,36,11,9,3,1,5,13,16,-3,7,11,10
1408,421,427,34,9,9,4,1,4,13,13,0,9,9,13
1409,421,427,57,12,9,3,1,5,15,27,-12,7,11,10
1410,421,427,43,1,9,7,2,0,26,6,20,16,2,23
1411,421,427,19,13,9,2,2,5,14,24,-10,6,12,8
1412,421,427,17,16,9,1,2,6,16,24,-8,4,14,5
1413,421,427,41,7,9,4,2,3,11,9,2,10,8,14
1414,421,427,4,5,9,4,3,2,14,16,-2,11,7,15
1415,421,427,21,8,9,4,1,4,19,17,2,9,9,13
1416,421,427,7,14,9,1,4,4,11,17,-6,6,12,7
1417,421,427,49,2,9,5,2,2,20,11,9,12,6,17
1418,421,427,53,4,9,4,4,1,12,8,4,12,6,16
1419,421,427,39,15,9,1,3,5,6,12,-6,5,13,6
1420,421,427,1,3,9,5,2,2,12,11,1,12,6,17
1421,421,427,18,6,9,4,2,3,15,10,5,10,8,14
1422,918,924,39,16,15,2,3,10,13,31,-18,7,23,9
1423,918,924,53,15,15,3,5,7,12,17,-5,11,19,14
1424,918,924,1,6,15,7,3,5,20,17,3,17,13,24
1425,918,924,18,14,15,4,5,6,14,18,-4,13,17,17
1426,918,924,49,2,15,8,4,3,21,9,12,20,10,28
1427,918,924,21,1,15,9,1,5,28,25,3,19,11,28
1428,918,924,4,10,15,6,2,7,30,33,-3,14,16,20
1429,918,924,7,12,15,5,2,8,19,25,-6,12,18,17
1430,918,924,41,4,15,9,0,6,23,18,5,18,12,27
1431,918,924,17,5,15,8,3,4,19,18,1,19,11,27
1432,918,924,8,7,15,6,3,6,28,22,6,15,15,21
1433,918,924,43,3,15,8,4,3,28,17,11,20,10,28
1434,918,924,57,9,15,6,3,6,20,19,1,15,15,21
1435,918,924,28,8,15,6,3,6,23,18,5,15,15,21
1436,918,924,36,11,15,5,3,7,19,24,-5,13,17,18
1437,918,924,48,13,15,5,2,8,11,17,-6,12,18,17
1438,1177,1190,36,6,11,5,2,4,18,15,3,12,10,17
1439,99,105,28,14,12,3,2,7,8,20,-12,8,16,11
1440,99,105,50,15,12,2,3,7,12,25,-13,7,17,9
1441,99,105,43,2,12,7,3,2,28,12,16,17,7,24
1442,99,105,34,4,12,7,2,3,26,24,2,16,8,23
1443,99,105,4,7,12,5,3,4,20,15,5,13,11,18
1444,99,105,7,8,12,5,2,5,19,19,0,12,12,17
1445,99,105,21,12,12,4,2,6,19,21,-2,10,14,14
1446,99,105,41,1,12,7,4,1,19,12,7,18,6,25
1447,99,105,49,3,12,7,3,2,21,9,12,17,7,24
1448,99,105,19,5,12,6,2,4,25,15,10,14,10,20
1449,99,105,17,10,12,5,0,7,14,24,-10,10,14,15
1450,99,105,53,6,12,6,1,5,25,19,6,13,11,19
1451,99,105,18,11,12,4,3,5,12,19,-7,11,13,15
1452,99,105,1,13,12,3,5,4,14,16,-2,11,13,14
1453,99,105,39,9,12,5,1,6,18,16,2,11,13,16
1454,99,105,29,16,12,1,2,9,7,21,-14,4,20,5
1455,232,238,29,16,28,5,6,17,25,49,-24,16,40,21
1456,232,238,39,13,28,10,3,15,41,53,-12,23,33,33
1457,232,238,1,10,28,8,11,9,42,47,-5,27,29,35
1458,232,238,18,14,28,6,13,9,26,40,-14,25,31,31
1459,232,238,53,5,28,12,6,10,44,38,6,30,26,42
1460,232,238,19,6,28,12,5,11,47,38,9,29,27,41
1461,232,238,17,12,28,9,7,12,41,56,-15,25,31,34
1462,232,238,49,1,28,17,8,3,59,24,35,42,14,59
1463,232,238,41,2,28,14,11,3,45,21,24,39,17,53
1464,232,238,7,4,28,12,7,9,41,37,4,31,25,43
1465,232,238,4,9,28,9,8,11,46,40,6,26,30,35
1466,232,238,21,11,28,9,7,12,41,43,-2,25,31,34
1467,232,238,43,3,28,15,7,6,53,27,26,37,19,52
1468,232,238,34,8,28,9,10,9,45,57,-12,28,28,37
1469,232,238,28,7,28,11,6,11,30,32,-2,28,28,39
1470,232,238,50,15,28,5,7,16,26,50,-24,17,39,22
1471,239,245,28,7,29,12,6,11,32,33,-1,30,28,42
1472,239,245,50,16,29,5,8,16,27,51,-24,18,40,23
1473,239,245,43,3,29,15,7,7,53,28,25,37,21,52
1474,239,245,34,9,29,9,10,10,46,60,-14,28,30,37
1475,239,245,7,4,29,13,7,9,42,37,5,33,25,46
1476,239,245,21,8,29,10,7,12,43,44,-1,27,31,37
1477,239,245,4,10,29,9,8,12,47,42,5,26,32,35
1478,239,245,41,2,29,15,11,3,48,22,26,41,17,56
1479,239,245,49,1,29,17,9,3,60,25,35,43,15,60
1480,239,245,19,6,29,12,6,11,48,39,9,30,28,42
1481,239,245,17,11,29,9,8,12,42,57,-15,26,32,35
1482,239,245,53,5,29,13,6,10,47,38,9,32,26,45
1483,239,245,1,12,29,8,11,10,42,48,-6,27,31,35
1484,239,245,18,14,29,6,13,10,27,42,-15,25,33,31
1485,239,245,39,13,29,10,3,16,41,56,-15,23,35,33
1486,239,245,29,15,29,6,6,17,26,49,-23,18,40,24
1487,470,483,39,10,15,5,3,7,19,20,-1,13,17,18
1488,470,483,1,3,15,8,3,4,20,14,6,19,11,27
1489,470,483,18,12,15,4,4,7,18,20,-2,12,18,16
1490,470,483,53,7,15,5,7,3,17,19,-2,17,13,22
1491,470,483,19,15,15,3,4,8,20,34,-14,10,20,13
1492,470,483,17,16,15,3,2,10,26,35,-9,8,22,11
1493,470,483,49,2,15,9,3,3,31,14,17,21,9,30
1494,470,483,41,4,15,8,2,5,19,13,6,18,12,26
1495,470,483,4,5,15,7,4,4,21,22,-1,18,12,25
1496,470,483,21,6,15,6,4,5,27,26,1,16,14,22
1497,470,483,7,9,15,5,5,5,26,25,1,15,15,20
1498,470,483,57,11,15,5,2,8,27,39,-12,12,18,17
1499,470,483,34,13,15,4,2,9,14,28,-14,10,20,14
1500,470,483,36,8,15,6,3,6,19,22,-3,15,15,21
1501,470,483,28,14,15,3,4,8,22,24,-2,10,20,13
1502,470,483,43,1,15,12,2,1,42,13,29,26,4,38
1503,834,840,28,8,13,6,2,5,22,16,6,14,12,20
1504,834,840,48,11,13,5,2,6,11,14,-3,12,14,17
1505,834,840,36,13,13,4,2,7,16,22,-6,10,16,14
1506,834,840,43,5,13,6,4,3,22,15,7,16,10,22
1507,834,840,57,9,13,6,2,5,19,17,2,14,12,20
1508,834,840,21,3,13,7,1,5,25,24,1,15,11,22
1509,834,840,4,10,13,5,2,6,25,28,-3,12,14,17
1510,834,840,7,12,13,5,2,6,17,21,-4,12,14,17
1511,834,840,41,6,13,7,0,6,19,18,1,14,12,21
1512,834,840,49,4,13,6,4,3,19,9,10,16,10,22
1513,834,840,17,1,13,7,3,3,18,17,1,17,9,24
1514,834,840,8,7,13,6,2,5,27,19,8,14,12,20
1515,834,840,53,14,13,3,4,6,10,13,-3,10,16,13
1516,834,840,1,2,13,7,2,4,19,15,4,16,10,23
1517,1212,1218,44,9,15,4,6,5,13,18,-5,14,16,18
1518,1212,1218,1,13,15,3,4,8,15,28,-13,10,20,13
1519,1597,1603,1,14,17,3,6,8,22,22,0,12,22,15
1520,1597,1603,53,4,17,8,4,5,30,15,15,20,14,28
1521,1597,1603,21,9,17,5,4,8,16,38,-22,14,20,19
1522,1597,1603,4,13,17,3,8,6,19,23,-4,14,20,17
1523,1597,1603,7,15,17,2,7,8,14,34,-20,11,23,13
1524,1597,1603,49,2,17,10,5,2,36,18,18,25,9,35
1525,1597,1603,17,3,17,10,1,6,37,32,5,21,13,31
1526,1597,1603,8,5,17,8,3,6,30,36,-6,19,15,27
1527,1597,1603,30,6,17,7,5,5,36,21,15,19,15,26
1528,1597,1603,41,7,17,7,5,5,25,19,6,19,15,26
1529,1597,1603,28,8,17,6,6,5,28,27,1,18,16,24
1530,1597,1603,36,12,17,3,8,6,23,27,-4,14,20,17
1531,1597,1603,48,16,17,2,5,10,14,35,-21,9,25,11
1532,1597,1603,43,1,17,15,1,1,55,12,43,31,3,46
1533,1597,1603,57,11,17,4,5,8,20,36,-16,13,21,17
1534,1597,1603,39,10,17,4,5,8,20,30,-10,13,21,17
1535,1653,1659,39,12,24,6,5,13,25,49,-24,17,31,23
1536,1653,1659,43,1,24,21,2,1,73,16,57,44,4,65
1537,1653,1659,57,15,24,5,6,13,25,53,-28,16,32,21
1538,1653,1659,28,7,24,9,8,7,41,35,6,26,22,35
1539,1653,1659,48,13,24,5,8,11,24,41,-17,18,30,23
1540,1653,1659,36,16,24,4,8,12,29,49,-20,16,32,20
1541,1653,1659,30,3,24,11,8,5,52,29,23,30,18,41
1542,1653,1659,41,4,24,11,7,6,39,22,17,29,19,40
1543,1653,1659,17,6,24,11,2,11,41,40,1,24,24,35
1544,1653,1659,8,8,24,10,4,10,38,46,-8,24,24,34
1545,1653,1659,7,10,24,6,9,9,24,43,-19,21,27,27
1546,1653,1659,21,11,24,6,7,11,20,47,-27,19,29,25
1547,1653,1659,4,14,24,4,11,9,30,37,-7,19,29,23
1548,1653,1659,49,2,24,13,6,5,41,26,15,32,16,45
1549,1653,1659,53,5,24,11,6,7,41,19,22,28,20,39
1550,1653,1659,1,9,24,7,7,10,39,30,9,21,27,28
1551,1499,1505,1,5,5,2,2,1,11,5,6,6,4,8
1552,1499,1505,53,3,5,3,1,1,9,3,6,7,3,10
1553,1499,1505,4,7,5,2,2,1,11,9,2,6,4,8
1554,1499,1505,7,14,5,1,1,3,4,15,-11,3,7,4
1555,1499,1505,21,16,5,0,2,3,3,13,-10,2,8,2
1556,1499,1505,49,4,5,2,3,0,12,4,8,7,3,9
1557,1499,1505,41,6,5,2,2,1,13,8,5,6,4,8
1558,1499,1505,30,10,5,1,2,2,7,9,-2,4,6,5
1559,1499,1505,28,11,5,1,1,3,3,8,-5,3,7,4
1560,1499,1505,48,12,5,1,1,3,3,9,-6,3,7,4
1561,1499,1505,36,15,5,0,2,3,4,9,-5,2,8,2
1562,1499,1505,43,1,5,5,0,0,20,2,18,10,0,15
1563,1499,1505,57,13,5,1,1,3,7,14,-7,3,7,4
1564,1499,1505,17,2,5,4,1,0,12,4,8,9,1,13
1565,1499,1505,8,9,5,2,0,3,13,19,-6,4,6,6
1566,1499,1505,39,8,5,2,1,2,7,8,-1,5,5,7
1567,1513,1526,39,6,7,3,2,2,11,10,1,8,6,11
1568,1513,1526,17,4,7,4,1,2,14,11,3,9,5,13
1569,1513,1526,8,8,7,3,0,4,17,20,-3,6,8,9
1570,1513,1526,43,1,7,7,0,0,26,6,20,14,0,21
1571,1513,1526,57,13,7,2,1,4,8,22,-14,5,9,7
1572,1513,1526,28,10,7,2,2,3,11,8,3,6,8,8
1573,1513,1526,48,14,7,1,2,4,3,13,-10,4,10,5
1574,1513,1526,36,16,7,0,2,5,7,14,-7,2,12,2
1575,1513,1526,41,3,7,4,2,1,18,8,10,10,4,14
1576,1513,1526,30,11,7,2,2,3,9,11,-2,6,8,8
1577,1513,1526,49,2,7,4,3,0,18,7,11,11,3,15
1578,1513,1526,4,5,7,3,2,2,15,13,2,8,6,11
1579,1513,1526,21,12,7,2,2,3,6,14,-8,6,8,8
1580,1513,1526,7,15,7,1,2,4,7,20,-13,4,10,5
1581,1513,1526,53,7,7,3,1,3,10,6,4,7,7,10
1582,1513,1526,1,9,7,2,2,3,12,9,3,6,8,8
1583,1933,1939,1,10,14,4,5,5,25,20,5,13,15,17
1584,1933,1939,21,6,14,6,4,4,22,19,3,16,12,22
1585,1933,1939,4,8,14,5,4,5,23,29,-6,14,14,19
1586,1933,1939,7,11,14,4,4,6,13,10,3,12,16,16
1587,1933,1939,53,3,14,9,3,2,20,12,8,21,7,30
1588,1933,1939,49,5,14,6,4,4,21,11,10,16,12,22
1589,1933,1939,41,7,14,5,4,5,26,25,1,14,14,19
1590,1933,1939,30,9,14,5,3,6,13,22,-9,13,15,18
1591,1933,1939,8,13,14,3,2,9,13,27,-14,8,20,11
1592,1933,1939,17,15,14,1,5,8,8,24,-16,7,21,8
1593,1933,1939,28,2,14,12,1,1,27,10,17,25,3,37
1594,1933,1939,48,12,14,4,3,7,14,22,-8,11,17,15
1595,1933,1939,52,14,14,2,3,9,10,25,-15,7,21,9
1596,1933,1939,43,1,14,12,1,1,38,7,31,25,3,37
1597,1,7,50,13,1,0,0,1,0,1,-1,0,2,0
1598,1,7,28,14,1,0,0,1,0,2,-2,0,2,0
1599,1,7,43,1,1,1,0,0,7,0,7,2,0,3
1600,1,7,34,4,1,1,0,0,3,2,1,2,0,3
1601,1,7,19,2,1,1,0,0,5,0,5,2,0,3
1602,1,7,17,15,1,0,0,1,0,5,-5,0,2,0
1603,1,7,41,5,1,1,0,0,2,1,1,2,0,3
1604,1,7,49,3,1,1,0,0,2,0,2,2,0,3
1605,1,7,7,5,1,1,0,0,2,1,1,2,0,3
1606,1,7,21,9,1,0,0,1,2,3,-1,0,2,0
1607,1,7,4,10,1,0,0,1,1,2,-1,0,2,0
1608,1,7,53,8,1,1,0,0,1,0,1,2,0,3
1609,1,7,1,10,1,0,0,1,1,2,-1,0,2,0
1610,1,7,18,16,1,0,0,1,0,7,-7,0,2,0
1611,1,7,39,5,1,1,0,0,2,1,1,2,0,3
1612,1,7,29,10,1,0,0,1,1,2,-1,0,2,0
1613,246,364,29,15,30,6,6,18,26,54,-28,18,42,24
1614,246,364,39,13,30,10,3,17,41,57,-16,23,37,33
1615,246,364,1,11,30,9,11,10,45,50,-5,29,31,38
1616,246,364,18,14,30,6,14,10,27,42,-15,26,34,32
1617,246,364,53,4,30,13,7,10,47,38,9,33,27,46
1618,246,364,41,2,30,15,11,4,50,25,25,41,19,56
1619,246,364,7,5,30,13,7,10,42,44,-2,33,27,46
1620,246,364,21,8,30,11,7,12,46,46,0,29,31,40
1621,246,364,4,9,30,10,8,12,52,42,10,28,32,38
1622,246,364,43,3,30,15,7,8,55,31,24,37,23,52
1623,246,364,34,12,30,9,10,11,47,63,-16,28,32,37
1624,246,364,28,7,30,12,7,11,32,33,-1,31,29,43
1625,246,364,50,16,30,5,9,16,27,51,-24,19,41,24
1626,246,364,19,6,30,13,6,11,49,39,10,32,28,45
1627,246,364,17,10,30,10,8,12,45,58,-13,28,32,38
1628,246,364,49,1,30,18,9,3,67,25,42,45,15,63
1629,71,84,49,1,9,7,2,0,19,5,14,16,2,23
1630,71,84,17,8,9,4,0,5,10,18,-8,8,10,12
1631,71,84,19,10,9,3,2,4,16,13,3,8,10,11
1632,71,84,28,14,9,2,2,5,6,16,-10,6,12,8
1633,71,84,50,16,9,1,2,6,8,21,-13,4,14,5
1634,71,84,34,2,9,6,1,2,20,13,7,13,5,19
1635,71,84,43,5,9,4,3,2,23,10,13,11,7,15
1636,71,84,41,3,9,5,3,1,11,7,4,13,5,18
1637,71,84,7,6,9,4,2,3,17,17,0,10,8,14
1638,71,84,4,11,9,3,2,4,15,12,3,8,10,11
1639,71,84,21,13,9,2,2,5,14,17,-3,6,12,8
1640,71,84,53,7,9,4,1,4,11,13,-2,9,9,13
1641,71,84,18,9,9,3,3,3,9,13,-4,9,9,12
1642,71,84,1,12,9,2,5,2,12,12,0,9,9,11
1643,71,84,39,4,9,5,0,4,15,10,5,10,8,15
1644,71,84,29,15,9,1,2,6,6,15,-9,4,14,5
1645,428,441,39,15,10,1,3,6,8,15,-7,5,15,6
1646,428,441,1,3,10,6,2,2,15,11,4,14,6,20
1647,428,441,18,8,10,4,2,4,15,13,2,10,10,14
1648,428,441,53,5,10,4,5,1,13,9,4,13,7,17
1649,428,441,4,6,10,4,3,3,14,20,-6,11,9,15
1650,428,441,21,7,10,4,2,4,20,18,2,10,10,14
1651,428,441,7,13,10,2,4,4,14,19,-5,8,12,10
1652,428,441,41,4,10,5,2,3,15,9,6,12,8,17
1653,428,441,36,9,10,4,1,5,15,17,-2,9,11,13
1654,428,441,28,11,10,3,3,4,19,15,4,9,11,12
1655,428,441,43,1,10,8,2,0,28,7,21,18,2,26
1656,428,441,34,10,10,4,1,5,13,18,-5,9,11,13
1657,428,441,57,12,10,3,1,6,16,29,-13,7,13,10
1658,428,441,19,14,10,2,3,5,15,25,-10,7,13,9
1659,428,441,17,16,10,1,2,7,17,26,-9,4,16,5
1660,428,441,49,2,10,6,2,2,25,11,14,14,6,20
1661,519,525,49,2,21,13,3,5,39,18,21,29,13,42
1662,519,525,17,14,21,6,3,12,35,43,-8,15,27,21
1663,519,525,19,16,21,3,7,11,27,49,-22,13,29,16
1664,519,525,28,9,21,7,5,9,34,29,5,19,23,26
1665,519,525,36,7,21,8,4,9,27,33,-6,20,22,28
1666,519,525,43,1,21,17,3,1,56,17,39,37,5,54
1667,519,525,57,12,21,6,5,10,33,45,-12,17,25,23
1668,519,525,34,15,21,5,5,11,19,37,-18,15,27,20
1669,519,525,41,6,21,9,5,7,23,20,3,23,19,32
1670,519,525,21,4,21,9,7,5,36,30,6,25,17,34
1671,519,525,4,5,21,9,6,6,29,32,-3,24,18,33
1672,519,525,7,11,21,6,7,8,32,35,-3,19,23,25
1673,519,525,53,8,21,6,9,6,25,26,-1,21,21,27
1674,519,525,18,13,21,6,4,11,24,27,-3,16,26,22
1675,519,525,1,3,21,10,5,6,29,22,7,25,17,35
1676,519,525,39,10,21,7,4,10,25,30,-5,18,24,25
1677,834,840,18,15,13,3,4,6,12,18,-6,10,16,13
1678,834,840,39,16,13,2,2,9,13,28,-15,6,20,8
1679,974,976,39,15,23,6,5,12,24,39,-15,17,29,23
1680,974,976,1,7,23,10,5,8,29,25,4,25,21,35
1681,974,976,18,16,23,5,6,12,20,31,-11,16,30,21
1682,974,976,53,13,23,6,8,9,20,21,-1,20,26,26
1683,974,976,49,2,23,13,4,6,33,18,15,30,16,43
1684,974,976,17,4,23,11,3,9,32,31,1,25,21,36
1685,974,976,8,12,23,9,3,11,34,34,0,21,25,30
1686,974,976,41,8,23,11,1,11,34,33,1,23,23,34
1687,974,976,21,1,23,14,1,8,42,35,7,29,17,43
1688,974,976,4,3,23,12,2,9,44,42,2,26,20,38
1689,974,976,7,6,23,11,2,10,35,33,2,24,22,35
1690,974,976,43,5,23,10,6,7,35,27,8,26,20,36
1691,974,976,57,9,23,9,5,9,27,30,-3,23,23,32
1692,974,976,28,10,23,8,8,7,31,24,7,24,22,32
1693,974,976,36,11,23,9,4,10,29,32,-3,22,24,31
1694,974,976,48,14,23,7,3,13,17,31,-14,17,29,24
1695,995,1001,28,9,28,10,10,8,39,34,5,30,26,40
1696,995,1001,36,12,28,9,5,14,29,39,-10,23,33,32
1697,995,1001,48,13,28,9,5,14,23,35,-12,23,33,32
1698,995,1001,43,4,28,14,6,8,46,33,13,34,22,48
1699,995,1001,57,10,28,10,6,12,31,39,-8,26,30,36
1700,995,1001,21,2,28,17,2,9,53,42,11,36,20,53
1701,995,1001,4,3,28,15,3,10,53,46,7,33,23,48
1702,995,1001,7,5,28,14,3,11,43,37,6,31,25,45
1703,995,1001,41,6,28,14,2,12,41,36,5,30,26,44
1704,995,1001,17,7,28,13,3,12,35,37,-2,29,27,42
1705,995,1001,8,11,28,9,5,14,36,40,-4,23,33,32
1706,995,1001,49,1,28,18,4,6,43,19,24,40,16,58
1707,995,1001,53,14,28,6,12,10,23,25,-2,24,32,30
1708,995,1001,1,8,28,12,5,11,34,34,0,29,27,41
1709,995,1001,18,16,28,5,7,16,25,41,-16,17,39,22
1710,995,1001,39,15,28,7,6,15,28,45,-17,20,36,27
1711,1002,1008,39,15,29,8,6,15,30,45,-15,22,36,30
1712,1002,1008,1,8,29,12,6,11,35,35,0,30,28,42
1713,1002,1008,18,16,29,5,7,17,25,43,-18,17,41,22
1714,1002,1008,49,1,29,19,4,6,47,21,26,42,16,61
1715,1002,1008,17,7,29,13,3,13,37,41,-4,29,29,42
1716,1002,1008,8,14,29,9,5,15,36,47,-11,23,35,32
1717,1002,1008,53,13,29,7,12,10,28,26,2,26,32,33
1718,1002,1008,41,6,29,14,2,13,41,37,4,30,28,44
1719,1002,1008,21,2,29,18,2,9,55,43,12,38,20,56
1720,1002,1008,4,4,29,15,3,11,54,51,3,33,25,48
1721,1002,1008,7,5,29,14,4,11,45,39,6,32,26,46
1722,1002,1008,43,3,29,15,6,8,53,33,20,36,22,51
1723,1002,1008,57,10,29,10,6,13,32,41,-9,26,32,36
1724,1002,1008,28,9,29,10,11,8,40,35,5,31,27,41
1725,1002,1008,48,11,29,10,5,14,24,35,-11,25,33,35
1726,1002,1008,36,12,29,9,6,14,31,41,-10,24,34,33
1727,1170,1176,36,7,10,4,2,4,15,15,0,10,10,14
1728,1170,1176,48,9,10,3,3,4,9,13,-4,9,11,12
1729,1170,1176,28,14,10,1,5,4,12,17,-5,7,13,8
1730,1170,1176,43,1,10,8,1,1,31,5,26,17,3,25
1731,1170,1176,57,13,10,2,3,5,8,16,-8,7,13,9
1732,1170,1176,24,15,10,1,2,7,9,20,-11,4,16,5
1733,1170,1176,21,6,10,4,4,2,12,10,2,12,8,16
1734,1170,1176,4,10,10,3,1,6,9,20,-11,7,13,10
1735,1170,1176,7,12,10,2,4,4,11,15,-4,8,12,10
1736,1170,1176,41,5,10,5,3,2,13,9,4,13,7,18
1737,1170,1176,53,2,10,6,3,1,24,9,15,15,5,21
1738,1170,1176,44,8,10,3,4,3,8,11,-3,10,10,13
1739,1170,1176,8,3,10,6,3,1,18,12,6,15,5,21
1740,1170,1176,17,11,10,2,4,4,12,14,-2,8,12,10
1741,1170,1176,49,4,10,6,2,2,18,8,10,14,6,20
1742,1170,1176,1,16,10,1,2,7,7,22,-15,4,16,5
1743,1191,1197,1,15,12,2,2,8,9,23,-14,6,18,8
1744,1191,1197,49,4,12,7,3,2,21,10,11,17,7,24
1745,1191,1197,8,3,12,7,4,1,20,13,7,18,6,25
1746,1191,1197,17,9,12,3,5,4,16,14,2,11,13,14
1747,1191,1197,53,2,12,7,4,1,27,10,17,18,6,25
1748,1191,1197,44,11,12,3,4,5,9,18,-9,10,14,13
1749,1191,1197,41,5,12,6,3,3,18,14,4,15,9,21
1750,1191,1197,21,7,12,4,6,2,16,14,2,14,10,18
1751,1191,1197,4,8,12,5,1,6,16,22,-6,11,13,16
1752,1191,1197,7,12,12,2,6,4,13,17,-4,10,14,12
1753,1191,1197,43,1,12,9,2,1,37,9,28,20,4,29
1754,1191,1197,36,6,12,5,3,4,19,16,3,13,11,18
1755,1667,1673,53,4,26,12,6,8,45,23,22,30,22,42
1756,1667,1673,7,10,26,7,9,10,28,48,-20,23,29,30
1757,1667,1673,4,13,26,5,11,10,34,41,-7,21,31,26
1758,1667,1673,21,14,26,6,7,13,22,53,-31,19,33,25
1759,1667,1673,49,2,26,13,8,5,43,28,15,34,18,47
1760,1667,1673,48,12,26,6,9,11,28,43,-15,21,31,27
1761,1667,1673,36,16,26,5,8,13,33,52,-19,18,34,23
1762,1667,1673,28,6,26,11,8,7,47,36,11,30,22,41
1763,1667,1673,43,1,26,23,2,1,77,16,61,48,4,71
1764,1667,1673,57,11,26,7,6,13,29,55,-26,20,32,27
1765,1667,1673,30,3,26,12,8,6,57,33,24,32,20,44
1766,1667,1673,41,5,26,11,8,7,40,24,16,30,22,41
1767,1667,1673,17,7,26,12,2,12,45,44,1,26,26,38
1768,1667,1673,39,15,26,6,5,15,26,55,-29,17,35,23
1769,1485,1498,39,4,4,2,1,1,6,5,1,5,3,7
1770,1485,1498,41,7,4,1,2,1,12,8,4,4,4,5
1771,1485,1498,30,10,4,1,2,1,6,6,0,4,4,5
1772,1485,1498,17,2,4,3,1,0,11,4,7,7,1,10
1773,1485,1498,8,5,4,2,0,2,13,17,-4,4,4,6
1774,1485,1498,43,1,4,4,0,0,16,2,14,8,0,12
1775,1485,1498,57,16,4,0,1,3,4,13,-9,1,7,1
1776,1485,1498,28,11,4,1,1,2,3,5,-2,3,5,4
1777,1485,1498,48,12,4,1,1,2,3,8,-5,3,5,4
1778,1485,1498,36,14,4,0,2,2,4,7,-3,2,6,2
1779,1485,1498,49,6,4,1,3,0,9,4,5,5,3,6
1780,1485,1498,4,9,4,1,2,1,9,9,0,4,4,5
1781,1485,1498,7,13,4,1,1,2,4,11,-7,3,5,4
1782,1485,1498,21,15,4,0,2,2,3,12,-9,2,6,2
1783,1485,1498,53,3,4,2,1,1,6,2,4,5,3,7
1784,1485,1498,1,8,4,1,2,1,9,5,4,4,4,5
1785,1975,1981,53,3,19,11,5,3,28,17,11,27,11,38
1786,1975,1981,21,7,19,7,5,7,28,28,0,19,19,26
1787,1975,1981,4,8,19,7,5,7,32,39,-7,19,19,26
1788,1975,1981,7,11,19,5,5,9,18,18,0,15,23,20
1789,1975,1981,49,4,19,10,5,4,29,14,15,25,13,35
1790,1975,1981,28,2,19,14,1,4,31,20,11,29,9,43
1791,1975,1981,52,12,19,5,4,10,23,29,-6,14,24,19
1792,1975,1981,48,14,19,4,4,11,16,34,-18,12,26,16
1793,1975,1981,43,1,19,16,1,2,55,10,45,33,5,49
1794,1975,1981,24,5,19,10,2,7,24,25,-1,22,16,32
1795,1975,1981,57,16,19,2,5,12,11,29,-18,9,29,11
1796,1975,1981,8,13,19,5,2,12,20,36,-16,12,26,17
1797,1975,1981,17,15,19,3,7,9,14,31,-17,13,25,16
1798,1975,1981,41,6,19,7,5,7,35,30,5,19,19,26
1799,1975,1981,30,9,19,6,6,7,18,27,-9,18,20,24
1800,1975,1981,1,10,19,5,8,6,30,25,5,18,20,23
1801,1835,1841,41,1,2,2,0,0,8,1,7,4,0,6
1802,1835,1841,30,10,2,0,1,1,2,3,-1,1,3,1
1803,1835,1841,17,5,2,1,1,0,3,2,1,3,1,4
1804,1835,1841,8,7,2,1,0,1,3,5,-2,2,2,3
1805,1835,1841,57,16,2,0,0,2,0,4,-4,0,4,0
1806,1835,1841,43,2,2,2,0,0,5,1,4,4,0,6
1807,1835,1841,24,13,2,0,1,1,0,2,-2,1,3,1
1808,1835,1841,28,2,2,2,0,0,5,1,4,4,0,6
1809,1835,1841,52,10,2,0,1,1,2,3,-1,1,3,1
1810,1835,1841,48,14,2,0,0,2,2,5,-3,0,4,0
1811,1835,1841,49,9,2,0,2,0,3,3,0,2,2,2
1812,1835,1841,53,4,2,2,0,0,4,2,2,4,0,6
1813,1835,1841,21,5,2,1,1,0,3,2,1,3,1,4
1814,1835,1841,4,7,2,1,0,1,3,5,-2,2,2,3
1815,1835,1841,7,12,2,0,1,1,0,1,-1,1,3,1
1816,1835,1841,1,14,2,0,0,2,2,5,-3,0,4,0
1817,2199,2205,21,2,2,2,0,0,4,1,3,4,0,6
1818,2199,2205,7,7,2,1,0,1,4,5,-1,2,2,3
1819,2199,2205,4,14,2,0,1,1,2,4,-2,1,3,1
1820,2199,2205,53,3,2,1,1,0,5,2,3,3,1,4
1821,2199,2205,49,4,2,1,0,1,5,4,1,2,2,3
1822,2199,2205,52,5,2,1,0,1,3,2,1,2,2,3
1823,2199,2205,28,15,2,0,0,2,2,5,-3,0,4,0
1824,2199,2205,24,10,2,0,2,0,3,3,0,2,2,2
1825,2199,2205,43,10,2,0,2,0,3,3,0,2,2,2
1826,2199,2205,8,1,2,2,0,0,7,3,4,4,0,6
1827,2199,2205,17,15,2,0,0,2,2,5,-3,0,4,0
1828,2199,2205,41,8,2,1,0,1,3,4,-1,2,2,3
1829,2199,2205,30,9,2,1,0,1,3,5,-2,2,2,3
1830,2199,2205,20,10,2,0,2,0,3,3,0,2,2,2
1831,2199,2205,1,6,2,1,0,1,4,4,0,2,2,3
1832,2199,2205,27,13,2,0,2,0,2,2,0,2,2,2
1833,2206,2212,27,14,3,0,3,0,3,3,0,3,3,3
1834,2206,2212,1,11,3,1,0,2,5,6,-1,2,4,3
1835,2206,2212,41,4,3,2,0,1,4,4,0,4,2,6
1836,2206,2212,20,6,3,1,2,0,4,3,1,4,2,5
1837,1625,1631,1,9,21,5,7,9,32,28,4,17,25,22
1838,1625,1631,53,6,21,9,6,6,34,17,17,24,18,33
1839,1625,1631,39,12,21,5,5,11,23,42,-19,15,27,20
1840,1660,1666,39,15,25,6,5,14,26,52,-26,17,33,23
1841,1660,1666,53,5,25,11,6,8,43,22,21,28,22,39
1842,1660,1666,1,9,25,8,7,10,45,30,15,23,27,31
1843,1660,1666,49,2,25,13,7,5,42,27,15,33,17,46
1844,1660,1666,7,10,25,7,9,9,27,44,-17,23,27,30
1845,1660,1666,4,11,25,5,11,9,33,39,-6,21,29,26
1846,1660,1666,21,12,25,6,7,12,21,50,-29,19,31,25
1847,1660,1666,17,6,25,12,2,11,44,41,3,26,24,38
1848,1660,1666,8,8,25,10,4,11,38,52,-14,24,26,34
1849,1660,1666,30,3,25,11,8,6,53,32,21,30,20,41
1850,1660,1666,41,4,25,11,7,7,39,23,16,29,21,40
1851,1660,1666,43,1,25,22,2,1,74,16,58,46,4,68
1852,1660,1666,57,13,25,6,6,13,27,54,-27,18,32,24
1853,1660,1666,28,7,25,10,8,7,44,36,8,28,22,38
1854,1660,1666,48,14,25,5,9,11,25,42,-17,19,31,24
1855,1660,1666,36,16,25,4,8,13,30,51,-21,16,34,20
1856,1695,1701,28,7,29,11,9,9,49,41,8,31,27,42
1857,1695,1701,48,15,29,6,10,13,28,48,-20,22,36,28
1858,1695,1701,36,16,29,6,9,14,39,53,-14,21,37,27
1859,1695,1701,43,1,29,23,3,3,79,21,58,49,9,72
1860,1695,1701,57,11,29,8,8,13,32,56,-24,24,34,32
1861,1695,1701,17,5,29,14,2,13,50,48,2,30,28,44
1862,1695,1701,8,8,29,11,5,13,42,58,-16,27,31,38
1863,1695,1701,49,2,29,14,9,6,45,33,12,37,21,51
1864,1695,1701,30,4,29,12,10,7,62,39,23,34,24,46
1865,1695,1701,41,6,29,11,10,8,40,30,10,32,26,43
1866,1695,1701,7,10,29,9,9,11,35,52,-17,27,31,36
1867,1695,1701,21,12,29,8,8,13,26,55,-29,24,34,32
1868,1695,1701,4,13,29,6,12,11,37,45,-8,24,34,30
1869,1695,1701,1,9,29,10,8,11,52,34,18,28,30,38
1870,1695,1701,53,3,29,13,7,9,50,27,23,33,25,46
1871,1695,1701,39,14,29,7,7,15,32,58,-26,21,37,28
1872,1912,1918,1,9,11,3,4,4,22,18,4,10,12,13
1873,1912,1918,4,6,11,5,2,4,20,24,-4,12,10,17
1874,1912,1918,21,7,11,4,4,3,17,13,4,12,10,16
1875,1912,1918,7,12,11,2,4,5,6,9,-3,8,14,10
1876,1912,1918,53,3,11,7,2,2,16,10,6,16,6,23
1877,1912,1918,41,5,11,5,4,2,21,10,11,14,8,19
1878,1912,1918,30,8,11,4,2,5,10,16,-6,10,12,14
1879,1912,1918,49,10,11,3,4,4,10,10,0,10,12,13
1880,1912,1918,8,11,11,3,2,6,11,21,-10,8,14,11
1881,1912,1918,17,15,11,1,4,6,6,17,-11,6,16,7
1882,1912,1918,43,2,11,9,1,1,24,3,21,19,3,28
1883,1912,1918,24,4,11,6,2,3,12,8,4,14,8,20
1884,1912,1918,57,16,11,0,3,8,3,17,-14,3,19,3
1885,1912,1918,28,1,11,10,1,0,24,8,16,21,1,31
1886,1912,1918,48,13,11,2,3,6,9,16,-7,7,15,9
1887,1912,1918,52,14,11,2,2,7,8,19,-11,6,16,8
1888,2080,2191,28,2,30,18,4,8,43,29,14,40,20,58
1889,2080,2191,52,12,30,8,8,14,36,47,-11,24,36,32
1890,2080,2191,48,15,30,4,10,16,24,52,-28,18,42,22
1891,2080,2191,43,1,30,21,5,4,88,18,70,47,13,68
1892,2080,2191,24,6,30,13,7,10,35,39,-4,33,27,46
1893,2080,2191,57,16,30,5,6,19,19,61,-42,16,44,21
1894,2080,2191,17,11,30,8,10,12,30,40,-10,26,34,34
1895,2080,2191,8,14,30,7,6,17,29,51,-22,20,40,27
1896,2080,2191,49,3,30,16,8,6,47,24,23,40,20,56
1897,2080,2191,41,8,30,11,7,12,52,46,6,29,31,40
1898,2080,2191,30,10,30,9,12,9,30,37,-7,30,30,39
1899,2080,2191,53,4,30,15,9,6,45,29,16,39,21,54
1900,2080,2191,4,7,30,11,8,11,47,62,-15,30,30,41
1901,2080,2191,21,9,30,11,7,12,43,44,-1,29,31,40
1902,2080,2191,7,13,30,7,10,13,25,31,-6,24,36,31
1903,2080,2191,1,5,30,12,11,7,56,39,17,35,25,47
1904,1863,1869,1,9,5,1,2,2,7,8,-1,4,6,5
1905,1863,1869,21,7,5,2,2,1,8,5,3,6,4,8
1906,1863,1869,4,8,5,2,1,2,8,11,-3,5,5,7
1907,1863,1869,7,11,5,1,2,2,2,3,-1,4,6,5
1908,1863,1869,53,4,5,3,1,1,6,4,2,7,3,10
1909,1863,1869,41,6,5,2,3,0,9,2,7,7,3,9
1910,1863,1869,30,12,5,1,2,2,4,6,-2,4,6,5
1911,1863,1869,49,14,5,0,3,2,4,6,-2,3,7,3
1912,1863,1869,8,5,5,3,0,2,6,8,-2,6,4,9
1913,1863,1869,17,10,5,1,2,2,3,4,-1,4,6,5
1914,1863,1869,28,1,5,5,0,0,10,2,8,10,0,15
1915,1863,1869,52,13,5,1,2,2,3,5,-2,4,6,5
1916,1177,1190,48,9,11,3,4,4,9,13,-4,10,12,13
1917,1177,1190,28,14,11,1,5,5,13,21,-8,7,15,8
1918,1177,1190,43,1,11,9,1,1,34,6,28,19,3,28
1919,1177,1190,57,13,11,2,3,6,8,19,-11,7,15,9
1920,1177,1190,24,15,11,1,2,8,10,23,-13,4,18,5
1921,1177,1190,8,2,11,7,3,1,19,12,7,17,5,24
1922,1177,1190,17,11,11,2,5,4,12,14,-2,9,13,11
1923,1177,1190,41,5,11,6,3,2,17,10,7,15,7,21
1924,1177,1190,21,7,11,4,5,2,13,11,2,13,9,17
1925,1177,1190,4,8,11,4,1,6,12,21,-9,9,13,13
1926,1177,1190,7,12,11,2,5,4,12,16,-4,9,13,11
1927,1177,1190,49,4,11,6,3,2,19,9,10,15,7,21
1928,1177,1190,53,3,11,6,4,1,25,10,15,16,6,22
1929,1177,1190,44,10,11,3,4,4,9,14,-5,10,12,13
1930,1177,1190,1,16,11,1,2,8,7,23,-16,4,18,5
1931,1317,1323,1,13,28,7,8,13,31,45,-14,22,34,29
1932,1317,1323,53,4,28,11,13,4,44,24,20,35,21,46
1933,1317,1323,44,14,28,6,9,13,25,49,-24,21,35,27
1934,1317,1323,49,3,28,14,8,6,53,27,26,36,20,50
1935,1317,1323,21,7,28,12,9,7,38,34,4,33,23,45
1936,1317,1323,4,8,28,10,6,12,36,44,-8,26,30,36
1937,1317,1323,7,11,28,7,9,12,38,45,-7,23,33,30
1938,1317,1323,41,5,28,13,6,9,35,27,8,32,24,45
1939,1317,1323,8,2,28,15,9,4,44,27,17,39,17,54
1940,1317,1323,17,9,28,8,9,11,38,39,-1,25,31,33
1941,1317,1323,36,6,28,13,6,9,42,37,5,32,24,45
1942,1317,1323,48,12,28,8,5,15,28,46,-18,21,35,29
1943,1317,1323,28,15,28,6,8,14,33,49,-16,20,36,26
1944,1317,1323,43,1,28,18,8,2,74,23,51,44,12,62
1945,1317,1323,57,10,28,7,10,11,20,38,-18,24,32,31
1946,1317,1323,24,16,28,3,9,16,19,44,-25,15,41,18
1947,1331,1463,43,1,30,18,9,3,77,28,49,45,15,63
1948,1331,1463,57,10,30,8,10,12,25,43,-18,26,34,34
1949,1331,1463,24,16,30,3,10,17,20,47,-27,16,44,19
1950,1331,1463,36,7,30,13,7,10,43,39,4,33,27,46
1951,1331,1463,28,13,30,8,8,14,36,50,-14,24,36,32
1952,1331,1463,48,15,30,8,6,16,29,49,-20,22,38,30
1953,1331,1463,8,2,30,16,9,5,49,30,19,41,19,57
1954,1331,1463,17,9,30,8,10,12,39,43,-4,26,34,34
1955,1331,1463,41,4,30,15,6,9,39,27,12,36,24,51
1956,1331,1463,21,6,30,13,9,8,42,38,4,35,25,48
1957,1331,1463,4,8,30,10,6,14,37,51,-14,26,34,36
1958,1331,1463,7,11,30,8,9,13,41,48,-7,25,35,33
1959,1331,1463,49,3,30,16,8,6,58,28,30,40,20,56
1960,1331,1463,53,5,30,12,13,5,47,26,21,37,23,49
1961,1331,1463,44,14,30,7,10,13,28,50,-22,24,36,31
1962,1331,1463,1,12,30,8,8,14,35,48,-13,24,36,32
1963,1611,1617,39,10,19,5,5,9,22,36,-14,15,23,20
1964,1611,1617,53,6,19,8,5,6,31,17,14,21,17,29
1965,1611,1617,1,12,19,4,6,9,26,25,1,14,24,18
1966,1611,1617,49,2,19,11,6,2,37,18,19,28,10,39
1967,1611,1617,4,9,19,4,9,6,23,25,-2,17,21,21
1968,1611,1617,21,11,19,5,5,9,17,41,-24,15,23,20
1969,1611,1617,7,15,19,3,8,8,15,34,-19,14,24,17
1970,1611,1617,30,4,19,8,6,5,38,22,16,22,16,30
1971,1611,1617,41,5,19,8,6,5,31,19,12,22,16,30
1972,1611,1617,17,3,19,11,1,7,40,35,5,23,15,34
1973,1611,1617,8,8,19,8,3,8,30,39,-9,19,19,27
1974,1611,1617,28,7,19,7,7,5,35,30,5,21,17,28
1975,1611,1617,36,14,19,3,8,8,25,35,-10,14,24,17
1976,1611,1617,48,16,19,3,6,10,17,36,-19,12,26,15
1977,1611,1617,43,1,19,16,2,1,59,15,44,34,4,50
1978,1611,1617,57,13,19,4,5,10,21,40,-19,13,25,17
1979,1674,1680,43,1,27,23,3,1,77,16,61,49,5,72
1980,1674,1680,57,10,27,8,6,13,31,55,-24,22,32,30
1981,1674,1680,28,6,27,11,9,7,48,37,11,31,23,42
1982,1674,1680,48,13,27,6,10,11,28,43,-15,22,32,28
1983,1674,1680,36,16,27,5,9,13,33,52,-19,19,35,24
1984,1674,1680,17,7,27,12,2,13,45,46,-1,26,28,38
1985,1674,1680,8,8,27,10,5,12,40,55,-15,25,29,35
1986,1674,1680,30,4,27,12,8,7,58,35,23,32,22,44
1987,1674,1680,41,5,27,11,9,7,40,24,16,31,23,42
1988,1674,1680,7,11,27,7,9,11,29,51,-22,23,31,30
1989,1674,1680,21,12,27,7,7,13,24,54,-30,21,33,28
1990,1674,1680,4,14,27,5,12,10,34,41,-7,22,32,27
1991,1674,1680,49,2,27,13,9,5,43,28,15,35,19,48
1992,1674,1680,53,3,27,13,6,8,48,24,24,32,22,45
1993,1674,1680,39,15,27,6,6,15,26,55,-29,18,36,24
1994,743,749,28,11,3,1,0,2,6,7,-1,2,4,3
1995,1198,1204,36,5,13,6,3,4,21,16,5,15,11,21
1996,1198,1204,48,9,13,4,4,5,11,15,-4,12,14,16
1997,1198,1204,28,15,13,1,6,6,16,25,-9,8,18,9
1998,1198,1204,43,1,13,9,3,1,39,11,28,21,5,30
1999,1198,1204,57,13,13,3,3,7,10,21,-11,9,17,12
2000,1198,1204,24,16,13,1,2,10,10,27,-17,4,22,5
2001,1198,1204,49,4,13,7,4,2,23,12,11,18,8,25
2002,1198,1204,8,3,13,7,5,1,20,13,7,19,7,26
2003,1198,1204,17,10,13,3,6,4,17,15,2,12,14,15
2004,1198,1204,41,6,13,6,3,4,18,16,2,15,11,21
2005,1198,1204,21,7,13,4,6,3,16,15,1,14,12,18
2006,1198,1204,4,8,13,5,2,6,17,23,-6,12,14,17
2007,1198,1204,7,12,13,2,7,4,15,19,-4,11,15,13
2008,1198,1204,53,2,13,8,4,1,30,12,18,20,6,28
2009,1198,1204,44,11,13,3,5,5,9,18,-9,11,15,14
2010,1198,1204,1,14,13,2,3,8,11,25,-14,7,19,9
2011,1289,1309,1,15,26,6,7,13,29,44,-15,19,33,25
2012,1289,1309,53,4,26,11,11,4,43,23,20,33,19,44
2013,1289,1309,44,11,26,6,9,11,24,44,-20,21,31,27
2014,1289,1309,21,7,26,10,9,7,33,32,1,29,23,39
2015,1289,1309,4,8,26,10,5,11,35,41,-6,25,27,35
2016,1289,1309,7,13,26,6,8,12,32,44,-12,20,32,26
2017,1289,1309,41,5,26,12,6,8,33,25,8,30,22,42
2018,1289,1309,8,2,26,14,9,3,43,24,19,37,15,51
2019,1289,1309,17,9,26,7,8,11,36,38,-2,22,30,29
2020,1289,1309,49,3,26,13,8,5,49,25,24,34,18,47
2021,1289,1309,36,6,26,12,6,8,39,32,7,30,22,42
2022,1289,1309,48,12,26,7,5,14,25,43,-18,19,33,26
2023,1289,1309,28,14,26,6,8,12,32,45,-13,20,32,26
2024,1289,1309,43,1,26,17,8,1,71,21,50,42,10,59
2025,1289,1309,57,10,26,7,8,11,19,37,-18,22,30,29
2026,1289,1309,24,16,26,3,7,16,19,44,-25,13,39,16
2027,1464,1470,43,1,1,1,0,0,6,0,6,2,0,3
2028,1464,1470,57,14,1,0,0,1,0,5,-5,0,2,0
2029,1464,1470,8,4,1,1,0,0,3,1,2,2,0,3
2030,1464,1470,17,5,1,1,0,0,2,1,1,2,0,3
2031,1464,1470,48,6,1,1,0,0,1,0,1,2,0,3
2032,1464,1470,36,11,1,0,0,1,0,1,-1,0,2,0
2033,1464,1470,28,11,1,0,0,1,0,1,-1,0,2,0
2034,1464,1470,41,8,1,0,1,0,3,3,0,1,1,1
2035,1464,1470,30,13,1,0,0,1,1,3,-2,0,2,0
2036,1464,1470,49,3,1,1,0,0,5,0,5,2,0,3
2037,1464,1470,4,8,1,0,1,0,3,3,0,1,1,1
2038,1464,1470,21,15,1,0,0,1,0,6,-6,0,2,0
2039,1464,1470,7,15,1,0,0,1,0,6,-6,0,2,0
2040,1464,1470,53,6,1,1,0,0,1,0,1,2,0,3
2041,1464,1470,1,1,1,1,0,0,6,0,6,2,0,3
2042,1464,1470,39,10,1,0,0,1,1,2,-1,0,2,0
2043,1478,1484,39,4,3,2,0,1,5,4,1,4,2,6
2044,1478,1484,1,6,3,1,2,0,8,2,6,4,2,5
2045,1478,1484,53,3,3,2,0,1,6,2,4,4,2,6
2046,1478,1484,4,10,3,1,1,1,7,7,0,3,3,4
2047,1478,1484,7,12,3,1,0,2,4,11,-7,2,4,3
2048,1478,1484,21,15,3,0,1,2,2,11,-9,1,5,1
2049,1478,1484,49,7,3,1,2,0,9,4,5,4,2,5
2050,1478,1484,41,8,3,1,1,1,12,8,4,3,3,4
2051,1478,1484,30,13,3,0,2,1,3,5,-2,2,4,2
2052,1478,1484,28,9,3,1,1,1,2,1,1,3,3,4
2053,1478,1484,48,11,3,1,0,2,1,6,-5,2,4,3
2054,1478,1484,36,14,3,0,1,2,2,5,-3,1,5,1
2055,1478,1484,17,2,3,2,1,0,6,2,4,5,1,7
2056,1478,1484,8,5,3,2,0,1,11,12,-1,4,2,6
2057,1478,1484,43,1,3,3,0,0,12,1,11,6,0,9
2058,1478,1484,57,16,3,0,0,3,2,11,-9,0,6,0
2059,1702,1827,43,1,30,24,3,3,87,22,65,51,9,75
2060,1702,1827,57,11,30,8,9,13,36,60,-24,25,35,33
2061,1702,1827,28,5,30,12,9,9,50,41,9,33,27,45
2062,1702,1827,48,13,30,7,10,13,30,48,-18,24,36,31
2063,1702,1827,36,16,30,6,10,14,40,54,-14,22,38,28
2064,1702,1827,49,2,30,15,9,6,50,34,16,39,21,54
2065,1702,1827,17,6,30,14,2,14,50,49,1,30,30,44
2066,1702,1827,8,8,30,11,6,13,46,62,-16,28,32,39
2067,1702,1827,7,10,30,9,10,11,36,53,-17,28,32,37
2068,1702,1827,21,12,30,8,8,14,27,60,-33,24,36,32
2069,1702,1827,4,14,30,6,13,11,37,45,-8,25,35,31
2070,1702,1827,30,4,30,12,10,8,63,47,16,34,26,46
2071,1702,1827,41,7,30,11,10,9,40,31,9,32,28,43
2072,1702,1827,53,3,30,14,7,9,51,27,24,35,25,49
2073,1702,1827,1,9,30,10,8,12,52,36,16,28,32,38
2074,736,742,57,1,2,2,0,0,6,2,4,4,0,6
2075,736,742,43,4,2,1,1,0,3,1,2,3,1,4
2076,736,742,36,7,2,1,0,1,3,2,1,2,2,3
2077,736,742,48,11,2,1,0,1,3,5,-2,2,2,3
2078,736,742,28,14,2,0,0,2,2,5,-3,0,4,0
2079,736,742,8,6,2,1,0,1,7,6,1,2,2,3
2080,736,742,17,12,2,1,0,1,2,5,-3,2,2,3
2081,736,742,49,9,2,1,0,1,3,3,0,2,2,3
2082,736,742,41,5,2,1,0,1,6,3,3,2,2,3
2083,736,742,53,13,2,0,1,1,1,3,-2,1,3,1
2084,736,742,7,2,2,2,0,0,5,1,4,4,0,6
2085,736,742,21,3,2,2,0,0,7,4,3,4,0,6
2086,736,742,4,8,2,1,0,1,7,7,0,2,2,3
2087,736,742,39,15,2,0,0,2,1,4,-3,0,4,0
2088,984,987,39,15,26,6,6,14,25,43,-18,18,34,24
2089,984,987,21,2,26,15,2,9,50,42,8,32,20,47
2090,984,987,4,3,26,13,3,10,49,44,5,29,23,42
2091,984,987,7,6,26,13,2,11,40,36,4,28,24,41
2092,984,987,53,14,26,6,10,10,22,24,-2,22,30,28
2093,984,987,41,7,26,13,2,11,37,34,3,28,24,41
2094,984,987,49,1,26,16,4,6,38,18,20,36,16,52
2095,984,987,17,4,26,13,3,10,35,34,1,29,23,42
2096,984,987,8,11,26,9,5,12,35,36,-1,23,29,32
2097,984,987,28,9,26,10,8,8,38,33,5,28,24,38
2098,984,987,36,12,26,9,5,12,29,34,-5,23,29,32
2099,984,987,48,13,26,8,5,13,19,31,-12,21,31,29
2100,984,987,43,5,26,12,6,8,41,31,10,30,22,42
2101,984,987,57,10,26,10,6,10,29,34,-5,26,26,36
2102,984,987,1,8,26,11,5,10,31,29,2,27,25,38
2103,984,987,18,16,26,5,6,15,23,38,-15,16,36,21
2104,1219,1225,43,1,16,12,3,1,48,14,34,27,5,39
2105,1219,1225,57,9,16,5,3,8,13,25,-12,13,19,18
2106,1219,1225,24,16,16,1,3,12,12,33,-21,5,27,6
2107,1219,1225,36,4,16,9,3,4,28,17,11,21,11,30
2108,1219,1225,48,12,16,4,4,8,14,24,-10,12,20,16
2109,1219,1225,28,15,16,2,6,8,20,33,-13,10,22,12
2110,1219,1225,8,2,16,9,5,2,24,16,8,23,9,32
2111,1219,1225,17,14,16,3,6,7,19,23,-4,12,20,15
2112,1219,1225,49,5,16,8,5,3,28,18,10,21,11,29
2113,1219,1225,41,6,16,8,3,5,25,18,7,19,13,27
2114,1219,1225,53,3,16,9,4,3,34,18,16,22,10,31
2115,1219,1225,44,10,16,4,6,6,13,19,-6,14,18,18
2116,1219,1225,21,7,16,6,6,4,23,18,5,18,14,24
2117,1219,1225,4,8,16,6,2,8,22,30,-8,14,18,20
2118,1219,1225,7,13,16,3,7,6,18,26,-8,13,19,16
2119,1219,1225,1,11,16,4,4,8,19,28,-9,12,20,16
2120,1233,1239,21,6,18,8,6,4,25,18,7,22,14,30
2121,1233,1239,4,8,18,8,2,8,26,32,-6,18,18,26
2122,1233,1239,7,10,18,4,7,7,20,27,-7,15,21,19
2123,1233,1239,53,4,18,10,5,3,37,19,18,25,11,35
2124,1233,1239,44,11,18,4,7,7,14,21,-7,15,21,19
2125,1233,1239,41,7,18,8,4,6,25,19,6,20,16,28
2126,1233,1239,49,3,18,10,5,3,39,19,20,25,11,35
2127,1233,1239,8,2,18,11,5,2,28,17,11,27,9,38
2128,1233,1239,17,12,18,4,6,8,25,29,-4,14,22,18
2129,1233,1239,36,5,18,9,3,6,28,21,7,21,15,30
2130,1233,1239,48,14,18,4,4,10,15,30,-15,12,24,16
2131,1233,1239,28,15,18,3,6,9,24,38,-14,12,24,15
2132,1233,1239,43,1,18,13,4,1,52,15,37,30,6,43
2133,1233,1239,57,9,18,5,4,9,13,27,-14,14,22,19
2134,1233,1239,24,16,18,1,4,13,12,39,-27,6,30,7
2135,1233,1239,1,13,18,4,4,10,20,32,-12,12,24,16
2136,1240,1246,1,14,19,4,4,11,20,35,-15,12,26,16
2137,1240,1246,43,1,19,14,4,1,55,15,40,32,6,46
2138,1240,1246,57,9,19,6,4,9,15,28,-13,16,22,22
2139,1240,1246,24,16,19,2,4,13,16,39,-23,8,30,10
2140,1240,1246,36,7,19,9,3,7,29,25,4,21,17,30
2141,1240,1246,28,13,19,4,6,9,26,38,-12,14,24,18
2142,1240,1246,48,15,19,4,4,11,16,32,-16,12,26,16
2143,1240,1246,8,2,19,12,5,2,29,17,12,29,9,41
2144,1240,1246,17,12,19,4,6,9,25,30,-5,14,24,18
2145,1240,1246,49,3,19,10,5,4,39,21,18,25,13,35
2146,1240,1246,41,6,19,9,4,6,26,19,7,22,16,31
2147,1240,1246,53,4,19,10,5,4,37,20,17,25,13,35
2148,1240,1246,44,10,19,4,7,8,15,24,-9,15,23,19
2149,1240,1246,21,5,19,9,6,4,28,19,9,24,14,33
2150,1240,1246,4,8,19,9,2,8,30,33,-3,20,18,29
2151,1240,1246,7,11,19,4,7,8,20,31,-11,15,23,19
2152,1254,1260,21,7,21,9,7,5,30,26,4,25,17,34
2153,1933,1939,24,4,14,7,2,5,18,13,5,16,12,23
2154,1933,1939,57,16,14,1,4,9,6,21,-15,6,22,7
2155,1940,1953,43,1,15,12,1,2,38,9,29,25,5,37
2156,1940,1953,24,5,15,7,2,6,18,16,2,16,14,23
2157,1940,1953,57,16,15,1,4,10,7,23,-16,6,24,7
2158,1940,1953,28,2,15,12,1,2,27,11,16,25,5,37
2159,1940,1953,48,12,15,4,4,7,14,22,-8,12,18,16
2160,1940,1953,52,13,15,3,3,9,13,25,-12,9,21,12
2161,1940,1953,8,14,15,3,2,10,13,30,-17,8,22,11
2162,1940,1953,17,15,15,2,5,8,10,25,-15,9,21,11
2163,1940,1953,41,6,15,6,4,5,28,26,2,16,14,22
2164,1940,1953,30,9,15,6,3,6,15,23,-8,15,15,21
2165,1940,1953,49,4,15,7,4,4,22,11,11,18,12,25
2166,1940,1953,53,3,15,10,3,2,22,12,10,23,7,33
2167,1940,1953,21,7,15,6,4,5,23,21,2,16,14,22
2168,1940,1953,4,8,15,6,4,5,26,29,-3,16,14,22
2169,1940,1953,7,11,15,4,4,7,14,12,2,12,18,16
2170,1940,1953,1,10,15,4,6,5,25,20,5,14,16,18
2171,2038,2072,53,4,28,14,9,5,40,28,12,37,19,51
2172,2038,2072,4,6,28,11,8,9,47,52,-5,30,26,41
2173,2038,2072,21,9,28,10,7,11,40,39,1,27,29,37
2174,2038,2072,7,12,28,7,8,13,25,31,-6,22,34,29
2175,2038,2072,30,10,28,9,10,9,30,37,-7,28,28,37
2176,2038,2072,41,8,28,10,7,11,47,42,5,27,29,37
2177,2038,2072,49,3,28,15,7,6,43,21,22,37,19,52
2178,2038,2072,43,1,28,20,5,3,75,16,59,45,11,65
2179,2038,2072,24,5,28,13,6,9,34,37,-3,32,24,45
2180,2038,2072,57,16,28,4,6,18,18,49,-31,14,42,18
2181,2038,2072,28,2,28,17,3,8,42,29,13,37,19,54
2182,2038,2072,17,13,28,6,10,12,24,39,-15,22,34,28
2183,2038,2072,8,14,28,7,5,16,28,49,-21,19,37,26
2184,2038,2072,52,11,28,8,7,13,33,43,-10,23,33,31
2185,2038,2072,48,15,28,4,9,15,22,49,-27,17,39,21
2186,2038,2072,1,7,28,10,11,7,48,35,13,31,25,41
2187,1898,1904,28,1,9,8,1,0,18,5,13,17,1,25
2188,1898,1904,52,12,9,2,2,5,7,16,-9,6,12,8
2189,1898,1904,48,15,9,1,2,6,6,14,-8,4,14,5
2190,1898,1904,57,16,9,0,2,7,1,14,-13,2,16,2
2191,1898,1904,43,2,9,8,0,1,18,3,15,16,2,24
2192,1898,1904,24,6,9,4,2,3,9,7,2,10,8,14
2193,1898,1904,8,9,9,3,2,4,8,13,-5,8,10,11
2194,1898,1904,17,13,9,1,4,4,5,10,-5,6,12,7
2195,1898,1904,49,11,9,2,3,4,7,10,-3,7,11,9
2196,1898,1904,21,5,9,4,3,2,15,10,5,11,7,15
2197,1898,1904,4,8,9,4,2,3,16,18,-2,10,8,14
2198,1898,1904,41,3,9,5,3,1,20,7,13,13,5,18
2199,1898,1904,30,7,9,4,2,3,10,11,-1,10,8,14
2200,1898,1904,7,14,9,1,3,5,5,9,-4,5,13,6
2201,1898,1904,53,4,9,5,2,2,11,8,3,12,6,17
2202,1898,1904,1,10,9,2,3,4,15,16,-1,7,11,9
2203,2423,2429,1,1,27,19,3,5,54,29,25,41,13,60
2204,2423,2429,53,13,27,6,8,13,39,52,-13,20,34,26
2205,2423,2429,21,5,27,11,9,7,33,22,11,31,23,42
2206,2423,2429,4,9,27,7,8,12,28,48,-20,22,32,29
2207,2423,2429,7,10,27,6,11,10,36,45,-9,23,31,29
2208,2423,2429,49,4,27,14,7,6,44,28,16,35,19,49
2209,2423,2429,17,8,27,9,7,11,32,33,-1,25,29,34
2210,2423,2429,8,11,27,5,12,10,39,45,-6,22,32,27
2211,2423,2429,41,3,27,15,5,7,40,26,14,35,19,50
2212,2423,2429,20,7,27,8,12,7,27,22,5,28,26,36
2213,2423,2429,30,16,27,6,4,17,26,56,-30,16,38,22
2214,2423,2429,43,2,27,18,6,3,59,12,47,42,12,60
2215,2423,2429,24,12,27,5,12,10,31,41,-10,22,32,27
2216,2423,2429,28,6,27,11,7,9,40,34,6,29,25,40
2217,2423,2429,52,15,27,5,10,12,27,46,-19,20,34,25
2218,2423,2429,27,14,27,5,11,11,28,44,-16,21,33,26
2219,2689,2695,27,9,15,6,2,7,22,22,0,14,16,20
2220,2689,2695,28,5,15,6,4,5,25,22,3,16,14,22
2221,2689,2695,52,12,15,4,4,7,23,27,-4,12,18,16
2222,2689,2695,43,2,15,10,2,3,34,14,20,22,8,32
2223,2689,2695,24,14,15,4,2,9,16,22,-6,10,20,14
2224,2689,2695,17,3,15,9,1,5,37,28,9,19,11,28
2225,2689,2695,8,8,15,6,3,6,27,30,-3,15,15,21
2226,2689,2695,49,4,15,7,6,2,24,17,7,20,10,27
2227,2689,2695,37,7,15,6,3,6,20,22,-2,15,15,21
2228,2689,2695,20,11,15,5,5,5,16,20,-4,15,15,20
2229,2689,2695,41,15,15,3,4,8,15,27,-12,10,20,13
2230,2689,2695,21,16,15,2,5,8,12,24,-12,9,21,11
2231,2689,2695,7,6,15,7,0,8,23,28,-5,14,16,21
2232,2206,2212,30,12,3,1,0,2,5,9,-4,2,4,3
2233,2206,2212,8,2,3,2,0,1,9,6,3,4,2,6
2234,2206,2212,17,16,3,0,0,3,2,7,-5,0,6,0
2235,2206,2212,43,5,3,1,2,0,5,4,1,4,2,5
2236,2206,2212,24,13,3,0,3,0,4,4,0,3,3,3
2237,2206,2212,52,9,3,1,0,2,3,3,0,2,4,3
2238,2206,2212,28,10,3,1,0,2,6,7,-1,2,4,3
2239,2206,2212,49,3,3,2,0,1,8,6,2,4,2,6
2240,2206,2212,53,7,3,1,1,1,5,3,2,3,3,4
2241,2206,2212,21,1,3,3,0,0,6,1,5,6,0,9
2242,2206,2212,7,8,3,1,1,1,5,6,-1,3,3,4
2243,2206,2212,4,15,3,0,2,1,3,5,-2,2,4,2
2244,2220,2226,21,2,5,3,1,1,8,5,3,7,3,10
2245,2220,2226,7,6,5,2,2,1,8,6,2,6,4,8
2246,2220,2226,4,14,5,0,4,1,5,7,-2,4,6,4
2247,2220,2226,53,5,5,2,2,1,8,5,3,6,4,8
2248,2220,2226,49,9,5,2,1,2,9,8,1,5,5,7
2249,2220,2226,28,12,5,1,1,3,6,9,-3,3,7,4
2250,2220,2226,52,13,5,1,1,3,4,7,-3,3,7,4
2251,2220,2226,43,4,5,2,3,0,7,4,3,7,3,9
2252,2220,2226,24,15,5,0,3,2,4,9,-5,3,7,3
2253,2220,2226,8,1,5,3,1,1,13,6,7,7,3,10
2254,2220,2226,17,16,5,0,2,3,2,7,-5,2,8,2
2255,2220,2226,20,7,5,2,2,1,6,5,1,6,4,8
2256,2220,2226,41,8,5,2,2,1,5,5,0,6,4,8
2257,2220,2226,30,10,5,2,0,3,7,13,-6,4,6,6
2258,2220,2226,1,3,5,3,0,2,11,7,4,6,4,9
2259,2220,2226,27,11,5,0,5,0,3,3,0,5,5,5
2260,2234,2247,27,11,7,1,5,1,5,6,-1,7,7,8
2261,2234,2247,1,2,7,5,0,2,14,8,6,10,4,15
2262,2234,2247,41,3,7,4,2,1,9,5,4,10,4,14
2263,2234,2247,20,7,7,3,2,2,8,6,2,8,6,11
2264,2234,2247,30,9,7,3,0,4,10,16,-6,6,8,9
2265,2234,2247,8,8,7,3,1,3,14,10,4,7,7,10
2266,2234,2247,17,14,7,1,2,4,5,9,-4,4,10,5
2267,2234,2247,43,4,7,3,4,0,9,4,5,10,4,13
2268,2234,2247,24,12,7,1,3,3,6,12,-6,5,9,6
2269,2234,2247,28,13,7,1,2,4,11,15,-4,4,10,5
2270,2234,2247,52,15,7,1,1,5,4,10,-6,3,11,4
2271,2234,2247,49,6,7,3,2,2,13,11,2,8,6,11
2272,2234,2247,53,10,7,2,2,3,9,12,-3,6,8,8
2273,2234,2247,21,1,7,5,1,1,13,6,7,11,3,16
2274,2234,2247,7,5,7,3,3,1,14,8,6,9,5,12
2275,2234,2247,4,16,7,0,4,3,5,11,-6,4,10,4
2276,2794,2800,7,8,27,11,4,12,36,48,-12,26,28,37
2277,2794,2800,21,16,27,5,8,14,20,39,-19,18,36,23
2278,2794,2800,53,6,27,11,6,10,38,31,7,28,26,39
2279,2794,2800,49,3,27,15,7,5,51,29,22,37,17,52
2280,2794,2800,37,12,27,8,7,12,27,38,-11,23,31,31
2281,2794,2800,28,7,27,11,6,10,42,36,6,28,26,39
2282,2794,2800,52,13,27,7,9,11,35,40,-5,23,31,30
2283,2794,2800,43,1,27,19,5,3,65,22,43,43,11,62
2284,2794,2800,24,10,27,9,4,14,32,39,-7,22,32,31
2285,2794,2800,17,5,27,12,3,12,49,55,-6,27,27,39
2286,2794,2800,8,11,27,9,4,14,38,49,-11,22,32,31
2287,2794,2800,1,2,27,16,7,4,47,19,28,39,15,55
2288,2794,2800,18,15,27,7,4,16,25,49,-24,18,36,25
2289,2794,2800,20,4,27,12,8,7,36,31,5,32,22,44
2290,2794,2800,41,14,27,7,7,13,29,41,-12,21,33,28
2291,2794,2800,27,9,27,10,5,12,32,36,-4,25,29,35
2292,2801,2807,27,8,28,11,5,12,33,36,-3,27,29,38
2293,2801,2807,20,4,28,12,8,8,36,33,3,32,24,44
2294,2801,2807,41,13,28,8,7,13,30,41,-11,23,33,31
2295,2801,2807,7,9,28,11,4,13,36,49,-13,26,30,37
2296,2801,2807,21,16,28,5,9,14,20,39,-19,19,37,24
2297,2801,2807,1,2,28,17,7,4,49,20,29,41,15,58
2298,2801,2807,18,15,28,8,4,16,28,49,-21,20,36,28
2299,2801,2807,17,6,28,12,3,13,49,58,-9,27,29,39
2300,2801,2807,8,10,28,10,4,14,40,49,-9,24,32,34
2301,2801,2807,43,1,28,19,5,4,65,24,41,43,13,62
2302,2801,2807,24,12,28,9,4,15,32,40,-8,22,34,31
2303,2801,2807,28,5,28,12,6,10,43,36,7,30,26,42
2304,2801,2807,52,11,28,8,9,11,37,40,-3,25,31,33
2305,2801,2807,49,3,28,15,8,5,51,29,22,38,18,53
2306,2801,2807,37,14,28,8,7,13,28,40,-12,23,33,31
2307,2801,2807,53,7,28,11,6,11,38,32,6,28,28,39
2308,2584,2597,53,15,5,0,3,2,3,6,-3,3,7,3
2309,2584,2597,37,3,5,3,1,1,9,5,4,7,3,10
2310,2584,2597,49,6,5,2,2,1,9,8,1,6,4,8
2311,2584,2597,52,7,5,2,1,2,11,11,0,5,5,7
2312,2584,2597,28,13,5,1,2,2,7,12,-5,4,6,5
2313,582,588,39,8,27,9,6,12,31,33,-2,24,30,33
2314,582,588,1,4,27,13,7,7,38,29,9,33,21,46
2315,582,588,18,14,27,7,7,13,31,36,-5,21,33,28
2316,582,588,53,12,27,7,9,11,28,35,-7,23,31,30
2317,582,588,21,3,27,13,9,5,55,41,14,35,19,48
2318,582,588,4,6,27,10,7,10,37,44,-7,27,27,37
2319,582,588,7,7,27,9,8,10,40,43,-3,26,28,35
2320,582,588,41,5,27,12,8,7,29,20,9,32,22,44
2321,582,588,43,1,27,21,4,2,70,24,46,46,8,67
2322,582,588,57,15,27,7,6,14,37,60,-23,20,34,27
2323,582,588,34,16,27,6,5,16,24,50,-26,17,37,23
2324,582,588,17,10,27,9,5,13,45,52,-7,23,31,32
2325,582,588,19,13,27,7,8,12,37,53,-16,22,32,29
2326,582,588,36,9,27,9,6,12,35,43,-8,24,30,33
2327,582,588,28,11,27,8,8,11,43,40,3,24,30,32
2328,582,588,49,2,27,16,3,8,51,28,23,35,19,51
2329,841,917,28,7,14,6,3,5,23,17,6,15,13,21
2330,841,917,48,11,14,5,2,7,11,15,-4,12,16,17
2331,841,917,36,12,14,5,2,7,18,23,-5,12,16,17
2332,841,917,17,6,14,7,3,4,18,18,0,17,11,24
2333,841,917,8,8,14,6,2,6,27,21,6,14,14,20
2334,841,917,43,3,14,7,4,3,24,15,9,18,10,25
2335,841,917,57,9,14,6,2,6,19,18,1,14,14,20
2336,841,917,21,1,14,8,1,5,26,24,2,17,11,25
2337,841,917,4,10,14,6,2,6,28,29,-1,14,14,20
2338,841,917,7,12,14,5,2,7,18,23,-5,12,16,17
2339,841,917,41,4,14,8,0,6,20,18,2,16,12,24
2340,841,917,49,2,14,7,4,3,20,9,11,18,10,25
2341,841,917,53,15,14,3,4,7,11,16,-5,10,18,13
2342,841,917,1,5,14,7,3,4,20,16,4,17,11,24
2343,841,917,18,14,14,3,5,6,12,18,-6,11,17,14
2344,841,917,39,16,14,2,3,9,13,28,-15,7,21,9
2345,977,980,39,15,24,6,5,13,25,42,-17,17,31,23
2346,977,980,1,8,24,10,5,9,30,28,2,25,23,35
2347,977,980,18,16,24,5,6,13,20,32,-12,16,32,21
2348,977,980,53,13,24,6,9,9,21,22,-1,21,27,27
2349,977,980,21,2,24,14,2,8,43,36,7,30,18,44
2350,977,980,4,3,24,13,2,9,49,43,6,28,20,41
2351,977,980,7,6,24,12,2,10,38,34,4,26,22,38
2352,977,980,41,7,24,11,2,11,34,33,1,24,24,35
2353,977,980,43,5,24,11,6,7,38,28,10,28,20,39
2354,977,980,57,9,24,9,6,9,27,30,-3,24,24,33
2355,977,980,28,10,24,8,8,8,32,29,3,24,24,32
2356,977,980,36,12,24,9,4,11,29,33,-4,22,26,31
2357,977,980,48,14,24,7,4,13,17,31,-14,18,30,25
2358,977,980,49,1,24,14,4,6,34,18,16,32,16,46
2359,977,980,17,4,24,12,3,9,33,31,2,27,21,39
2360,977,980,8,11,24,9,4,11,34,34,0,22,26,31
2361,799,805,17,1,9,5,3,1,12,9,3,13,5,18
2362,799,805,8,10,9,3,2,4,18,12,6,8,10,11
2363,799,805,49,6,9,4,2,3,12,8,4,10,8,14
2364,799,805,28,5,9,4,2,3,17,12,5,10,8,14
2365,799,805,36,11,9,3,2,4,12,15,-3,8,10,11
2366,799,805,48,13,9,3,1,5,5,10,-5,7,11,10
2367,799,805,57,2,9,5,1,3,16,12,4,11,7,16
2368,799,805,43,3,9,4,4,1,15,8,7,12,6,16
2369,799,805,41,4,9,5,0,4,15,12,3,10,8,15
2370,799,805,4,8,9,4,1,4,18,21,-3,9,9,13
2371,799,805,21,9,9,4,1,4,13,17,-4,9,9,13
2372,799,805,7,12,9,3,2,4,11,16,-5,8,10,11
2373,799,805,53,14,9,2,3,4,9,11,-2,7,11,9
2374,799,805,1,7,9,4,2,3,13,11,2,10,8,14
2375,799,805,18,16,9,1,4,4,6,13,-7,6,12,7
2376,799,805,39,15,9,2,2,5,8,13,-5,6,12,8
2377,1107,1113,1,15,2,0,1,1,1,4,-3,1,3,1
2378,1107,1113,53,2,2,2,0,0,4,0,4,4,0,6
2379,1107,1113,44,3,2,1,1,0,3,1,2,3,1,4
2380,1107,1113,41,4,2,1,1,0,3,2,1,3,1,4
2381,1107,1113,21,7,2,1,0,1,2,2,0,2,2,3
2382,1107,1113,4,7,2,1,0,1,2,2,0,2,2,3
2383,1107,1113,7,13,2,0,1,1,3,5,-2,1,3,1
2384,1107,1113,43,1,2,2,0,0,5,0,5,4,0,6
2385,1107,1113,57,10,2,0,2,0,2,2,0,2,2,2
2386,1107,1113,24,12,2,0,1,1,2,3,-1,1,3,1
2387,1107,1113,28,10,2,0,2,0,2,2,0,2,2,2
2388,1107,1113,48,14,2,0,1,1,1,3,-2,1,3,1
2389,1107,1113,36,16,2,0,0,2,1,5,-4,0,4,0
2390,1107,1113,49,5,2,1,0,1,4,4,0,2,2,3
2391,1107,1113,17,6,2,1,0,1,3,3,0,2,2,3
2392,1107,1113,8,9,2,0,2,0,5,5,0,2,2,2
2393,1590,1596,1,13,16,3,6,7,22,21,1,12,20,15
2394,1632,1645,1,9,22,6,7,9,36,28,8,19,25,25
2395,1632,1645,53,5,22,10,6,6,39,17,22,26,18,36
2396,1632,1645,49,2,22,12,6,4,39,24,15,30,14,42
2397,1632,1645,30,3,22,10,7,5,48,26,22,27,17,37
2398,1632,1645,41,4,22,10,7,5,36,20,16,27,17,37
2399,1632,1645,17,6,22,11,2,9,41,38,3,24,20,35
2400,1632,1645,8,7,22,9,4,9,34,44,-10,22,22,31
2401,1632,1645,7,10,22,5,8,9,21,41,-20,18,26,23
2402,1632,1645,21,12,22,5,7,10,18,45,-27,17,27,22
2403,1632,1645,4,13,22,4,10,8,27,33,-6,18,26,22
2404,1632,1645,43,1,22,19,2,1,68,15,53,40,4,59
2405,1632,1645,57,15,22,5,5,12,23,48,-25,15,29,20
2406,1632,1645,28,8,22,8,7,7,38,33,5,23,21,31
2407,1632,1645,48,11,22,5,7,10,22,37,-15,17,27,22
2408,1632,1645,36,16,22,3,8,11,28,46,-18,14,30,17
2409,1632,1645,39,14,22,5,5,12,23,46,-23,15,29,20
2410,1646,1652,39,12,23,6,5,12,25,47,-22,17,29,23
2411,1646,1652,28,7,23,8,8,7,39,34,5,24,22,32
2412,1646,1652,48,13,23,5,8,10,23,38,-15,18,28,23
2413,1646,1652,36,16,23,4,8,11,29,46,-17,16,30,20
2414,1646,1652,43,1,23,20,2,1,70,15,55,42,4,62
2415,1646,1652,57,15,23,5,6,12,25,50,-25,16,30,21
2416,1646,1652,21,10,23,6,7,10,19,45,-26,19,27,25
2417,1646,1652,7,11,23,5,9,9,23,43,-20,19,27,24
2418,1646,1652,4,14,23,4,11,8,28,34,-6,19,27,23
2419,1646,1652,17,6,23,11,2,10,41,39,2,24,22,35
2420,1646,1652,8,8,23,9,4,10,35,46,-11,22,24,31
2421,1646,1652,41,3,23,11,7,5,38,20,18,29,17,40
2422,1646,1652,30,4,23,10,8,5,49,27,22,28,18,38
2423,1646,1652,49,2,23,12,6,5,39,26,13,30,16,42
2424,1646,1652,53,5,23,10,6,7,39,18,21,26,20,36
2425,1646,1652,1,9,23,6,7,10,36,30,6,19,27,25
2426,1681,1694,1,9,28,9,8,11,47,34,13,26,30,35
2427,1681,1694,53,3,28,13,6,9,49,26,23,32,24,45
2428,1681,1694,49,2,28,14,9,5,45,28,17,37,19,51
2429,1681,1694,30,4,28,12,9,7,61,38,23,33,23,45
2430,1681,1694,41,5,28,11,9,8,40,30,10,31,25,42
2431,1681,1694,17,7,28,13,2,13,48,47,1,28,28,41
2432,1681,1694,8,8,28,10,5,13,40,57,-17,25,31,35
2433,1681,1694,7,10,28,8,9,11,31,51,-20,25,31,33
2434,1681,1694,4,12,28,6,12,10,36,41,-5,24,32,30
2435,1681,1694,21,13,28,7,8,13,25,55,-30,22,34,29
2436,1681,1694,43,1,28,23,3,2,78,19,59,49,7,72
2437,1681,1694,57,11,28,8,7,13,32,56,-24,23,33,31
2438,1681,1694,28,6,28,11,9,8,48,39,9,31,25,42
2439,1681,1694,48,14,28,6,10,12,28,45,-17,22,34,28
2440,1681,1694,36,15,28,6,9,13,39,52,-13,21,35,27
2441,1681,1694,39,16,28,6,7,15,29,58,-29,19,37,25
2442,1506,1512,39,9,6,2,2,2,9,10,-1,6,6,8
2443,1506,1512,28,10,6,2,1,3,11,8,3,5,7,7
2444,1506,1512,48,14,6,1,1,4,3,13,-10,3,9,4
2445,1506,1512,36,16,6,0,2,4,6,12,-6,2,10,2
2446,1506,1512,43,1,6,6,0,0,23,4,19,12,0,18
2447,1506,1512,57,15,6,1,1,4,7,22,-15,3,9,4
2448,1506,1512,4,5,6,3,2,1,13,10,3,8,4,11
2449,1506,1512,21,12,6,1,2,3,5,14,-9,4,8,5
2450,1506,1512,7,13,6,1,2,3,6,17,-11,4,8,5
2451,1506,1512,17,2,6,4,1,1,14,7,7,9,3,13
2452,1506,1512,8,7,6,3,0,3,17,19,-2,6,6,9
2453,1506,1512,41,4,6,3,2,1,14,8,6,8,4,11
2454,1506,1512,30,11,6,1,2,3,7,10,-3,4,8,5
2455,1506,1512,49,3,6,3,3,0,15,6,9,9,3,12
2456,1506,1512,53,6,6,3,1,2,10,5,5,7,5,10
2457,1506,1512,1,8,6,2,2,2,12,7,5,6,6,8
2458,1527,1533,1,11,8,2,3,3,12,9,3,7,9,9
2459,1527,1533,53,6,8,3,2,3,13,9,4,8,8,11
2460,1527,1533,49,3,8,4,3,1,19,9,10,11,5,15
2461,1527,1533,17,2,8,5,1,2,19,13,6,11,5,16
2462,1527,1533,8,10,8,3,1,4,17,20,-3,7,9,10
2463,1527,1533,41,4,8,4,3,1,18,8,10,11,5,15
2464,1527,1533,30,8,8,3,2,3,15,13,2,8,8,11
2465,1527,1533,4,9,8,3,2,3,15,14,1,8,8,11
2466,1527,1533,21,12,8,2,2,4,8,19,-11,6,10,8
2467,1527,1533,7,13,8,2,2,4,8,20,-12,6,10,8
2468,1527,1533,28,7,8,3,2,3,12,8,4,8,8,11
2469,1527,1533,48,15,8,1,2,5,5,19,-14,4,12,5
2470,1527,1533,36,16,8,0,3,5,10,17,-7,3,13,3
2471,1527,1533,43,1,8,8,0,0,28,7,21,16,0,24
2472,2584,2597,43,1,5,5,0,0,19,4,15,10,0,15
2473,2584,2597,24,11,5,1,2,2,6,6,0,4,6,5
2474,2584,2597,17,2,5,3,1,1,14,8,6,7,3,10
2475,2584,2597,8,5,5,2,2,1,10,9,1,6,4,8
2476,2584,2597,41,12,5,1,2,2,5,8,-3,4,6,5
2477,2584,2597,20,14,5,1,1,3,5,13,-8,3,7,4
2478,2584,2597,1,4,5,3,0,2,9,6,3,6,4,9
2479,2584,2597,18,16,5,0,2,3,2,9,-7,2,8,2
2480,2584,2597,21,8,5,2,1,2,8,9,-1,5,5,7
2481,2584,2597,7,10,5,2,0,3,9,11,-2,4,6,6
2482,2584,2597,27,9,5,2,0,3,5,6,-1,4,6,6
2483,2598,2604,27,11,6,2,0,4,6,9,-3,4,8,6
2484,2598,2604,7,7,6,3,0,3,10,11,-1,6,6,9
2485,2598,2604,21,9,6,2,2,2,8,9,-1,6,6,8
2486,2598,2604,1,2,6,4,0,2,12,6,6,8,4,12
2487,2598,2604,18,16,6,0,2,4,2,12,-10,2,10,2
2488,2598,2604,20,10,6,2,1,3,6,13,-7,5,7,7
2489,2598,2604,41,13,6,1,2,3,6,10,-4,4,8,5
2490,2598,2604,17,5,6,3,1,2,14,10,4,7,5,10
2491,2598,2604,8,8,6,2,3,1,11,10,1,7,5,9
2492,2598,2604,43,1,6,6,0,0,21,4,17,12,0,18
2493,2598,2604,24,12,6,1,2,3,6,7,-1,4,8,5
2494,2598,2604,52,6,6,3,1,2,14,12,2,7,5,10
2495,2598,2604,28,14,6,1,2,3,7,13,-6,4,8,5
2496,2598,2604,37,3,6,3,2,1,10,6,4,8,4,11
2497,2598,2604,49,4,6,3,2,1,11,9,2,8,4,11
2498,2598,2604,53,15,6,0,4,2,3,6,-3,4,8,4
2499,3032,3045,4,13,14,3,6,5,14,18,-4,12,16,15
2500,3032,3045,7,16,14,2,3,9,12,29,-17,7,21,9
2501,3032,3045,53,8,14,5,3,6,26,26,0,13,15,18
2502,3032,3045,49,3,14,7,5,2,25,10,15,19,9,26
2503,3032,3045,37,7,14,5,5,4,22,19,3,15,13,20
2504,3032,3045,43,4,14,6,6,2,31,15,16,18,10,24
2505,3032,3045,28,6,14,5,7,2,22,18,4,17,11,22
2506,3032,3045,52,10,14,4,5,5,18,22,-4,13,15,17
2507,3032,3045,24,15,14,3,4,7,19,33,-14,10,18,13
2508,3032,3045,17,5,14,5,7,2,27,18,9,17,11,22
2509,3032,3045,8,14,14,3,5,6,13,22,-9,11,17,14
2510,3032,3045,20,9,14,5,3,6,24,25,-1,13,15,18
2511,3032,3045,41,12,14,4,3,7,19,28,-9,11,17,15
2512,3032,3045,1,1,14,8,2,4,25,13,12,18,10,26
2513,3032,3045,27,2,14,8,2,4,22,17,5,18,10,26
2514,3032,3045,39,11,14,4,4,6,17,23,-6,12,16,16
2515,3046,3052,27,3,15,8,3,4,23,18,5,19,11,27
2516,3046,3052,39,13,15,4,4,7,17,24,-7,12,18,16
2517,3046,3052,1,2,15,8,3,4,27,15,12,19,11,27
2518,3046,3052,20,9,15,5,3,7,24,26,-2,13,17,18
2519,3046,3052,41,14,15,4,3,8,19,29,-10,11,19,15
2520,3046,3052,17,6,15,5,8,2,28,19,9,18,12,23
2521,3046,3052,8,12,15,4,5,6,14,22,-8,13,17,17
2522,3046,3052,43,4,15,6,7,2,33,17,16,19,11,25
2523,3046,3052,24,15,15,3,4,8,19,34,-15,10,20,13
2524,3046,3052,28,5,15,6,7,2,23,18,5,19,11,25
2525,3046,3052,52,11,15,4,5,6,18,23,-5,13,17,17
2526,3046,3052,49,1,15,8,5,2,31,10,21,21,9,29
2527,3046,3052,37,8,15,5,5,5,22,25,-3,15,15,20
2528,3046,3052,53,7,15,6,3,6,27,26,1,15,15,21
2529,3046,3052,4,10,15,4,6,5,15,18,-3,14,16,18
2530,3046,3052,7,16,15,3,3,9,13,29,-16,9,21,12
2531,3130,3143,53,12,25,8,5,12,35,43,-8,21,29,29
2532,3130,3143,49,1,25,15,7,3,52,16,36,37,13,52
2533,3130,3143,37,6,25,10,7,8,36,37,-1,27,23,37
2534,3130,3143,43,5,25,11,9,5,52,29,23,31,19,42
2535,3130,3143,24,15,25,4,7,14,25,47,-22,15,35,19
2536,3130,3143,28,7,25,9,9,7,36,36,0,27,23,36
2537,3130,3143,52,13,25,7,7,11,27,36,-9,21,29,28
2538,3130,3143,17,3,25,12,9,4,43,28,15,33,17,45
2539,3130,3143,8,8,25,9,6,10,26,34,-8,24,26,33
2540,3130,3143,20,10,25,9,4,12,39,43,-4,22,28,31
2541,3130,3143,41,11,25,9,4,12,28,40,-12,22,28,31
2542,3130,3143,1,4,25,12,7,6,51,27,24,31,19,43
2543,3130,3143,4,9,25,7,11,7,27,30,-3,25,25,32
2544,3130,3143,7,16,25,4,4,17,21,53,-32,12,38,16
2545,3130,3143,27,2,25,15,3,7,40,26,14,33,17,48
2546,3130,3143,39,14,25,5,9,11,24,37,-13,19,31,24
2547,3165,3171,27,2,29,17,5,7,42,26,16,39,19,56
2548,3165,3171,39,13,29,8,9,12,30,41,-11,25,33,33
2549,3165,3171,4,11,29,8,12,9,32,37,-5,28,30,36
2550,3165,3171,7,16,29,5,5,19,27,62,-35,15,43,20
2551,3165,3171,1,4,29,13,8,8,54,32,22,34,24,47
2552,1527,1533,57,14,8,2,1,5,8,23,-15,5,11,7
2553,1527,1533,39,5,8,3,3,2,11,10,1,9,7,12
2554,2010,2016,43,1,24,18,3,3,66,14,52,39,9,57
2555,2010,2016,24,5,24,12,4,8,26,26,0,28,20,40
2556,2010,2016,57,16,24,3,6,15,15,39,-24,12,36,15
2557,2010,2016,28,4,24,15,2,7,33,24,9,32,16,47
2558,2010,2016,52,11,24,7,6,11,27,34,-7,20,28,27
2559,2010,2016,48,15,24,4,7,13,21,44,-23,15,33,19
2560,2010,2016,17,13,24,5,9,10,20,34,-14,19,29,24
2561,2010,2016,8,14,24,6,4,14,26,44,-18,16,32,22
2562,2010,2016,21,6,24,9,6,9,35,32,3,24,24,33
2563,2010,2016,4,7,24,8,8,8,38,47,-9,24,24,32
2564,2010,2016,7,12,24,6,6,12,20,27,-7,18,30,24
2565,2010,2016,41,9,24,8,6,10,39,36,3,22,26,30
2566,2010,2016,30,10,24,7,9,8,23,32,-9,23,25,30
2567,2010,2016,49,2,24,14,6,4,39,15,24,34,14,48
2568,2010,2016,53,3,24,14,6,4,36,23,13,34,14,48
2569,2010,2016,1,8,24,7,10,7,37,30,7,24,24,31
2570,2024,2030,1,7,26,8,11,7,42,34,8,27,25,35
2571,2024,2030,53,4,26,14,7,5,38,26,12,35,17,49
2572,2024,2030,49,2,26,15,6,5,42,19,23,36,16,51
2573,2024,2030,41,8,26,9,7,10,42,38,4,25,27,34
2574,2024,2030,30,10,26,8,10,8,28,35,-7,26,26,34
2575,2024,2030,4,6,26,10,8,8,43,48,-5,28,24,38
2576,2024,2030,21,9,26,9,7,10,38,36,2,25,27,34
2577,2024,2030,7,12,26,7,6,13,23,29,-6,20,32,27
2578,2024,2030,17,13,26,6,9,11,22,36,-14,21,31,27
2579,2024,2030,8,14,26,6,5,15,26,47,-21,17,35,23
2580,2024,2030,28,3,26,16,2,8,39,28,11,34,18,50
2581,2024,2030,52,11,26,8,6,12,31,40,-9,22,30,30
2582,2024,2030,48,15,26,4,8,14,21,47,-26,16,36,20
2583,2024,2030,43,1,26,19,4,3,70,15,55,42,10,61
2584,2024,2030,24,5,26,12,6,8,30,30,0,30,22,42
2585,2024,2030,57,16,26,3,6,17,17,44,-27,12,40,15
2586,1856,1862,43,2,4,3,0,1,8,3,5,6,2,9
2587,1856,1862,24,6,4,2,1,1,5,4,1,5,3,7
2588,1856,1862,57,15,4,0,0,4,0,6,-6,0,8,0
2589,1856,1862,28,1,4,4,0,0,9,2,7,8,0,12
2590,1856,1862,52,9,4,1,2,1,3,3,0,4,4,5
2591,1856,1862,48,16,4,0,0,4,3,10,-7,0,8,0
2592,1856,1862,8,4,4,3,0,1,6,6,0,6,2,9
2593,1856,1862,17,9,4,1,2,1,3,3,0,4,4,5
2594,1856,1862,4,7,4,2,1,1,5,6,-1,5,3,7
2595,1856,1862,21,8,4,1,2,1,4,4,0,4,4,5
2596,1856,1862,7,13,4,0,2,2,1,3,-2,2,6,2
2597,1856,1862,41,5,4,2,2,0,9,2,7,6,2,8
2598,1856,1862,30,11,4,1,1,2,4,6,-2,3,5,4
2599,1856,1862,49,12,4,0,3,1,4,5,-1,3,5,3
2600,1856,1862,53,3,4,3,0,1,6,4,2,6,2,9
2601,1856,1862,1,14,4,0,2,2,2,5,-3,2,6,2
2602,2367,2373,1,1,22,15,3,4,48,27,21,33,11,48
2603,2367,2373,21,5,22,10,7,5,28,16,12,27,17,37
2604,2367,2373,4,8,22,7,6,9,24,37,-13,20,24,27
2605,2367,2373,7,10,22,5,9,8,28,36,-8,19,25,24
2606,2367,2373,53,12,22,6,5,11,37,47,-10,17,27,23
2607,2367,2373,49,3,22,11,6,5,38,24,14,28,16,39
2608,2367,2373,41,4,22,11,5,6,33,20,13,27,17,38
2609,2367,2373,20,7,22,7,10,5,17,14,3,24,20,31
2610,2367,2373,30,14,22,5,4,13,22,45,-23,14,30,19
2611,2367,2373,17,9,22,7,5,10,23,28,-5,19,25,26
2612,2367,2373,8,13,22,5,8,9,33,38,-5,18,26,23
2613,2367,2373,28,6,22,8,7,7,31,29,2,23,21,31
2614,2367,2373,52,15,22,4,7,11,21,38,-17,15,29,19
2615,2367,2373,43,2,22,14,5,3,48,10,38,33,11,47
2616,2367,2373,24,11,22,4,12,6,25,30,-5,20,24,24
2617,2367,2373,27,16,22,3,9,10,21,38,-17,15,29,18
2618,2255,2268,27,14,9,1,5,3,6,11,-5,7,11,8
2619,2255,2268,43,4,9,4,4,1,12,6,6,12,6,16
2620,2255,2268,24,15,9,1,5,3,6,12,-6,7,11,8
2621,2255,2268,28,10,9,2,3,4,14,16,-2,7,11,9
2622,2255,2268,52,16,9,1,3,5,7,13,-6,5,13,6
2623,2255,2268,8,8,9,3,3,3,16,12,4,9,9,12
2624,2255,2268,17,11,9,2,3,4,6,9,-3,7,11,9
2625,2255,2268,21,1,9,6,2,1,15,6,9,14,4,20
2626,2255,2268,7,6,9,3,4,2,15,11,4,10,8,13
2627,2255,2268,4,13,9,1,5,3,7,12,-5,7,11,8
2628,2255,2268,41,3,9,5,3,1,12,6,6,13,5,18
2629,2255,2268,20,7,9,3,4,2,9,7,2,10,8,13
2630,2255,2268,30,9,9,3,0,6,11,19,-8,6,12,9
2631,2255,2268,49,5,9,4,3,2,15,12,3,11,7,15
2632,1268,1274,8,2,23,12,8,3,34,23,11,32,14,44
2633,1268,1274,17,14,23,5,7,11,30,37,-7,17,29,22
2634,1268,1274,49,3,23,12,6,5,46,23,23,30,16,42
2635,1268,1274,36,5,23,11,5,7,36,27,9,27,19,38
2636,1268,1274,28,10,23,6,7,10,31,41,-10,19,27,25
2637,1268,1274,48,13,23,6,4,13,22,41,-19,16,30,22
2638,1268,1274,43,1,23,16,6,1,69,20,49,38,8,54
2639,1268,1274,57,11,23,6,7,10,16,33,-17,19,27,25
2640,1268,1274,24,16,23,3,5,15,18,42,-24,11,35,14
2641,1268,1274,41,6,23,10,6,7,28,22,6,26,20,36
2642,1268,1274,21,7,23,9,8,6,30,27,3,26,20,35
2643,1268,1274,4,8,23,10,4,9,35,38,-3,24,22,34
2644,1268,1274,7,9,23,6,7,10,29,37,-8,19,27,25
2645,1268,1274,53,4,23,11,8,4,42,22,20,30,16,41
2646,1268,1274,44,12,23,5,8,10,20,36,-16,18,28,23
2647,1268,1274,1,15,23,5,6,12,23,40,-17,16,30,21
2648,1282,1288,1,15,25,6,7,12,28,42,-14,19,31,25
2649,1282,1288,53,4,25,11,10,4,43,23,20,32,18,43
2650,1282,1288,44,11,25,6,8,11,22,42,-20,20,30,26
2651,1282,1288,21,7,25,10,9,6,33,29,4,29,21,39
2652,1282,1288,4,8,25,10,4,11,35,41,-6,24,26,34
2653,1282,1288,7,14,25,6,7,12,31,43,-12,19,31,25
2654,1282,1288,41,6,25,11,6,8,31,24,7,28,22,39
2655,1282,1288,43,1,25,17,7,1,70,20,50,41,9,58
2656,1282,1288,57,12,25,6,8,11,17,37,-20,20,30,26
2657,1282,1288,24,16,25,3,6,16,19,44,-25,12,38,15
2658,1282,1288,36,5,25,12,6,7,39,29,10,30,20,42
2659,1282,1288,28,10,25,6,8,11,32,43,-11,20,30,26
2660,1282,1288,48,13,25,7,4,14,25,43,-18,18,32,25
2661,1282,1288,49,3,25,13,7,5,47,23,24,33,17,46
2662,1282,1288,8,2,25,13,9,3,40,24,16,35,15,48
2663,1282,1288,17,9,25,6,8,11,33,38,-5,20,30,26
2664,1604,1610,28,8,18,7,6,5,33,28,5,20,16,27
2665,1604,1610,36,14,18,3,8,7,24,32,-8,14,22,17
2666,1604,1610,48,16,18,2,6,10,15,36,-21,10,26,12
2667,1604,1610,43,1,18,16,1,1,57,13,44,33,3,49
2668,1604,1610,57,13,18,4,5,9,21,38,-17,13,23,17
2669,1604,1610,17,3,18,10,1,7,38,35,3,21,15,31
2670,1604,1610,8,6,18,8,3,7,30,37,-7,19,17,27
2671,1604,1610,21,9,18,5,5,8,17,39,-22,15,21,20
2672,1604,1610,4,11,18,3,9,6,20,24,-4,15,21,18
2673,1604,1610,7,15,18,3,7,8,15,34,-19,13,23,16
2674,1604,1610,41,5,18,8,5,5,31,19,12,21,15,29
2675,1604,1610,30,7,18,7,6,5,36,21,15,20,16,27
2676,1604,1610,49,2,18,10,6,2,36,18,18,26,10,36
2677,1604,1610,53,4,18,8,5,5,31,16,15,21,15,29
2678,1604,1610,1,10,18,4,6,8,25,23,2,14,22,18
2679,1604,1610,39,12,18,4,5,9,20,36,-16,13,23,17
2680,1534,1540,39,9,9,3,3,3,11,11,0,9,9,12
2681,1534,1540,1,11,9,2,4,3,13,10,3,8,10,10
2682,1534,1540,53,5,9,4,2,3,16,9,7,10,8,14
2683,1534,1540,41,4,9,4,3,2,18,11,7,11,7,15
2684,1534,1540,30,7,9,3,3,3,16,14,2,9,9,12
2685,1534,1540,4,8,9,3,3,3,16,15,1,9,9,12
2686,1534,1540,21,12,9,2,2,5,9,21,-12,6,12,8
2687,1534,1540,7,13,9,2,2,5,9,23,-14,6,12,8
2688,1534,1540,43,1,9,9,0,0,30,8,22,18,0,27
2689,1534,1540,57,14,9,2,2,5,9,24,-15,6,12,8
2690,1534,1540,28,6,9,4,2,3,14,9,5,10,8,14
2691,1534,1540,48,15,9,1,2,6,6,21,-15,4,14,5
2692,1534,1540,36,16,9,0,4,5,11,18,-7,4,14,4
2693,1534,1540,17,2,9,6,1,2,22,14,8,13,5,19
2694,1534,1540,8,10,9,3,2,4,18,21,-3,8,10,11
2695,1534,1540,49,3,9,5,3,1,20,9,11,13,5,18
2696,1954,1960,49,4,16,8,4,4,25,12,13,20,12,28
2697,1954,1960,8,14,16,4,2,10,14,30,-16,10,22,14
2698,1954,1960,17,15,16,3,5,8,11,25,-14,11,21,14
2699,1954,1960,43,1,16,13,1,2,39,9,30,27,5,40
2700,1954,1960,28,2,16,13,1,2,28,11,17,27,5,40
2701,1954,1960,48,12,16,4,4,8,14,23,-9,12,20,16
2702,1954,1960,52,13,16,4,3,9,19,26,-7,11,21,15
2703,1954,1960,24,5,16,8,2,6,19,16,3,18,14,26
2704,1954,1960,57,16,16,1,4,11,7,24,-17,6,26,7
2705,1954,1960,21,7,16,6,4,6,24,24,0,16,16,22
2706,1954,1960,4,8,16,6,4,6,27,35,-8,16,16,22
2707,1954,1960,7,11,16,4,4,8,14,13,1,12,20,16
2708,1954,1960,41,6,16,6,4,6,28,27,1,16,16,22
2709,1954,1960,30,9,16,6,4,6,16,24,-8,16,16,22
2710,1954,1960,53,3,16,10,4,2,23,13,10,24,8,34
2711,1702,1827,39,15,30,7,8,15,32,58,-26,22,38,29
2712,1926,1932,1,11,13,3,5,5,23,20,3,11,15,14
2713,1926,1932,53,3,13,9,2,2,19,11,8,20,6,29
2714,1926,1932,41,6,13,5,4,4,23,18,5,14,12,19
2715,1926,1932,30,10,13,4,3,6,11,21,-10,11,15,15
2716,1926,1932,21,7,13,5,4,4,20,19,1,14,12,19
2717,1926,1932,4,8,13,5,3,5,22,28,-6,13,13,18
2718,1926,1932,7,12,13,3,4,6,8,10,-2,10,16,13
2719,1926,1932,8,13,13,3,2,8,12,25,-13,8,18,11
2720,1926,1932,17,16,13,1,4,8,7,23,-16,6,20,7
2721,1926,1932,49,5,13,5,4,4,18,10,8,14,12,19
2722,1926,1932,28,1,13,12,1,0,27,8,19,25,1,37
2723,1926,1932,48,9,13,4,3,6,14,17,-3,11,15,15
2724,1926,1932,52,14,13,2,2,9,9,24,-15,6,20,8
2725,1926,1932,43,2,13,11,1,1,31,4,27,23,3,34
2726,1926,1932,24,4,13,7,2,4,18,11,7,16,10,23
2727,1926,1932,57,15,13,1,4,8,5,18,-13,6,20,7
2728,1884,1890,28,1,7,7,0,0,15,4,11,14,0,21
2729,1884,1890,52,14,7,1,2,4,3,11,-8,4,10,5
2730,1884,1890,48,15,7,0,2,5,3,11,-8,2,12,2
2731,1884,1890,43,2,7,6,0,1,14,3,11,12,2,18
2732,1884,1890,24,3,7,4,1,2,9,6,3,9,5,13
2733,1884,1890,57,16,7,0,2,5,1,10,-9,2,12,2
2734,1884,1890,49,12,7,1,3,3,6,8,-2,5,9,6
2735,1884,1890,8,8,7,3,1,3,8,11,-3,7,7,10
2736,1884,1890,17,10,7,1,4,2,4,5,-1,6,8,7
2737,1884,1890,4,5,7,4,1,2,13,14,-1,9,5,13
2738,1884,1890,21,7,7,3,3,1,11,6,5,9,5,12
2739,1884,1890,7,13,7,1,2,4,4,7,-3,4,10,5
2740,1884,1890,41,6,7,3,3,1,15,5,10,9,5,12
2741,1884,1890,30,9,7,2,2,3,5,9,-4,6,8,8
2742,1884,1890,53,4,7,4,1,2,7,6,1,9,5,13
2743,1884,1890,1,11,7,1,3,3,9,11,-2,5,9,6
2744,2283,2289,1,1,12,9,1,2,27,14,13,19,5,28
2745,2283,2289,53,11,12,3,2,7,18,25,-7,8,16,11
2746,2283,2289,21,4,12,6,4,2,17,9,8,16,8,22
2747,2283,2289,7,10,12,3,5,4,19,18,1,11,13,14
2748,2283,2289,4,12,12,2,5,5,11,19,-8,9,15,11
2749,2283,2289,8,7,12,4,4,4,22,18,4,12,12,16
2750,2283,2289,17,8,12,4,4,4,13,11,2,12,12,16
2751,2283,2289,49,5,12,6,3,3,21,15,6,15,9,21
2752,2283,2289,41,3,12,7,3,2,14,7,7,17,7,24
2753,2283,2289,20,6,12,4,5,3,11,9,2,13,11,17
2754,2283,2289,30,14,12,3,0,9,13,27,-14,6,18,9
2755,2283,2289,43,2,12,7,4,1,21,6,15,18,6,25
2756,2283,2289,24,13,12,1,7,4,11,18,-7,9,15,10
2757,2283,2289,28,9,12,4,4,4,20,19,1,12,12,16
2758,2283,2289,52,16,12,1,5,6,9,22,-13,7,17,8
2759,2283,2289,27,15,12,1,6,5,8,18,-10,8,16,9
2760,2360,2366,27,15,21,3,9,9,21,36,-15,15,27,18
2761,2360,2366,28,7,21,7,7,7,30,29,1,21,21,28
2762,2360,2366,52,16,21,3,7,11,19,38,-19,13,29,16
2763,2360,2366,17,8,21,7,5,9,21,25,-4,19,23,26
2764,2360,2366,8,11,21,5,8,8,33,33,0,18,24,23
2765,2360,2366,43,2,21,13,5,3,43,10,33,31,11,44
2766,2360,2366,24,12,21,3,12,6,23,29,-6,18,24,21
2767,2360,2366,49,3,21,11,6,4,38,23,15,28,14,39
2768,2360,2366,41,4,21,11,5,5,32,18,14,27,15,38
2769,2360,2366,20,6,21,7,10,4,17,13,4,24,18,31
2770,2360,2366,30,14,21,5,4,12,22,43,-21,14,28,19
2771,2360,2366,21,5,21,9,7,5,26,16,10,25,17,34
2772,2360,2366,4,9,21,6,6,9,21,35,-14,18,24,24
2773,2360,2366,7,10,21,5,9,7,28,34,-6,19,23,24
2774,2360,2366,53,13,21,5,5,11,35,47,-12,15,27,20
2775,2360,2366,1,1,21,14,3,4,47,27,20,31,11,45
2776,2430,2433,1,2,28,19,3,6,55,32,23,41,15,60
2777,2430,2433,53,12,28,7,8,13,41,53,-12,22,34,29
2778,2430,2433,21,5,28,11,9,8,33,24,9,31,25,42
2779,2430,2433,7,9,28,7,11,10,39,46,-7,25,31,32
2780,2430,2433,4,13,28,7,8,13,29,50,-21,22,34,29
2781,2430,2433,41,3,28,16,5,7,42,26,16,37,19,53
2782,2430,2433,20,7,28,8,12,8,27,26,1,28,28,36
2783,2430,2433,30,16,28,6,4,18,26,58,-32,16,40,22
2784,2430,2433,17,8,28,9,7,12,32,35,-3,25,31,34
2785,2430,2433,8,10,28,6,12,10,41,45,-4,24,32,30
2786,2430,2433,49,4,28,14,7,7,44,29,15,35,21,49
2787,2430,2433,43,1,28,19,6,3,61,12,49,44,12,63
2788,2430,2433,24,11,28,6,12,10,33,41,-8,24,32,30
2789,2430,2433,28,6,28,11,7,10,40,36,4,29,27,40
2790,1863,1869,48,15,5,0,1,4,3,10,-7,1,9,1
2791,1863,1869,43,2,5,4,0,1,10,3,7,8,2,12
2792,1863,1869,24,3,5,3,1,1,7,4,3,7,3,10
2793,1863,1869,57,16,5,0,0,5,1,10,-9,0,10,0
2794,1891,1897,43,2,8,7,0,1,16,3,13,14,2,21
2795,1891,1897,24,7,8,4,1,3,9,7,2,9,7,13
2796,1891,1897,57,16,8,0,2,6,1,12,-11,2,14,2
2797,1891,1897,28,1,8,8,0,0,18,5,13,16,0,24
2798,1891,1897,52,11,8,2,2,4,6,13,-7,6,10,8
2799,1891,1897,48,15,8,0,2,6,4,14,-10,2,14,2
2800,1891,1897,8,9,8,3,1,4,8,13,-5,7,9,10
2801,1891,1897,17,12,8,1,4,3,5,8,-3,6,10,7
2802,1891,1897,49,10,8,2,3,3,7,8,-1,7,9,9
2803,1891,1897,41,3,8,4,3,1,18,6,12,11,5,15
2804,1891,1897,30,8,8,3,2,3,7,10,-3,8,8,11
2805,1891,1897,53,5,8,4,2,2,9,8,1,10,6,14
2806,1891,1897,21,4,8,4,3,1,13,6,7,11,5,15
2807,1891,1897,4,6,8,4,2,2,15,16,-1,10,6,14
2808,1891,1897,7,14,8,1,2,5,5,9,-4,4,12,5
2809,1891,1897,1,13,8,1,3,4,11,14,-3,5,11,6
2810,2269,2275,1,1,10,7,1,2,23,13,10,15,5,22
2811,2269,2275,21,2,10,6,3,1,15,6,9,15,5,21
2812,2269,2275,7,8,10,3,4,3,16,14,2,10,10,13
2813,2269,2275,4,10,10,2,5,3,10,13,-3,9,11,11
2814,2269,2275,53,15,10,2,2,6,12,21,-9,6,14,8
2815,2269,2275,49,5,10,4,3,3,15,13,2,11,9,15
2816,2269,2275,41,3,10,6,3,1,13,6,7,15,5,21
2817,2269,2275,20,6,10,3,5,2,9,7,2,11,9,14
2818,2269,2275,30,12,10,3,0,7,13,22,-9,6,14,9
2819,2269,2275,28,11,10,2,4,4,15,17,-2,8,12,10
2820,2269,2275,52,16,10,1,3,6,7,20,-13,5,15,6
2821,2269,2275,43,4,10,5,4,1,19,6,13,14,6,19
2822,2269,2275,24,14,10,1,6,3,7,13,-6,8,12,9
2823,2269,2275,8,7,10,3,4,3,18,14,4,10,10,13
2824,2269,2275,17,9,10,3,3,4,9,11,-2,9,11,12
2825,2269,2275,27,13,10,1,6,3,8,13,-5,8,12,9
2826,2353,2359,27,16,20,2,9,9,16,36,-20,13,27,15
2827,2353,2359,17,7,20,7,4,9,20,24,-4,18,22,25
2828,2353,2359,8,11,20,5,8,7,31,30,1,18,22,23
2829,2353,2359,43,1,20,13,5,2,43,8,35,31,9,44
2830,2353,2359,24,14,20,2,12,6,21,29,-8,16,24,18
2831,2353,2359,28,8,20,6,7,7,26,28,-2,19,21,25
2832,2353,2359,52,15,20,3,7,10,19,36,-17,13,27,16
2833,2353,2359,41,4,20,10,5,5,27,17,10,25,15,35
2834,2353,2359,20,6,20,7,9,4,16,12,4,23,17,30
2835,2353,2359,30,13,20,5,4,11,22,38,-16,14,26,19
2836,2353,2359,49,3,20,10,6,4,36,23,13,26,14,36
2837,2353,2359,21,5,20,9,6,5,25,15,10,24,16,33
2838,2353,2359,4,9,20,6,6,8,20,30,-10,18,22,24
2839,2353,2359,7,10,20,5,9,6,27,30,-3,19,21,24
2840,2353,2359,1,2,20,13,3,4,44,25,19,29,11,42
2841,2353,2359,53,12,20,5,4,11,34,46,-12,14,26,19
2842,2640,2646,1,2,10,6,2,2,17,7,10,14,6,20
2843,2640,2646,18,16,10,1,2,7,4,17,-13,4,16,5
2844,2640,2646,21,13,10,2,2,6,10,19,-9,6,14,8
2845,2640,2646,7,7,10,5,0,5,15,16,-1,10,10,15
2846,2640,2646,53,15,10,1,5,4,5,11,-6,7,13,8
2847,2640,2646,49,3,10,5,4,1,16,12,4,14,6,19
2848,2640,2646,37,5,10,5,2,3,17,14,3,12,8,17
2849,2640,2646,20,11,10,3,3,4,9,16,-7,9,11,12
2850,2640,2646,41,13,10,2,2,6,10,19,-9,6,14,8
2851,2640,2646,8,4,10,5,3,2,19,16,3,13,7,18
2852,2640,2646,17,6,10,5,1,4,22,20,2,11,9,16
2853,2640,2646,52,8,10,4,3,3,18,15,3,11,9,15
2854,2640,2646,28,10,10,3,3,4,17,17,0,9,11,12
2855,2640,2646,43,1,10,8,1,1,27,9,18,17,3,25
2856,2640,2646,24,12,10,3,2,5,14,13,1,8,12,11
2857,2640,2646,27,9,10,4,1,5,18,17,1,9,11,13
2858,2647,2653,27,10,11,4,2,5,19,18,1,10,12,14
2859,2647,2653,43,1,11,8,2,1,28,10,18,18,4,26
2860,2647,2653,24,12,11,3,2,6,14,14,0,8,14,11
2861,2647,2653,52,8,11,4,3,4,19,17,2,11,11,15
2862,2647,2653,28,11,11,3,3,5,18,19,-1,9,13,12
2863,2647,2653,17,4,11,6,1,4,23,20,3,13,9,19
2864,2647,2653,8,6,11,5,3,3,21,21,0,13,9,18
2865,2647,2653,20,9,11,4,3,4,14,18,-4,11,11,15
2866,2647,2653,41,13,11,3,2,6,12,20,-8,8,14,11
2867,2647,2653,37,3,11,6,2,3,19,15,4,14,8,20
2868,2647,2653,49,5,11,5,4,2,17,14,3,14,8,19
2869,2647,2653,53,14,11,2,5,4,7,12,-5,9,13,11
2870,2689,2695,53,10,15,5,5,5,16,15,1,15,15,20
2871,2689,2695,1,1,15,10,3,2,28,9,19,23,7,33
2872,2689,2695,18,13,15,4,3,8,14,25,-11,11,19,15
2873,3060,3066,1,2,17,9,4,4,34,18,16,22,12,31
2874,3060,3066,53,8,17,7,3,7,30,32,-2,17,17,24
2875,3060,3066,4,12,17,4,7,6,17,24,-7,15,19,19
2876,3060,3066,7,16,17,3,3,11,15,35,-20,9,25,12
2877,3060,3066,20,7,17,7,3,7,29,27,2,17,17,24
2878,3060,3066,41,13,17,5,3,9,22,32,-10,13,21,18
2879,3060,3066,49,1,17,10,5,2,37,11,26,25,9,35
2880,3060,3066,37,10,17,5,6,6,24,29,-5,16,18,21
2881,3060,3066,17,5,17,6,8,3,31,24,7,20,14,26
2882,3060,3066,8,9,17,6,5,6,17,23,-6,17,17,23
2883,3060,3066,43,4,17,7,8,2,40,20,20,22,12,29
2884,3060,3066,24,15,17,3,4,10,20,37,-17,10,24,13
2885,3060,3066,28,6,17,6,8,3,25,22,3,20,14,26
2886,3060,3066,52,11,17,5,5,7,21,25,-4,15,19,20
2887,3060,3066,27,3,17,9,3,5,27,21,6,21,13,30
2888,3060,3066,39,14,17,4,5,8,18,27,-9,13,21,17
2889,3095,3101,27,3,20,11,3,6,33,23,10,25,15,36
2890,3095,3101,39,14,20,4,7,9,18,30,-12,15,25,19
2891,3095,3101,28,9,20,6,9,5,28,29,-1,21,19,27
2892,3095,3101,52,12,20,6,5,9,22,29,-7,17,23,23
2893,3095,3101,43,4,20,9,8,3,44,22,22,26,14,35
2894,3095,3101,24,15,20,4,5,11,22,39,-17,13,27,17
2895,3095,3101,17,5,20,8,8,4,35,26,9,24,16,32
2896,3095,3101,8,8,20,7,6,7,22,28,-6,20,20,27
2897,3095,3101,20,11,20,7,4,9,33,34,-1,18,22,25
2898,3095,3101,41,13,20,6,4,10,23,33,-10,16,24,22
2899,3095,3101,49,1,20,12,5,3,39,12,27,29,11,41
2900,3095,3101,37,7,20,7,6,7,28,32,-4,20,20,27
2901,3095,3101,4,10,20,6,8,6,21,24,-3,20,20,26
2902,3095,3101,7,16,20,3,4,13,17,39,-22,10,30,13
2903,3095,3101,53,6,20,8,3,9,33,37,-4,19,21,27
2904,3095,3101,1,2,20,11,5,4,39,20,19,27,13,38
2905,3438,3444,1,2,21,14,3,4,47,27,20,31,11,45
2906,3438,3444,4,3,21,13,4,4,39,19,20,30,12,43
2907,3438,3444,53,4,21,10,6,5,28,16,12,26,16,36
2908,3438,3444,20,11,21,6,7,8,23,36,-13,19,23,25
2909,3438,3444,41,14,21,4,5,12,23,35,-12,13,29,17
2910,3438,3444,49,1,21,14,5,2,46,17,29,33,9,47
2911,3438,3444,37,5,21,9,6,6,32,23,9,24,18,33
2912,3438,3444,5,13,21,4,6,11,19,39,-20,14,28,18
2913,3438,3444,17,8,21,7,8,6,28,25,3,22,20,29
2914,3438,3444,8,16,21,2,8,11,22,38,-16,12,30,14
2915,3438,3444,43,7,21,8,6,7,39,21,18,22,20,30
2916,3438,3444,26,15,21,3,5,13,17,43,-26,11,31,14
2917,3438,3444,52,9,21,7,7,7,25,30,-5,21,21,28
2918,3438,3444,28,10,21,7,5,9,30,39,-9,19,23,26
2919,3438,3444,27,6,21,9,3,9,28,27,1,21,21,30
2920,3438,3444,39,12,21,5,8,8,20,31,-11,18,24,23
2921,3445,3451,27,8,22,9,3,10,28,29,-1,21,23,30
2922,3445,3451,39,12,22,5,8,9,20,32,-12,18,26,23
2923,3445,3451,52,7,22,8,7,7,27,30,-3,23,21,31
2924,3445,3451,28,11,22,7,5,10,31,41,-10,19,25,26
2925,3445,3451,43,9,22,8,6,8,39,23,16,22,22,30
2926,3445,3451,26,15,22,3,5,14,17,44,-27,11,33,14
2927,3445,3451,17,6,22,8,8,6,29,25,4,24,20,32
2928,3445,3451,8,16,22,2,8,12,22,39,-17,12,32,14
2929,3445,3451,49,1,22,15,5,2,48,18,30,35,9,50
2930,3445,3451,20,10,22,7,7,8,24,36,-12,21,23,28
2931,3445,3451,41,13,22,5,5,12,25,36,-11,15,29,20
2932,3445,3451,37,5,22,10,6,6,33,23,10,26,18,36
2933,3445,3451,5,14,22,4,6,12,19,42,-23,14,30,18
2934,3445,3451,53,4,22,11,6,5,30,16,14,28,16,39
2935,3445,3451,4,3,22,13,4,5,40,21,19,30,14,43
2936,3445,3451,1,2,22,15,3,4,50,27,23,33,11,48
2937,3508,3514,4,3,28,14,7,7,44,33,11,35,21,49
2938,3508,3514,52,8,28,10,9,9,34,38,-4,29,27,39
2939,3508,3514,28,12,28,8,6,14,35,54,-19,22,34,30
2940,3508,3514,53,5,28,13,7,8,40,24,16,33,23,46
2941,3508,3514,49,1,28,21,5,2,62,21,41,47,9,68
2942,3508,3514,37,6,28,12,8,8,38,27,11,32,24,44
2943,3508,3514,5,16,28,4,7,17,23,58,-35,15,41,19
2944,3508,3514,20,10,28,8,9,11,35,48,-13,25,31,33
2945,3508,3514,41,11,28,8,6,14,33,42,-9,22,34,30
2946,3508,3514,17,9,28,10,8,10,35,42,-7,28,28,38
2947,3508,3514,8,15,28,4,10,14,26,44,-18,18,38,22
2948,3165,3171,17,3,29,13,9,7,49,36,13,35,23,48
2949,3165,3171,8,10,29,9,9,11,31,41,-10,27,31,36
2950,3165,3171,20,8,29,11,5,13,47,50,-3,27,31,38
2951,3165,3171,41,9,29,11,4,14,33,44,-11,26,32,37
2952,3165,3171,28,7,29,10,11,8,39,41,-2,31,27,41
2953,3165,3171,52,12,29,8,9,12,29,38,-9,25,33,33
2954,3165,3171,43,5,29,12,11,6,58,32,26,35,23,47
2955,3165,3171,24,15,29,5,8,16,30,56,-26,18,40,23
2956,3165,3171,49,1,29,19,7,3,62,17,45,45,13,64
2957,3165,3171,37,6,29,11,9,9,44,44,0,31,27,42
2958,3165,3171,53,14,29,8,7,14,39,49,-10,23,35,31
2959,2969,2975,53,6,6,2,2,2,8,11,-3,6,6,8
2960,2969,2975,49,2,6,5,0,1,16,5,11,10,2,15
2961,2969,2975,37,11,6,1,3,2,13,13,0,5,7,6
2962,2969,2975,43,4,6,2,3,1,18,7,11,7,5,9
2963,2969,2975,24,7,6,2,1,3,9,12,-3,5,7,7
2964,2969,2975,28,10,6,1,4,1,10,8,2,6,6,7
2965,2969,2975,52,13,6,1,3,2,9,15,-6,5,7,6
2966,2969,2975,20,8,6,2,1,3,9,13,-4,5,7,7
2967,2969,2975,41,16,6,1,1,4,6,15,-9,3,9,4
2968,2969,2975,8,5,6,2,2,2,8,10,-2,6,6,8
2969,2969,2975,17,9,6,1,4,1,11,8,3,6,6,7
2970,2969,2975,4,12,6,1,3,2,5,8,-3,5,7,6
2971,2969,2975,7,14,6,1,2,3,7,12,-5,4,8,5
2972,2969,2975,27,1,6,5,1,0,12,3,9,11,1,16
2973,2969,2975,39,15,6,1,2,3,5,10,-5,4,8,5
2974,2969,2975,1,3,6,4,0,2,11,7,4,8,4,12
2975,2976,2982,1,3,7,4,1,2,12,8,4,9,5,13
2976,2976,2982,27,1,7,6,1,0,15,3,12,13,1,19
2977,2976,2982,39,14,7,1,3,3,6,11,-5,5,9,6
2978,2976,2982,4,12,7,1,3,3,7,11,-4,5,9,6
2979,2976,2982,7,13,7,1,3,3,8,13,-5,5,9,6
2980,2976,2982,8,5,7,3,2,2,10,10,0,8,6,11
2981,2976,2982,17,8,7,1,5,1,12,9,3,7,7,8
2982,2976,2982,20,6,7,3,1,3,11,14,-3,7,7,10
2983,2976,2982,41,16,7,1,1,5,6,17,-11,3,11,4
2984,2976,2982,28,9,7,1,5,1,11,9,2,7,7,8
2985,2976,2982,52,15,7,1,3,3,10,17,-7,5,9,6
2986,2976,2982,43,4,7,3,3,1,21,9,12,9,5,12
2987,2976,2982,49,2,7,6,0,1,19,5,14,12,2,18
2988,2976,2982,37,11,7,1,4,2,14,14,0,6,8,7
2989,2976,2982,24,10,7,2,1,4,9,15,-6,5,9,7
2990,2976,2982,53,7,7,2,2,3,8,14,-6,6,8,8
2991,3424,3430,53,4,19,8,6,5,23,14,9,22,16,30
2992,3424,3430,43,6,19,8,5,6,38,18,20,21,17,29
2993,3424,3430,26,15,19,3,5,11,16,39,-23,11,27,14
2994,3424,3430,49,2,19,12,5,2,39,14,25,29,9,41
2995,3424,3430,37,7,19,8,5,6,25,22,3,21,17,29
2996,3424,3430,5,13,19,4,6,9,18,36,-18,14,24,18
2997,3424,3430,20,10,19,6,6,7,22,34,-12,18,20,24
2998,3424,3430,41,14,19,3,5,11,21,33,-12,11,27,14
2999,3424,3430,17,8,19,7,7,5,25,19,6,21,17,28
3000,3424,3430,8,16,19,2,7,10,18,32,-14,11,27,13
3001,3424,3430,4,3,19,11,4,4,34,18,16,26,12,37
3002,3424,3430,52,9,19,7,5,7,25,30,-5,19,19,26
3003,3424,3430,28,11,19,6,5,8,28,32,-4,17,21,23
3004,3424,3430,27,5,19,9,2,8,27,23,4,20,18,29
3005,3424,3430,39,12,19,4,7,8,16,28,-12,15,23,19
3006,3424,3430,1,1,19,13,2,4,42,25,17,28,10,41
3007,3473,3479,1,2,25,17,4,4,59,29,30,38,12,55
3008,3473,3479,27,7,25,10,3,12,33,36,-3,23,27,33
3009,3473,3479,39,13,25,6,8,11,21,35,-14,20,30,26
3010,3473,3479,52,8,25,8,9,8,29,33,-4,25,25,33
3011,3473,3479,28,12,25,7,6,12,32,48,-16,20,30,27
3012,3473,3479,4,3,25,14,6,5,43,23,20,34,16,48
3013,3473,3479,17,9,25,8,8,9,30,36,-6,24,26,32
3014,3473,3479,8,16,25,3,9,13,23,40,-17,15,35,18
3015,3473,3479,20,10,25,8,8,9,30,40,-10,24,26,32
3016,3473,3479,41,11,25,7,6,12,30,39,-9,20,30,27
3017,3473,3479,49,1,25,18,5,2,56,20,36,41,9,59
3018,3473,3479,37,4,25,12,6,7,38,26,12,30,20,42
3019,3473,3479,5,14,25,4,7,14,21,50,-29,15,35,19
3020,3473,3479,43,6,25,11,6,8,52,24,28,28,22,39
3021,3473,3479,26,15,25,4,6,15,19,48,-29,14,36,18
3022,3473,3479,53,5,25,11,7,7,33,22,11,29,21,40
3023,3501,3507,53,6,27,12,7,8,35,24,11,31,23,43
3024,3501,3507,43,4,27,13,6,8,57,25,32,32,22,45
3025,3501,3507,26,14,27,5,7,15,20,48,-28,17,37,22
3026,3501,3507,49,1,27,20,5,2,60,20,40,45,9,65
3027,3501,3507,37,5,27,12,7,8,38,27,11,31,23,43
3028,1191,1197,57,13,12,2,3,7,8,21,-13,7,17,9
3029,1191,1197,24,16,12,1,2,9,10,25,-15,4,20,5
3030,1191,1197,48,10,12,3,4,5,10,15,-5,10,14,13
3031,1191,1197,28,14,12,1,6,5,14,22,-8,8,16,9
3032,1226,1232,36,5,17,9,3,5,28,20,8,21,13,30
3033,1226,1232,48,12,17,4,4,9,14,27,-13,12,22,16
3034,1226,1232,28,15,17,3,6,8,23,33,-10,12,22,15
3035,1226,1232,43,1,17,13,3,1,51,14,37,29,5,42
3036,1226,1232,57,9,17,5,4,8,13,25,-12,14,20,19
3037,1226,1232,24,16,17,1,4,12,12,33,-21,6,28,7
3038,1226,1232,21,7,17,7,6,4,24,18,6,20,14,27
3039,1226,1232,4,8,17,7,2,8,24,31,-7,16,18,23
3040,1226,1232,7,13,17,3,7,7,18,27,-9,13,21,16
3041,1226,1232,41,6,17,8,3,6,25,19,6,19,15,27
3042,1226,1232,53,3,17,10,4,3,36,18,18,24,10,34
3043,1226,1232,44,10,17,4,6,7,14,21,-7,14,20,18
3044,1226,1232,8,2,17,10,5,2,25,16,9,25,9,35
3045,1226,1232,17,14,17,3,6,8,20,28,-8,12,22,15
3046,1226,1232,49,4,17,9,5,3,33,19,14,23,11,32
3047,1226,1232,1,11,17,4,4,9,19,30,-11,12,22,16
3048,1261,1267,1,15,22,4,6,12,22,40,-18,14,30,18
3049,1261,1267,53,4,22,11,7,4,41,21,20,29,15,40
3050,1261,1267,44,13,22,5,7,10,19,35,-16,17,27,22
3051,1261,1267,49,3,22,12,5,5,46,23,23,29,15,41
3052,1261,1267,8,2,22,12,7,3,31,20,11,31,13,43
3053,1261,1267,17,11,22,5,7,10,27,32,-5,17,27,22
3054,1261,1267,41,6,22,10,5,7,27,21,6,25,19,35
3055,1261,1267,21,7,22,9,8,5,30,26,4,26,18,35
3056,1261,1267,4,8,22,10,4,8,33,35,-2,24,20,34
3057,1261,1267,7,12,22,5,7,10,24,34,-10,17,27,22
3058,1261,1267,36,5,22,11,4,7,35,26,9,26,18,37
3059,1261,1267,28,9,22,6,7,9,31,39,-8,19,25,25
3060,1261,1267,48,14,22,5,4,13,19,39,-20,14,30,19
3061,1261,1267,43,1,22,16,5,1,66,17,49,37,7,53
3062,1261,1267,57,10,22,6,6,10,16,33,-17,18,26,24
3063,1261,1267,24,16,22,2,5,15,16,42,-26,9,35,11
3064,1275,1281,43,1,24,16,7,1,69,20,49,39,9,55
3065,1275,1281,57,12,24,6,7,11,16,36,-20,19,29,25
3066,1275,1281,36,5,24,12,5,7,38,28,10,29,19,41
3067,1275,1281,28,9,24,6,8,10,32,42,-10,20,28,26
3068,1275,1281,48,15,24,6,4,14,23,43,-20,16,32,22
3069,1275,1281,21,7,24,10,8,6,32,28,4,28,20,38
3070,1275,1281,4,8,24,10,4,10,35,40,-5,24,24,34
3071,1275,1281,7,11,24,6,7,11,30,41,-11,19,29,25
3072,1275,1281,41,6,24,11,6,7,31,22,9,28,20,39
3073,1275,1281,24,16,24,3,5,16,19,44,-25,11,37,14
3074,1275,1281,8,2,24,13,8,3,39,23,16,34,14,47
3075,1275,1281,17,10,24,6,7,11,32,37,-5,19,29,25
3076,1275,1281,49,3,24,12,7,5,46,23,23,31,17,43
3077,1275,1281,53,4,24,11,9,4,43,23,20,31,17,42
3078,1275,1281,44,14,24,5,8,11,20,41,-21,18,30,23
3079,1275,1281,1,13,24,6,6,12,27,41,-14,18,30,24
3080,1156,1162,1,14,8,1,2,5,5,17,-12,4,12,5
3081,1156,1162,49,3,8,5,2,1,14,6,8,12,4,17
3082,1156,1162,8,2,8,5,3,0,16,6,10,13,3,18
3083,1156,1162,17,12,8,1,4,3,9,11,-2,6,10,7
3084,1156,1162,53,4,8,4,3,1,18,9,9,11,5,15
3085,1156,1162,44,9,8,2,4,2,7,7,0,8,8,10
3086,1156,1162,41,5,8,4,3,1,9,5,4,11,5,15
3087,1156,1162,21,6,8,3,3,2,8,8,0,9,7,12
3088,1156,1162,7,8,8,2,4,2,10,10,0,8,8,10
3089,1156,1162,4,13,8,2,0,6,6,18,-12,4,12,6
3090,1156,1162,36,7,8,3,2,3,12,13,-1,8,8,11
3091,1156,1162,48,11,8,2,2,4,6,11,-5,6,10,8
3092,1156,1162,28,15,8,0,4,4,8,15,-7,4,12,4
3093,1156,1162,43,1,8,7,1,0,24,2,22,15,1,22
3094,1156,1162,57,10,8,2,3,3,7,10,-3,7,9,9
3095,1156,1162,24,16,8,0,2,6,6,17,-11,2,14,2
3096,1905,1911,28,1,10,9,1,0,23,8,15,19,1,28
3097,1905,1911,48,12,10,2,2,6,8,15,-7,6,14,8
3098,1905,1911,52,13,10,2,2,6,8,18,-10,6,14,8
3099,1905,1911,43,2,10,8,1,1,18,3,15,17,3,25
3100,1905,1911,24,5,10,5,2,3,11,8,3,12,8,17
3101,1905,1911,57,16,10,0,3,7,3,16,-13,3,17,3
3102,1905,1911,4,6,10,5,2,3,20,18,2,12,8,17
3103,1905,1911,21,7,10,4,3,3,16,12,4,11,9,15
3104,1905,1911,7,14,10,1,4,5,5,9,-4,6,14,7
3105,1905,1911,41,4,10,5,4,1,20,7,13,14,6,19
3106,1905,1911,30,8,10,4,2,4,10,15,-5,10,10,14
3107,2647,2653,7,7,11,5,0,6,17,21,-4,10,12,15
3108,2647,2653,21,15,11,2,3,6,11,20,-9,7,15,9
3109,2647,2653,1,2,11,6,3,2,18,8,10,15,7,21
3110,2647,2653,18,16,11,2,2,7,9,19,-10,6,16,8
3111,2696,2702,1,1,16,11,3,2,32,10,22,25,7,36
3112,2696,2702,18,14,16,4,3,9,15,27,-12,11,21,15
3113,2696,2702,7,10,16,7,0,9,24,32,-8,14,18,21
3114,2696,2702,21,16,16,2,5,9,12,29,-17,9,23,11
3115,2696,2702,53,7,16,6,5,5,19,15,4,17,15,23
3116,2696,2702,49,3,16,8,6,2,26,18,8,22,10,30
3117,2696,2702,37,6,16,7,3,6,23,23,0,17,15,24
3118,2696,2702,20,8,16,6,5,5,21,20,1,17,15,23
3119,2696,2702,41,13,16,4,4,8,16,27,-11,12,20,16
3120,2696,2702,17,4,16,9,1,6,37,33,4,19,13,28
3121,2696,2702,8,5,16,7,3,6,30,30,0,17,15,24
3122,2696,2702,28,9,16,6,4,6,26,25,1,16,16,22
3123,2696,2702,52,12,16,4,4,8,23,28,-5,12,20,16
3124,2696,2702,43,2,16,11,2,3,39,14,25,24,8,35
3125,2696,2702,24,15,16,4,2,10,16,25,-9,10,22,14
3126,2696,2702,27,11,16,6,2,8,22,25,-3,14,18,20
3127,2927,2933,27,9,1,0,1,0,1,1,0,1,1,1
3128,2927,2933,39,16,1,0,0,1,1,5,-4,0,2,0
3129,2927,2933,24,2,1,1,0,0,4,1,3,2,0,3
3130,2927,2933,52,5,1,1,0,0,2,1,1,2,0,3
3131,2927,2933,28,7,1,0,1,0,2,2,0,1,1,1
3132,2927,2933,43,7,1,0,1,0,2,2,0,1,1,1
3133,2927,2933,8,4,1,1,0,0,2,0,2,2,0,3
3134,2927,2933,17,11,1,0,0,1,1,2,-1,0,2,0
3135,2927,2933,41,13,1,0,0,1,1,3,-2,0,2,0
3136,2927,2933,20,15,1,0,0,1,1,4,-3,0,2,0
3137,2927,2933,49,1,1,1,0,0,5,1,4,2,0,3
3138,2927,2933,37,3,1,1,0,0,3,1,2,2,0,3
3139,2927,2933,53,11,1,0,0,1,1,2,-1,0,2,0
3140,2927,2933,4,9,1,0,1,0,1,1,0,1,1,1
3141,2927,2933,7,14,1,0,0,1,0,2,-2,0,2,0
3142,2927,2933,1,5,1,1,0,0,2,1,1,2,0,3
3143,3375,3381,1,2,13,8,2,3,27,16,11,18,8,26
3144,3375,3381,4,3,13,8,2,3,25,14,11,18,8,26
3145,3375,3381,52,9,13,4,4,5,16,22,-6,12,14,16
3146,3375,3381,28,12,13,3,4,6,16,24,-8,10,16,13
3147,3375,3381,53,5,13,6,3,4,15,7,8,15,11,21
3148,3375,3381,49,1,13,9,3,1,26,8,18,21,5,30
3149,3375,3381,37,4,13,6,4,3,19,12,7,16,10,22
3150,3375,3381,5,13,13,3,3,7,11,24,-13,9,17,12
3151,3375,3381,20,8,13,4,5,4,14,23,-9,13,13,17
3152,3375,3381,41,14,13,3,2,8,18,24,-6,8,18,11
3153,3375,3381,17,6,13,5,6,2,17,10,7,16,10,21
3154,3375,3381,8,15,13,2,5,6,10,18,-8,9,17,11
3155,3375,3381,43,7,13,5,4,4,25,12,13,14,12,19
3156,3375,3381,26,16,13,2,4,7,12,25,-13,8,18,10
3157,3375,3381,27,10,13,4,2,7,15,20,-5,10,16,14
3158,3375,3381,39,11,13,3,5,5,9,16,-7,11,15,14
3159,3389,3395,27,8,15,6,2,7,22,20,2,14,16,20
3160,3389,3395,39,10,15,4,5,6,13,21,-8,13,17,17
3161,3389,3395,43,7,15,6,5,4,30,15,15,17,13,23
3162,3389,3395,26,14,15,3,4,8,15,32,-17,10,20,13
3163,3389,3395,17,4,15,7,6,2,23,11,12,20,10,27
3164,3389,3395,8,16,15,2,6,7,13,22,-9,10,20,12
3165,3389,3395,20,11,15,4,5,6,15,29,-14,13,17,17
3166,3389,3395,41,15,15,3,3,9,18,25,-7,9,21,12
3167,3389,3395,49,1,15,10,3,2,29,11,18,23,7,33
3168,3389,3395,37,5,15,7,5,3,21,13,8,19,11,26
3169,3389,3395,5,13,15,3,4,8,11,26,-15,10,20,13
3170,3389,3395,53,6,15,7,3,5,18,10,8,17,13,24
3171,3389,3395,52,9,15,4,5,6,16,23,-7,13,17,17
3172,3389,3395,28,12,15,4,4,7,20,27,-7,12,18,16
3173,3389,3395,4,3,15,9,2,4,27,17,10,20,10,29
3174,3389,3395,1,2,15,9,2,4,31,20,11,20,10,29
3175,3312,3318,1,1,4,4,0,0,9,4,5,8,0,12
3176,3312,3318,4,6,4,2,1,1,8,6,2,5,3,7
3177,3312,3318,52,4,4,2,2,0,10,2,8,6,2,8
3178,3312,3318,28,11,4,1,1,2,3,7,-4,3,5,4
3179,3312,3318,53,2,4,3,1,0,8,1,7,7,1,10
3180,3312,3318,20,8,4,1,3,0,6,4,2,5,3,6
3181,3312,3318,41,16,4,0,0,4,2,7,-5,0,8,0
3182,3312,3318,49,3,4,3,0,1,6,4,2,6,2,9
3183,3312,3318,37,7,4,2,1,1,6,4,2,5,3,7
3184,3312,3318,5,15,4,0,1,3,2,11,-9,1,7,1
3185,3312,3318,17,10,4,1,2,1,2,2,0,4,4,5
3186,3312,3318,8,11,4,1,1,2,3,7,-4,3,5,4
3187,3312,3318,43,5,4,2,1,1,8,4,4,5,3,7
3188,3501,3507,5,16,27,4,7,16,22,55,-33,15,39,19
3189,3501,3507,20,10,27,8,9,10,32,44,-12,25,29,33
3190,3501,3507,41,11,27,7,6,14,30,42,-12,20,34,27
3191,3501,3507,17,9,27,10,8,9,34,38,-4,28,26,38
3192,3501,3507,8,15,27,4,10,13,26,41,-15,18,36,22
3193,3501,3507,4,3,27,14,6,7,44,33,11,34,20,48
3194,3501,3507,52,8,27,10,9,8,34,33,1,29,25,39
3195,3501,3507,28,12,27,7,6,14,32,53,-21,20,34,27
3196,3501,3507,27,7,27,12,3,12,39,38,1,27,27,39
3197,3501,3507,39,13,27,6,8,13,22,40,-18,20,34,26
3198,3501,3507,1,2,27,18,4,5,67,31,36,40,14,58
3199,3515,3521,27,7,29,13,3,13,41,41,0,29,29,42
3200,3515,3521,39,14,29,6,9,14,24,43,-19,21,37,27
3201,3515,3521,52,9,29,10,9,10,35,40,-5,29,29,39
3202,3515,3521,28,11,29,8,7,14,36,55,-19,23,35,31
3203,3515,3521,4,3,29,15,7,7,46,34,12,37,21,52
3204,3515,3521,20,10,29,8,9,12,35,49,-14,25,33,33
3205,3515,3521,41,12,29,8,6,15,33,43,-10,22,36,30
3206,3515,3521,1,2,29,20,4,5,73,34,39,44,14,64
3207,3515,3521,17,8,29,11,8,10,36,42,-6,30,28,41
3208,3515,3521,8,15,29,4,10,15,26,47,-21,18,40,22
3209,3515,3521,43,4,29,15,6,8,63,26,37,36,22,51
3210,3515,3521,26,13,29,7,7,15,27,49,-22,21,37,28
3211,3515,3521,49,1,29,21,5,3,62,24,38,47,11,68
3212,3515,3521,37,5,29,13,8,8,43,28,15,34,24,47
3213,3515,3521,5,16,29,4,7,18,24,63,-39,15,43,19
3214,3515,3521,53,6,29,13,7,9,40,26,14,33,25,46
3215,3655,3661,53,6,1,1,0,0,1,0,1,2,0,3
3216,3655,3661,49,1,1,1,0,0,3,0,3,2,0,3
3217,3655,3661,37,7,1,0,1,0,0,0,0,1,1,1
3218,3655,3661,43,1,1,1,0,0,3,0,3,2,0,3
3219,3655,3661,26,7,1,0,1,0,0,0,0,1,1,1
3220,3655,3661,17,12,1,0,0,1,0,1,-1,0,2,0
3221,3655,3661,1,1,1,1,0,0,3,0,3,2,0,3
3222,3655,3661,20,7,1,0,1,0,0,0,0,1,1,1
3223,3655,3661,41,14,1,0,0,1,0,3,-3,0,2,0
3224,3655,3661,21,4,1,1,0,0,2,0,2,2,0,3
3225,3655,3661,4,14,1,0,0,1,0,3,-3,0,2,0
3226,3655,3661,28,5,1,1,0,0,2,1,1,2,0,3
3227,3655,3661,36,7,1,0,1,0,0,0,0,1,1,1
3228,3655,3661,52,13,1,0,0,1,0,2,-2,0,2,0
3229,3655,3661,39,11,1,0,0,1,1,2,-1,0,2,0
3230,3655,3661,27,14,1,0,0,1,0,3,-3,0,2,0
3231,3760,3780,39,11,15,4,4,7,18,23,-5,12,18,16
3232,3760,3780,27,15,15,2,4,9,16,30,-14,8,22,10
3233,3760,3780,1,2,15,10,3,2,33,16,17,23,7,33
3234,3760,3780,17,4,15,8,0,7,24,19,5,16,14,24
3235,3760,3780,20,6,15,5,7,3,18,10,8,17,13,22
3236,3760,3780,41,13,15,4,4,7,9,19,-10,12,18,16
3237,3760,3780,52,8,15,5,5,5,19,19,0,15,15,20
3238,3760,3780,28,10,15,5,5,5,20,23,-3,15,15,20
3239,3760,3780,36,14,15,2,8,5,13,21,-8,12,18,14
3240,3760,3780,49,1,15,10,4,1,34,11,23,24,6,34
3241,3760,3780,37,9,15,5,5,5,13,15,-2,15,15,20
3242,3760,3780,43,3,15,10,1,4,29,15,14,21,9,31
3243,3760,3780,26,12,15,4,4,7,13,21,-8,12,18,16
3244,3760,3780,53,5,15,6,5,4,19,17,2,17,13,23
3245,3760,3780,21,7,15,6,2,7,17,19,-2,14,16,20
3246,3760,3780,4,16,15,2,3,10,12,29,-17,7,23,9
3247,3795,3808,53,6,18,6,7,5,19,20,-1,19,17,25
3248,3795,3808,49,1,18,13,4,1,41,11,30,30,6,43
3249,3795,3808,37,7,18,6,6,6,16,18,-2,18,18,24
3250,3795,3808,43,3,18,12,2,4,33,15,18,26,10,38
3251,3795,3808,26,11,18,5,5,8,17,23,-6,15,21,20
3252,3795,3808,20,5,18,6,8,4,22,13,9,20,16,26
3253,3795,3808,41,13,18,4,6,8,11,23,-12,14,22,18
3254,3795,3808,17,4,18,10,0,8,29,21,8,20,16,30
3255,3795,3808,52,8,18,6,6,6,21,24,-3,18,18,24
3256,3795,3808,28,10,18,6,5,7,23,27,-4,17,19,23
3257,3795,3808,36,14,18,2,8,8,14,27,-13,12,24,14
3258,3795,3808,21,9,18,6,5,7,21,23,-2,17,19,23
3259,3795,3808,4,15,18,3,4,11,15,32,-17,10,26,13
3260,3795,3808,39,12,18,5,4,9,20,31,-11,14,22,19
3261,3795,3808,27,16,18,3,4,11,19,37,-18,10,26,13
3262,3795,3808,1,2,18,12,4,2,42,18,24,28,8,40
3263,3690,3696,1,3,6,4,2,0,15,3,12,10,2,14
3264,3690,3696,27,15,6,1,1,4,5,11,-6,3,9,4
3265,3690,3696,39,16,6,1,1,4,5,13,-8,3,9,4
3266,3690,3696,21,7,6,2,2,2,4,6,-2,6,6,8
3267,1954,1960,1,10,16,4,6,6,25,21,4,14,18,18
3268,1989,1995,1,10,21,5,10,6,32,27,5,20,22,25
3269,1989,1995,53,3,21,12,6,3,30,18,12,30,12,42
3270,1989,1995,41,8,21,7,6,8,36,32,4,20,22,27
3271,1989,1995,30,9,21,6,8,7,21,30,-9,20,22,26
3272,1989,1995,4,6,21,8,6,7,34,40,-6,22,20,30
3273,1989,1995,21,7,21,8,5,8,31,30,1,21,21,29
3274,1989,1995,7,13,21,5,5,11,18,21,-3,15,27,20
3275,1989,1995,43,1,21,17,2,2,59,11,48,36,6,53
3276,1989,1995,24,5,21,12,2,7,26,25,1,26,16,38
3277,1989,1995,57,16,21,2,5,14,12,37,-25,9,33,11
3278,1989,1995,28,2,21,14,1,6,31,22,9,29,13,43
3279,1989,1995,52,11,21,6,4,11,25,33,-8,16,26,22
3280,1989,1995,48,15,21,4,6,11,20,38,-18,14,28,18
3281,1989,1995,17,12,21,5,7,9,20,31,-11,17,25,22
3282,1989,1995,8,14,21,5,3,13,21,38,-17,13,29,18
3283,1989,1995,49,4,21,11,6,4,32,15,17,28,14,39
3284,2031,2037,49,3,27,15,6,6,42,20,22,36,18,51
3285,2031,2037,17,13,27,6,9,12,23,38,-15,21,33,27
3286,2031,2037,8,14,27,6,5,16,26,48,-22,17,37,23
3287,2031,2037,28,2,27,17,2,8,41,28,13,36,18,53
3288,2031,2037,52,11,27,8,7,12,32,41,-9,23,31,31
3289,2031,2037,48,15,27,4,9,14,22,48,-26,17,37,21
3290,2031,2037,43,1,27,20,4,3,74,15,59,44,10,64
3291,2031,2037,24,5,27,12,6,9,31,35,-4,30,24,42
3292,2031,2037,57,16,27,4,6,17,18,44,-26,14,40,18
3293,2031,2037,4,6,27,11,8,8,45,49,-4,30,24,41
3294,2031,2037,21,10,27,9,7,11,38,38,0,25,29,34
3295,2031,2037,7,12,27,7,7,13,24,30,-6,21,33,28
3296,2031,2037,30,8,27,9,10,8,29,35,-6,28,26,37
3297,2031,2037,41,9,27,9,7,11,42,42,0,25,29,34
3298,2031,2037,53,4,27,14,8,5,39,27,12,36,18,50
3299,2031,2037,1,7,27,9,11,7,47,35,12,29,25,38
3300,2332,2338,1,2,17,12,2,3,38,20,18,26,8,38
3301,2332,2338,53,11,17,5,3,9,32,37,-5,13,21,18
3302,2332,2338,41,5,17,8,5,4,20,15,5,21,13,29
3303,2332,2338,20,6,17,6,7,4,14,11,3,19,15,25
3304,2332,2338,30,14,17,4,2,11,19,36,-17,10,24,14
3305,2332,2338,21,3,17,9,5,3,25,13,12,23,11,32
3306,2332,2338,7,10,17,4,7,6,23,27,-4,15,19,19
3307,2332,2338,4,12,17,4,6,7,17,27,-10,14,20,18
3308,2332,2338,43,1,17,12,4,1,40,7,33,28,6,40
3309,2332,2338,24,15,17,1,11,5,16,25,-9,13,21,14
3310,2332,2338,28,8,17,5,6,6,23,25,-2,16,18,21
3311,2332,2338,52,13,17,3,6,8,19,29,-10,12,22,15
3312,2332,2338,8,7,17,5,7,5,30,24,6,17,17,22
3313,2332,2338,17,9,17,5,4,8,15,23,-8,14,20,19
3314,2332,2338,49,4,17,8,5,4,30,22,8,21,13,29
3315,2332,2338,27,16,17,1,8,8,14,34,-20,10,24,11
3316,2409,2422,27,13,26,5,11,10,28,42,-14,21,31,26
3317,2409,2422,49,4,26,13,7,6,42,28,14,33,19,46
3318,2409,2422,17,7,26,9,7,10,32,30,2,25,27,34
3319,2409,2422,8,10,26,5,12,9,38,43,-5,22,30,27
3320,2409,2422,28,6,26,10,7,9,37,34,3,27,25,37
3321,2409,2422,52,15,26,5,9,12,26,45,-19,19,33,24
3322,2409,2422,43,2,26,17,6,3,57,12,45,40,12,57
3323,2409,2422,24,11,26,5,12,9,31,40,-9,22,30,27
3324,2409,2422,4,9,26,7,8,11,27,45,-18,22,30,29
3325,2409,2422,7,12,26,5,11,10,34,44,-10,21,31,26
3326,2409,2422,41,3,26,15,5,6,39,21,18,35,17,50
3327,2409,2422,20,8,26,7,12,7,22,21,1,26,26,33
3328,2409,2422,30,16,26,5,4,17,23,55,-32,14,38,19
3329,2409,2422,21,5,26,11,9,6,33,20,13,31,21,42
3330,2409,2422,53,14,26,6,7,13,38,51,-13,19,33,25
3331,2409,2422,1,1,26,18,3,5,53,29,24,39,13,57
3332,2248,2254,1,1,8,6,0,2,16,9,7,12,4,18
3333,2248,2254,53,12,8,2,2,4,9,13,-4,6,10,8
3334,2248,2254,49,6,8,3,3,2,14,12,2,9,7,12
3335,2248,2254,41,3,8,5,2,1,11,5,6,12,4,17
3336,2248,2254,20,7,8,3,3,2,9,7,2,9,7,12
3337,2248,2254,30,9,8,3,0,5,11,18,-7,6,10,9
3338,2248,2254,21,2,8,5,2,1,13,6,7,12,4,17
3339,2248,2254,7,5,8,3,3,2,14,10,4,9,7,12
3340,2248,2254,4,14,8,1,4,3,7,12,-5,6,10,7
3341,2248,2254,43,4,8,3,4,1,10,6,4,10,6,13
3342,2248,2254,24,15,8,1,4,3,6,12,-6,6,10,7
3343,2248,2254,8,8,8,3,2,3,16,12,4,8,8,11
3344,2248,2254,17,11,8,2,2,4,6,9,-3,6,10,8
3345,2248,2254,28,10,8,2,2,4,14,16,-2,6,10,8
3346,3508,3514,43,4,28,14,6,8,60,26,34,34,22,48
3347,3508,3514,26,14,28,6,7,15,24,49,-25,19,37,25
3348,3508,3514,27,7,28,12,3,13,40,41,-1,27,29,39
3349,3508,3514,39,13,28,6,8,14,23,42,-19,20,36,26
3350,3508,3514,1,2,28,19,4,5,71,34,37,42,14,61
3351,3305,3311,1,1,3,3,0,0,6,2,4,6,0,9
3352,3305,3311,39,9,3,1,1,1,2,1,1,3,3,4
3353,3305,3311,27,14,3,0,1,2,2,5,-3,1,5,1
3354,3305,3311,43,8,3,1,1,1,5,3,2,3,3,4
3355,3305,3311,26,13,3,0,1,2,2,4,-2,1,5,1
3356,3305,3311,52,6,3,1,2,0,5,1,4,4,2,5
3357,3305,3311,28,11,3,1,1,1,3,6,-3,3,3,4
3358,3305,3311,8,10,3,1,1,1,3,4,-1,3,3,4
3359,3305,3311,17,12,3,0,2,1,1,2,-1,2,4,2
3360,3305,3311,20,7,3,1,2,0,4,2,2,4,2,5
3361,3305,3311,41,15,3,0,0,3,1,5,-4,0,6,0
3362,3305,3311,37,3,3,2,1,0,4,1,3,5,1,7
3363,3305,3311,49,5,3,2,0,1,4,3,1,4,2,6
3364,3305,3311,5,16,3,0,0,3,0,9,-9,0,6,0
3365,3305,3311,53,2,3,2,1,0,5,1,4,5,1,7
3366,3305,3311,4,4,3,2,0,1,6,4,2,4,2,6
3367,3865,3878,1,2,26,18,4,4,65,30,35,40,12,58
3368,3865,3878,53,6,26,9,9,8,26,28,-2,27,25,36
3369,3865,3878,49,1,26,20,5,1,60,16,44,45,7,65
3370,3865,3878,37,7,26,9,8,9,27,28,-1,26,26,35
3371,3865,3878,21,9,26,9,6,11,27,40,-13,24,28,33
3372,3865,3878,4,16,26,4,5,17,17,52,-35,13,39,17
3373,3865,3878,17,4,26,15,0,11,39,27,12,30,22,45
3374,3865,3878,43,3,26,14,5,7,43,25,18,33,19,47
3375,3865,3878,26,10,26,8,6,12,25,32,-7,22,30,30
3376,3865,3878,20,11,26,6,11,9,28,27,1,23,29,29
3377,3865,3878,41,12,26,6,11,9,16,28,-12,23,29,29
3378,3865,3878,52,5,26,9,9,8,31,27,4,27,25,36
3379,3865,3878,28,8,26,9,6,11,32,37,-5,24,28,33
3380,3865,3878,36,14,26,6,9,11,25,33,-8,21,31,27
3381,3865,3878,39,13,26,7,7,12,29,40,-11,21,31,28
3382,3865,3878,27,15,26,6,5,15,32,52,-20,17,35,23
3383,3669,3675,39,12,3,1,0,2,5,8,-3,2,4,3
3384,3669,3675,27,16,3,0,1,2,1,5,-4,1,5,1
3385,3669,3675,1,5,3,1,2,0,5,2,3,4,2,5
3386,3669,3675,43,1,3,3,0,0,8,0,8,6,0,9
3387,3669,3675,26,7,3,1,1,1,2,5,-3,3,3,4
3388,3669,3675,17,10,3,1,0,2,2,3,-1,2,4,3
3389,3669,3675,21,4,3,2,0,1,3,4,-1,4,2,6
3390,3669,3675,4,9,3,1,0,2,5,5,0,2,4,3
3391,3669,3675,49,2,3,2,1,0,10,1,9,5,1,7
3392,3669,3675,37,6,3,1,2,0,1,0,1,4,2,5
3393,3669,3675,41,11,3,1,0,2,2,4,-2,2,4,3
3394,3669,3675,20,14,3,0,2,1,1,3,-2,2,4,2
3395,3669,3675,53,8,3,1,1,1,1,4,-3,3,3,4
3396,3669,3675,28,3,3,2,1,0,5,3,2,5,1,7
3397,3669,3675,36,13,3,0,2,1,1,2,-1,2,4,2
3398,3669,3675,52,15,3,0,1,2,2,5,-3,1,5,1
3399,3683,3689,53,10,5,1,2,2,2,7,-5,4,6,5
3400,3683,3689,41,7,5,2,0,3,6,9,-3,4,6,6
3401,3683,3689,20,8,5,1,3,1,4,4,0,5,5,6
3402,3683,3689,49,2,5,3,2,0,14,3,11,8,2,11
3403,3683,3689,37,9,5,1,2,2,2,6,-4,4,6,5
3404,3683,3689,21,6,5,2,1,2,4,6,-2,5,5,7
3405,3683,3689,4,12,5,1,1,3,7,9,-2,3,7,4
3406,3683,3689,17,4,5,3,0,2,7,3,4,6,4,9
3407,3683,3689,43,1,5,5,0,0,15,2,13,10,0,15
3408,3683,3689,26,11,5,1,2,2,3,9,-6,4,6,5
3409,3683,3689,28,5,5,2,3,0,8,6,2,7,3,9
3410,3683,3689,52,13,5,1,1,3,6,8,-2,3,7,4
3411,3683,3689,36,15,5,0,4,1,2,3,-1,4,6,4
3412,3683,3689,1,3,5,3,2,0,11,3,8,8,2,11
3413,3683,3689,27,14,5,1,1,3,3,8,-5,3,7,4
3414,3683,3689,39,16,5,1,0,4,5,13,-8,2,8,3
3415,4019,4025,39,15,1,0,0,1,1,3,-2,0,2,0
3416,4019,4025,52,4,1,1,0,0,2,1,1,2,0,3
3417,4019,4025,28,5,1,1,0,0,1,0,1,2,0,3
3418,4019,4025,36,7,1,0,1,0,1,1,0,1,1,1
3419,4019,4025,17,15,1,0,0,1,1,3,-2,0,2,0
3420,4019,4025,41,1,1,1,0,0,4,2,2,2,0,3
3421,4019,4025,20,2,1,1,0,0,3,1,2,2,0,3
3422,4019,4025,24,5,1,1,0,0,1,0,1,2,0,3
3423,4019,4025,43,7,1,0,1,0,1,1,0,1,1,1
3424,4019,4025,26,7,1,0,1,0,1,1,0,1,1,1
3425,4019,4025,57,12,1,0,0,1,0,1,-1,0,2,0
3426,4019,4025,21,14,1,0,0,1,2,4,-2,0,2,0
3427,4019,4025,49,11,1,0,0,1,1,2,-1,0,2,0
3428,2430,2433,52,15,28,6,10,12,31,46,-15,22,34,28
3429,2430,2433,27,14,28,6,11,11,29,44,-15,23,33,29
3430,2437,2555,27,14,30,7,11,12,32,49,-17,25,35,32
3431,2437,2555,28,5,30,12,7,11,43,41,2,31,29,43
3432,2437,2555,52,13,30,7,11,12,35,48,-13,25,35,32
3433,2437,2555,43,1,30,20,7,3,63,12,51,47,13,67
3434,2437,2555,24,12,30,7,12,11,36,45,-9,26,34,33
3435,2437,2555,49,4,30,15,7,8,50,34,16,37,23,52
3436,2437,2555,17,8,30,9,8,13,34,39,-5,26,34,35
3437,2437,2555,8,11,30,7,12,11,43,46,-3,26,34,33
3438,2437,2555,41,3,30,16,7,7,43,27,16,39,21,55
3439,2437,2555,20,7,30,9,12,9,28,27,1,30,30,39
3440,2437,2555,30,16,30,6,4,20,26,62,-36,16,44,22
3441,2437,2555,21,6,30,11,10,9,34,27,7,32,28,43
3442,2437,2555,7,10,30,8,11,11,41,47,-6,27,33,35
3443,2437,2555,4,15,30,7,8,15,31,56,-25,22,38,29
3444,2437,2555,53,9,30,9,8,13,47,55,-8,26,34,35
3445,2437,2555,1,2,30,21,3,6,62,33,29,45,15,66
3446,2682,2688,1,1,14,9,3,2,27,9,18,21,7,30
3447,2682,2688,18,13,14,4,3,7,13,20,-7,11,17,15
3448,2682,2688,53,11,14,4,5,5,13,15,-2,13,15,17
3449,2682,2688,20,9,14,5,4,5,16,20,-4,14,14,19
3450,2682,2688,41,15,14,3,4,7,15,24,-9,10,18,13
3451,2682,2688,7,5,14,7,0,7,21,25,-4,14,14,21
3452,2682,2688,21,16,14,2,4,8,12,24,-12,8,20,10
3453,2682,2688,17,4,14,8,1,5,32,27,5,17,11,25
3454,2682,2688,8,6,14,6,3,5,27,28,-1,15,13,21
3455,2682,2688,49,3,14,7,5,2,24,17,7,19,9,26
3456,2682,2688,37,7,14,6,3,5,20,21,-1,15,13,21
3457,2682,2688,28,8,14,5,4,5,22,20,2,14,14,19
3458,2682,2688,52,12,14,4,3,7,23,27,-4,11,17,15
3459,2682,2688,43,2,14,9,2,3,32,14,18,20,8,29
3460,2682,2688,24,14,14,4,2,8,16,21,-5,10,18,14
3461,2682,2688,27,10,14,5,2,7,21,22,-1,12,16,17
3462,2626,2639,27,7,9,4,1,4,16,14,2,9,9,13
3463,2626,2639,52,9,9,3,3,3,16,15,1,9,9,12
3464,2626,2639,28,11,9,2,3,4,13,17,-4,7,11,9
3465,2626,2639,43,1,9,7,1,1,25,8,17,15,3,22
3466,2626,2639,24,12,9,2,2,5,10,12,-2,6,12,8
3467,2626,2639,37,4,9,5,2,2,16,12,4,12,6,17
3468,2626,2639,49,6,9,4,4,1,13,10,3,12,6,16
3469,2626,2639,8,2,9,5,3,1,18,13,5,13,5,18
3470,2626,2639,17,5,9,5,1,3,22,16,6,11,7,16
3471,2626,2639,7,8,9,4,0,5,13,16,-3,8,10,12
3472,2626,2639,21,14,9,2,2,5,10,17,-7,6,12,8
3473,2626,2639,20,10,9,3,3,3,9,15,-6,9,9,12
3474,2626,2639,41,13,9,2,2,5,9,15,-6,6,12,8
3475,2626,2639,53,15,9,1,5,3,5,9,-4,7,11,8
3476,2626,2639,1,3,9,5,2,2,14,6,8,12,6,17
3477,2626,2639,18,16,9,0,2,7,3,17,-14,2,16,2
3478,3004,3010,1,3,11,6,2,3,20,10,10,14,8,20
3479,3004,3010,53,6,11,4,3,4,22,20,2,11,11,15
3480,3004,3010,24,15,11,2,4,5,15,27,-12,8,14,10
3481,3004,3010,4,13,11,2,5,4,12,16,-4,9,13,11
3482,3004,3010,7,16,11,2,3,6,10,21,-11,7,15,9
3483,3004,3010,49,2,11,6,3,2,22,9,13,15,7,21
3484,3004,3010,37,8,11,3,5,3,20,18,2,11,11,14
3485,3004,3010,20,11,11,3,3,5,16,21,-5,9,13,12
3486,3004,3010,41,12,11,3,2,6,16,24,-8,8,14,11
3487,3004,3010,43,4,11,4,6,1,26,12,14,14,8,18
3488,3004,3010,17,5,11,3,7,1,18,12,6,13,9,16
3489,3004,3010,8,10,11,3,4,4,13,17,-4,10,12,13
3490,3004,3010,28,7,11,3,6,2,17,17,0,12,10,15
3491,3004,3010,52,9,11,3,5,3,16,19,-3,11,11,14
3492,3004,3010,27,1,11,7,2,2,19,11,8,16,6,23
3493,3004,3010,39,14,11,2,4,5,11,19,-8,8,14,10
3494,3053,3059,27,3,16,9,3,4,27,18,9,21,11,30
3495,3053,3059,39,14,16,4,4,8,17,26,-9,12,20,16
3496,3053,3059,28,5,16,6,8,2,25,20,5,20,12,26
3497,3053,3059,52,13,16,4,5,7,19,25,-6,13,19,17
3498,3053,3059,43,4,16,6,8,2,35,19,16,20,12,26
3499,3053,3059,24,15,16,3,4,9,20,36,-16,10,22,13
3500,3053,3059,20,8,16,6,3,7,26,27,-1,15,17,21
3501,3053,3059,41,11,16,5,3,8,22,30,-8,13,19,18
3502,3053,3059,49,1,16,9,5,2,33,10,23,23,9,32
3503,3053,3059,37,9,16,5,5,6,23,28,-5,15,17,20
3504,3053,3059,17,7,16,5,8,3,29,24,5,18,14,23
3505,3053,3059,8,10,16,5,5,6,16,23,-7,15,17,20
3506,3053,3059,4,12,16,4,6,6,15,22,-7,14,18,18
3507,2255,2268,53,12,9,2,2,5,9,15,-6,6,12,8
3508,2255,2268,1,2,9,6,1,2,17,10,7,13,5,19
3509,2654,2660,1,2,12,7,3,2,20,9,11,17,7,24
3510,2654,2660,18,14,12,3,2,7,11,19,-8,8,16,11
3511,2654,2660,7,6,12,6,0,6,18,21,-3,12,12,18
3512,2654,2660,21,16,12,2,4,6,12,21,-9,8,16,10
3513,2654,2660,53,15,12,2,5,5,7,14,-7,9,15,11
3514,2654,2660,49,4,12,6,4,2,19,15,4,16,8,22
3515,2654,2660,37,5,12,6,2,4,19,18,1,14,10,20
3516,2654,2660,20,10,12,4,3,5,15,20,-5,11,13,15
3517,2654,2660,41,13,12,3,3,6,13,21,-8,9,15,12
3518,2654,2660,17,3,12,7,1,4,26,20,6,15,9,22
3519,2654,2660,8,7,12,5,3,4,22,23,-1,13,11,18
3520,2654,2660,52,8,12,4,3,5,20,19,1,11,13,15
3521,2654,2660,28,8,12,4,3,5,20,19,1,11,13,15
3522,2654,2660,43,1,12,8,2,2,28,11,17,18,6,26
3523,2654,2660,24,11,12,4,2,6,16,15,1,10,14,14
3524,2654,2660,27,12,12,4,2,6,19,20,-1,10,14,14
3525,2759,2765,27,10,24,8,4,12,28,35,-7,20,28,28
3526,2759,2765,43,1,24,17,4,3,58,20,38,38,10,55
3527,2759,2765,24,12,24,8,3,13,28,34,-6,19,29,27
3528,2759,2765,28,6,24,10,6,8,38,31,7,26,22,36
3529,2759,2765,52,11,24,7,7,10,31,35,-4,21,27,28
3530,2759,2765,17,7,24,11,2,11,48,53,-5,24,24,35
3531,2759,2765,8,9,24,9,4,11,36,43,-7,22,26,31
3532,2759,2765,20,4,24,10,8,6,33,28,5,28,20,38
3533,2759,2765,41,15,24,5,7,12,25,40,-15,17,31,22
3534,2759,2765,49,3,24,12,7,5,41,28,13,31,17,43
3535,2759,2765,37,13,24,7,6,11,24,33,-9,20,28,27
3536,2759,2765,53,8,24,9,6,9,29,27,2,24,24,33
3537,2759,2765,7,5,24,11,3,10,36,42,-6,25,23,36
3538,2759,2765,21,16,24,4,8,12,17,35,-18,16,32,20
3539,2759,2765,1,2,24,14,7,3,44,18,26,35,13,49
3540,2759,2765,18,14,24,7,4,13,23,37,-14,18,30,25
3541,2934,2940,1,2,2,2,0,0,5,1,4,4,0,6
3542,2934,2940,53,7,2,1,0,1,3,3,0,2,2,3
3543,2934,2940,49,1,2,2,0,0,8,1,7,4,0,6
3544,2934,2940,37,6,2,1,0,1,3,2,1,2,2,3
3545,2934,2940,41,7,2,1,0,1,3,3,0,2,2,3
3546,2934,2940,20,15,2,0,0,2,2,6,-4,0,4,0
3547,2934,2940,8,3,2,2,0,0,5,2,3,4,0,6
3548,2934,2940,17,13,2,0,1,1,2,3,-1,1,3,1
3549,2934,2940,4,14,2,0,1,1,1,4,-3,1,3,1
3550,2934,2940,7,16,2,0,0,2,0,5,-5,0,4,0
3551,2934,2940,52,9,2,1,0,1,2,3,-1,2,2,3
3552,2934,2940,28,11,2,0,2,0,3,3,0,2,2,2
3553,2934,2940,24,5,2,1,0,1,6,4,2,2,2,3
3554,2934,2940,43,12,2,0,1,1,3,4,-1,1,3,1
3555,2934,2940,27,4,2,1,1,0,3,2,1,3,1,4
3556,2934,2940,39,10,2,1,0,1,2,5,-3,2,2,3
3557,2941,2947,27,2,3,2,1,0,6,2,4,5,1,7
3558,2941,2947,39,9,3,1,1,1,3,6,-3,3,3,4
3559,2941,2947,43,5,3,1,1,1,10,4,6,3,3,4
3560,2941,2947,24,10,3,1,0,2,6,8,-2,2,4,3
3561,2941,2947,52,8,3,1,1,1,5,6,-1,3,3,4
3562,2941,2947,28,14,3,0,3,0,4,4,0,3,3,3
3563,2941,2947,4,15,3,0,2,1,2,5,-3,2,4,2
3564,2941,2947,7,16,3,0,1,2,1,6,-5,1,5,1
3565,2941,2947,8,4,3,2,0,1,5,5,0,4,2,6
3566,2941,2947,17,6,3,1,1,1,7,4,3,3,3,4
3567,2941,2947,20,11,3,1,0,2,5,7,-2,2,4,3
3568,2941,2947,41,13,3,1,0,2,3,10,-7,2,4,3
3569,2941,2947,49,1,3,3,0,0,12,1,11,6,0,9
3570,2941,2947,37,7,3,1,1,1,6,5,1,3,3,4
3571,2941,2947,53,12,3,1,0,2,4,8,-4,2,4,3
3572,2941,2947,1,3,3,2,0,1,6,4,2,4,2,6
3573,3368,3374,1,3,12,7,2,3,23,16,7,16,8,23
3574,3368,3374,4,2,12,7,2,3,23,13,10,16,8,23
3575,3368,3374,52,10,12,3,4,5,15,22,-7,10,14,13
3576,3368,3374,28,11,12,3,4,5,13,20,-7,10,14,13
3577,3368,3374,53,5,12,6,3,3,15,6,9,15,9,21
3578,3368,3374,49,1,12,8,3,1,24,8,16,19,5,27
3579,3368,3374,37,4,12,6,4,2,18,10,8,16,8,22
3580,3368,3374,5,12,12,3,3,6,11,21,-10,9,15,12
3581,3368,3374,20,7,12,4,5,3,14,19,-5,13,11,17
3582,3368,3374,41,14,12,3,1,8,16,22,-6,7,17,10
3583,3368,3374,17,6,12,5,5,2,15,8,7,15,9,20
3584,3368,3374,8,15,12,2,4,6,8,16,-8,8,16,10
3585,3368,3374,43,8,12,4,4,4,22,12,10,12,12,16
3586,3368,3374,26,16,12,2,3,7,10,23,-13,7,17,9
3587,3368,3374,39,9,12,3,5,4,9,14,-5,11,13,14
3588,2248,2254,52,16,8,1,2,5,6,12,-6,4,12,5
3589,2248,2254,27,13,8,1,5,2,6,9,-3,7,9,8
3590,2703,2709,27,11,17,6,3,8,22,25,-3,15,19,21
3591,2703,2709,28,10,17,6,4,7,26,27,-1,16,18,22
3592,2703,2709,52,12,17,4,5,8,25,30,-5,13,21,17
3593,2703,2709,43,2,17,12,2,3,41,14,27,26,8,38
3594,2703,2709,24,15,17,4,2,11,17,27,-10,10,24,14
3595,2703,2709,17,4,17,9,2,6,39,35,4,20,14,29
3596,2703,2709,8,8,17,7,3,7,31,32,-1,17,17,24
3597,2703,2709,49,3,17,8,6,3,27,20,7,22,12,30
3598,2703,2709,37,7,17,7,4,6,23,23,0,18,16,25
3599,2703,2709,7,9,17,7,1,9,24,32,-8,15,19,22
3600,2703,2709,21,16,17,3,5,9,14,29,-15,11,23,14
3601,2703,2709,20,6,17,7,5,5,23,21,2,19,15,26
3602,2703,2709,41,13,17,4,5,8,16,27,-11,13,21,17
3603,2703,2709,53,5,17,7,5,5,21,16,5,19,15,26
3604,2703,2709,1,1,17,12,3,2,34,11,23,27,7,39
3605,2703,2709,18,14,17,4,3,10,15,29,-14,11,23,15
3606,2745,2751,1,2,22,14,5,3,42,16,26,33,11,47
3607,2745,2751,18,13,22,6,4,12,20,34,-14,16,28,22
3608,2745,2751,53,5,22,9,6,7,29,23,6,24,20,33
3609,2745,2751,20,4,22,10,7,5,32,26,6,27,17,37
3610,2745,2751,41,15,22,4,7,11,23,38,-15,15,29,19
3611,2745,2751,7,7,22,10,2,10,34,41,-7,22,22,32
3612,2745,2751,21,16,22,3,7,12,16,35,-19,13,31,16
3613,2745,2751,49,3,22,11,7,4,39,24,15,29,15,40
3614,2745,2751,37,11,22,7,6,9,24,29,-5,20,24,27
3615,2745,2751,17,6,22,10,2,10,45,48,-3,22,22,32
3616,2745,2751,8,8,22,9,4,9,34,39,-5,22,22,31
3617,2745,2751,43,1,22,16,3,3,52,18,34,35,9,51
3618,2745,2751,24,14,22,6,3,13,23,34,-11,15,29,21
3619,2745,2751,28,9,22,8,6,8,34,31,3,22,22,30
3620,2745,2751,52,12,22,6,6,10,29,35,-6,18,26,24
3621,2745,2751,27,10,22,8,3,11,27,32,-5,19,25,27
3622,2815,2926,27,8,30,11,5,14,33,39,-6,27,33,38
3623,2815,2926,28,5,30,14,6,10,52,38,14,34,26,48
3624,2815,2926,52,12,30,9,9,12,41,44,-3,27,33,36
3625,2815,2926,43,1,30,20,6,4,67,24,43,46,14,66
3626,2815,2926,24,14,30,9,5,16,32,41,-9,23,37,32
3627,2815,2926,17,7,30,12,3,15,50,66,-16,27,33,39
3628,2815,2926,8,10,30,11,4,15,42,50,-8,26,34,37
3629,2815,2926,49,3,30,16,8,6,53,31,22,40,20,56
3630,2815,2926,37,13,30,9,7,14,30,42,-12,25,35,34
3631,2815,2926,20,4,30,14,8,8,42,35,7,36,24,50
3632,2815,2926,41,11,30,10,7,13,32,41,-9,27,33,37
3633,2815,2926,53,6,30,11,7,12,42,38,4,29,31,40
3634,2815,2926,1,2,30,19,7,4,53,21,32,45,15,64
3635,2815,2926,18,15,30,8,4,18,29,54,-25,20,40,28
3636,2815,2926,7,9,30,11,5,14,39,54,-15,27,33,38
3637,2815,2926,21,16,30,6,9,15,23,42,-19,21,39,27
3638,2605,2618,1,2,7,5,0,2,14,6,8,10,4,15
3639,2605,2618,18,16,7,0,2,5,2,14,-12,2,12,2
3640,2605,2618,53,13,7,1,4,2,5,6,-1,6,8,7
3641,2605,2618,20,11,7,2,2,3,7,14,-7,6,8,8
3642,2605,2618,41,14,7,1,2,4,6,12,-6,4,10,5
3643,2605,2618,7,8,7,3,0,4,11,13,-2,6,8,9
3644,2605,2618,21,10,7,2,2,3,8,11,-3,6,8,8
3645,2605,2618,37,3,7,4,2,1,12,6,6,10,4,14
3646,2605,2618,49,4,7,4,2,1,12,9,3,10,4,14
3647,2605,2618,17,5,7,4,1,2,16,11,5,9,5,13
3648,2605,2618,8,6,7,3,3,1,13,11,2,9,5,12
3649,2605,2618,43,1,7,6,0,1,21,6,15,12,2,18
3650,2605,2618,24,9,7,2,2,3,8,7,1,6,8,8
3651,2605,2618,52,7,7,3,1,3,14,13,1,7,7,10
3652,2605,2618,28,15,7,1,2,4,8,15,-7,4,10,5
3653,2605,2618,27,12,7,2,1,4,7,10,-3,5,9,7
3654,3116,3122,27,3,23,13,3,7,38,26,12,29,17,42
3655,3116,3122,39,14,23,4,9,10,20,34,-14,17,29,21
3656,3116,3122,28,8,23,8,9,6,34,34,0,25,21,33
3657,3116,3122,52,12,23,7,6,10,24,31,-7,20,26,27
3658,3116,3122,17,4,23,10,9,4,39,27,12,29,17,39
3659,3116,3122,8,7,23,9,6,8,25,30,-5,24,22,33
3660,3116,3122,43,5,23,10,8,5,49,28,21,28,18,38
3661,3116,3122,24,15,23,4,6,13,23,44,-21,14,32,18
3662,3116,3122,20,10,23,8,4,11,36,39,-3,20,26,28
3663,3116,3122,41,13,23,7,4,12,26,40,-14,18,28,25
3664,3116,3122,49,1,23,15,5,3,50,14,36,35,11,50
3665,3116,3122,37,6,23,9,6,8,33,35,-2,24,22,33
3666,3116,3122,4,9,23,7,10,6,24,26,-2,24,22,31
3667,3312,3318,26,14,4,0,1,3,3,9,-6,1,7,1
3668,3312,3318,39,9,4,1,2,1,4,3,1,4,4,5
3669,3312,3318,27,13,4,0,1,3,3,8,-5,1,7,1
3670,3347,3353,27,11,9,2,2,5,10,14,-4,6,12,8
3671,3347,3353,39,14,9,1,4,4,4,12,-8,6,12,7
3672,3347,3353,43,9,9,3,3,3,16,8,8,9,9,12
3673,3347,3353,26,16,9,1,3,5,8,16,-8,5,13,6
3674,3347,3353,17,7,9,3,4,2,10,6,4,10,8,13
3675,3347,3353,8,13,9,1,4,4,5,12,-7,6,12,7
3676,3347,3353,49,3,9,6,2,1,11,6,5,14,4,20
3677,3347,3353,37,5,9,4,3,2,14,9,5,11,7,15
3678,3347,3353,20,8,9,3,4,2,12,16,-4,10,8,13
3679,3347,3353,41,15,9,2,0,7,9,16,-7,4,14,6
3680,3347,3353,5,12,9,2,2,5,7,18,-11,6,12,8
3681,3347,3353,53,4,9,5,2,2,13,4,9,12,6,17
3682,3347,3353,52,6,9,3,4,2,15,11,4,10,8,13
3683,3347,3353,28,10,9,2,3,4,9,15,-6,7,11,9
3684,3347,3353,4,2,9,6,2,1,20,8,12,14,4,20
3685,3347,3353,1,1,9,7,0,2,19,11,8,14,4,21
3686,3851,3857,1,2,24,17,4,3,61,26,35,38,10,55
3687,3851,3857,53,8,24,8,8,8,23,26,-3,24,24,32
3688,3851,3857,49,1,24,18,5,1,56,14,42,41,7,59
3689,3851,3857,37,7,24,8,8,8,23,25,-2,24,24,32
3690,3851,3857,21,5,24,9,6,9,26,37,-11,24,24,33
3691,3851,3857,4,16,24,4,5,15,16,46,-30,13,35,17
3692,3851,3857,43,3,24,13,5,6,42,24,18,31,17,44
3693,3851,3857,26,10,24,8,5,11,25,31,-6,21,27,29
3694,3851,3857,20,11,24,6,10,8,28,25,3,22,26,28
3695,3851,3857,41,12,24,5,10,9,15,28,-13,20,28,25
3696,3851,3857,17,4,24,14,0,10,38,26,12,28,20,42
3697,3851,3857,52,6,24,8,9,7,25,26,-1,25,23,33
3698,3851,3857,28,9,24,8,6,10,31,36,-5,22,26,30
3699,3851,3857,36,13,24,5,8,11,22,32,-10,18,30,23
3700,3851,3857,27,14,24,6,4,14,32,46,-14,16,32,22
3701,3851,3857,39,15,24,5,7,12,25,40,-15,17,31,22
3702,4103,4109,39,6,11,5,2,4,11,15,-4,12,10,17
3703,4103,4109,43,3,11,6,3,2,26,14,12,15,7,21
3704,4103,4109,57,5,11,5,3,3,10,9,1,13,9,18
3705,4103,4109,24,8,11,4,3,4,11,8,3,11,11,15
3706,4103,4109,26,16,11,1,5,5,5,14,-9,7,15,8
3707,4103,4109,17,14,11,2,4,5,12,16,-4,8,14,10
3708,4103,4109,49,1,11,8,2,1,24,6,18,18,4,26
3709,4103,4109,37,13,11,3,1,7,11,17,-6,7,15,10
3710,4103,4109,20,10,11,3,3,5,15,15,0,9,13,12
3711,4103,4109,41,12,11,3,2,6,12,24,-12,8,14,11
3712,4103,4109,53,15,11,2,2,7,9,20,-11,6,16,8
3713,4103,4109,52,4,11,6,2,3,15,10,5,14,8,20
3714,4103,4109,28,9,11,3,4,4,11,13,-2,10,12,13
3715,4103,4109,36,11,11,3,3,5,12,22,-10,9,13,12
3716,4103,4109,1,2,11,7,4,0,23,8,15,18,4,25
3717,4103,4109,21,7,11,4,3,4,17,13,4,11,11,15
3718,4159,4165,21,9,17,5,5,7,21,20,1,15,19,20
3719,4159,4165,1,1,17,13,4,0,42,13,29,30,4,43
3720,4159,4165,52,4,17,8,4,5,22,16,6,20,14,28
3721,4159,4165,28,10,17,5,5,7,15,18,-3,15,19,20
3722,4159,4165,36,11,17,5,5,7,18,29,-11,15,19,20
3723,4159,4165,41,8,17,6,3,8,17,29,-12,15,19,21
3724,4159,4165,20,16,17,3,4,10,19,28,-9,10,24,13
3725,4159,4165,17,13,17,4,4,9,18,30,-12,12,22,16
3726,4159,4165,49,2,17,10,5,2,32,11,21,25,9,35
3727,4159,4165,37,15,17,4,2,11,14,31,-17,10,24,14
3728,4159,4165,53,14,17,4,3,10,15,26,-11,11,23,15
3729,4159,4165,43,3,17,10,4,3,39,18,21,24,10,34
3730,4159,4165,57,5,17,8,4,5,16,13,3,20,14,28
3731,4159,4165,24,6,17,7,6,4,21,11,10,20,14,27
3732,4159,4165,26,12,17,4,7,6,11,17,-6,15,19,19
3733,4159,4165,39,7,17,6,3,8,16,26,-10,15,19,21
3734,4026,4032,39,11,2,1,0,1,2,3,-1,2,2,3
3735,4026,4032,52,2,2,2,0,0,3,1,2,4,0,6
3736,4026,4032,28,10,2,1,0,1,1,1,0,2,2,3
3737,4026,4032,17,8,2,1,0,1,3,3,0,2,2,3
3738,4026,4032,43,3,2,1,1,0,3,2,1,3,1,4
3739,4026,4032,24,12,2,1,0,1,1,2,-1,2,2,3
3740,4026,4032,26,13,2,0,1,1,1,2,-1,1,3,1
3741,4026,4032,57,16,2,0,0,2,0,2,-2,0,4,0
3742,4026,4032,20,4,2,1,0,1,4,3,1,2,2,3
3743,4026,4032,41,6,2,1,0,1,4,4,0,2,2,3
3744,4026,4032,21,6,2,1,0,1,4,4,0,2,2,3
3745,4026,4032,37,5,2,1,0,1,2,1,1,2,2,3
3746,4026,4032,49,9,2,1,0,1,2,2,0,2,2,3
3747,1905,1911,53,3,10,6,2,2,13,9,4,14,6,20
3748,1905,1911,8,9,10,3,2,5,11,18,-7,8,12,11
3749,1905,1911,17,15,10,1,4,5,6,12,-6,6,14,7
3750,1905,1911,49,11,10,2,4,4,7,10,-3,8,12,10
3751,1905,1911,1,10,10,2,4,4,17,18,-1,8,12,10
3752,1982,1988,1,10,20,5,9,6,31,26,5,19,21,24
3753,1982,1988,49,4,20,11,5,4,31,14,17,27,13,38
3754,1982,1988,17,13,20,4,7,9,15,31,-16,15,25,19
3755,1982,1988,8,14,20,5,2,13,20,37,-17,12,28,17
3756,1982,1988,53,3,20,11,6,3,29,18,11,28,12,39
3757,1982,1988,41,7,20,7,6,7,35,30,5,20,20,27
3758,1982,1988,30,9,20,6,7,7,18,27,-9,19,21,25
3759,1982,1988,21,6,20,8,5,7,31,29,2,21,19,29
3760,1982,1988,4,8,20,7,6,7,33,40,-7,20,20,27
3761,1982,1988,7,11,20,5,5,10,18,20,-2,15,25,20
3762,1982,1988,28,2,20,14,1,5,31,21,10,29,11,43
3763,1982,1988,52,12,20,5,4,11,23,32,-9,14,26,19
3764,1982,1988,48,15,20,4,5,11,17,35,-18,13,27,17
3765,1982,1988,43,1,20,17,1,2,58,10,48,35,5,52
3766,1982,1988,24,5,20,11,2,7,25,25,0,24,16,35
3767,1982,1988,57,16,20,2,5,13,12,32,-20,9,31,11
3768,1996,2002,43,1,22,17,2,3,59,12,47,36,8,53
3769,1996,2002,24,5,22,12,2,8,26,26,0,26,18,38
3770,1996,2002,57,16,22,3,5,14,14,37,-23,11,33,14
3771,1996,2002,28,2,22,14,1,7,31,23,8,29,15,43
3772,1996,2002,52,10,22,7,4,11,26,33,-7,18,26,25
3773,1996,2002,48,15,22,4,6,12,20,40,-20,14,30,18
3774,1996,2002,21,7,22,8,6,8,31,30,1,22,22,30
3775,1996,2002,4,8,22,8,6,8,35,44,-9,22,22,30
3776,1996,2002,7,12,22,6,5,11,20,22,-2,17,27,23
3777,1996,2002,41,6,22,8,6,8,37,32,5,22,22,30
3778,1996,2002,30,9,22,7,8,7,22,30,-8,22,22,29
3779,1996,2002,53,4,22,12,6,4,31,20,11,30,14,42
3780,1996,2002,17,13,22,5,8,9,20,31,-11,18,26,23
3781,1996,2002,8,14,22,6,3,13,25,39,-14,15,29,21
3782,1996,2002,49,3,22,12,6,4,34,15,19,30,14,42
3783,1996,2002,1,11,22,5,10,7,32,29,3,20,24,25
3784,1870,1883,1,10,6,1,3,2,8,9,-1,5,7,6
3785,1870,1883,49,14,6,0,3,3,4,7,-3,3,9,3
3786,1870,1883,8,8,6,3,1,2,7,9,-2,7,5,10
3787,1870,1883,17,11,6,1,3,2,3,4,-1,5,7,6
3788,1870,1883,53,6,6,3,1,2,6,6,0,7,5,10
3789,1870,1883,41,3,6,3,3,0,13,2,11,9,3,12
3790,1870,1883,30,9,6,2,2,2,5,6,-1,6,6,8
3791,1870,1883,21,4,6,3,2,1,10,5,5,8,4,11
3792,1870,1883,4,7,6,3,1,2,11,13,-2,7,5,10
3793,1870,1883,7,12,6,1,2,3,4,6,-2,4,8,5
3794,1870,1883,28,1,6,6,0,0,12,2,10,12,0,18
3795,1870,1883,52,13,6,1,2,3,3,9,-6,4,8,5
3796,1870,1883,48,15,6,0,1,5,3,11,-8,1,11,1
3797,1870,1883,43,2,6,5,0,1,11,3,8,10,2,15
3798,1870,1883,24,5,6,3,1,2,7,6,1,7,5,10
3799,1870,1883,57,16,6,0,1,5,1,10,-9,1,11,1
3800,2192,2198,52,4,1,1,0,0,2,0,2,2,0,3
3801,2192,2198,28,12,1,0,0,1,0,1,-1,0,2,0
3802,2192,2198,7,5,1,1,0,0,3,2,1,2,0,3
3803,2192,2198,21,6,1,1,0,0,1,0,1,2,0,3
3804,2192,2198,4,15,1,0,0,1,0,2,-2,0,2,0
3805,2192,2198,24,7,1,0,1,0,1,1,0,1,1,1
3806,2192,2198,43,7,1,0,1,0,1,1,0,1,1,1
3807,2192,2198,20,7,1,0,1,0,1,1,0,1,1,1
3808,2192,2198,41,13,1,0,0,1,1,3,-2,0,2,0
3809,2192,2198,30,16,1,0,0,1,1,4,-3,0,2,0
3810,2192,2198,8,2,1,1,0,0,3,1,2,2,0,3
3811,2192,2198,17,13,1,0,0,1,1,3,-2,0,2,0
3812,2192,2198,49,11,1,0,0,1,2,3,-1,0,2,0
3813,2192,2198,1,2,1,1,0,0,3,1,2,2,0,3
3814,2192,2198,53,1,1,1,0,0,4,1,3,2,0,3
3815,2192,2198,27,7,1,0,1,0,1,1,0,1,1,1
3816,2325,2331,27,16,16,1,8,7,12,30,-18,10,22,11
3817,2325,2331,53,12,16,4,3,9,28,35,-7,11,21,15
3818,2325,2331,1,2,16,11,2,3,34,18,16,24,8,35
3819,2325,2331,8,7,16,5,6,5,30,24,6,16,16,21
3820,2325,2331,17,9,16,5,4,7,15,21,-6,14,18,19
3821,2325,2331,49,4,16,8,5,3,28,18,10,21,11,29
3822,2325,2331,41,5,16,7,5,4,18,15,3,19,13,26
3823,2325,2331,20,6,16,5,7,4,13,11,2,17,15,22
3824,2325,2331,30,13,16,4,2,10,19,33,-14,10,22,14
3825,2325,2331,21,3,16,9,5,2,25,12,13,23,9,32
3826,2325,2331,4,10,16,4,6,6,17,26,-9,14,18,18
3827,3690,3696,4,14,6,1,1,4,8,12,-4,3,9,4
3828,3690,3696,52,10,6,2,1,3,9,9,0,5,7,7
3829,3690,3696,36,11,6,1,4,1,4,4,0,6,6,7
3830,3690,3696,37,13,6,1,2,3,2,8,-6,4,8,5
3831,3690,3696,17,4,6,3,0,3,8,5,3,6,6,9
3832,3690,3696,20,5,6,2,3,1,6,4,2,7,5,9
3833,3690,3696,41,12,6,2,0,4,6,12,-6,4,8,6
3834,3690,3696,28,6,6,2,3,1,9,9,0,7,5,9
3835,3690,3696,49,2,6,4,2,0,17,3,14,10,2,14
3836,3690,3696,43,1,6,5,0,1,15,6,9,10,2,15
3837,3690,3696,26,9,6,2,2,2,6,11,-5,6,6,8
3838,3690,3696,53,8,6,2,2,2,5,8,-3,6,6,8
3839,3697,3703,53,6,7,3,2,2,8,8,0,8,6,11
3840,3697,3703,43,1,7,5,1,1,16,7,9,11,3,16
3841,3697,3703,26,7,7,3,2,2,9,12,-3,8,6,11
3842,3697,3703,20,5,7,3,3,1,10,4,6,9,5,12
3843,3697,3703,41,13,7,2,0,5,6,16,-10,4,10,6
3844,3697,3703,17,4,7,4,0,3,12,6,6,8,6,12
3845,3697,3703,49,2,7,4,3,0,18,4,14,11,3,15
3846,3697,3703,37,14,7,1,3,3,3,9,-6,5,9,6
3847,3697,3703,28,8,7,2,4,1,10,10,0,8,6,10
3848,3697,3703,52,10,7,2,1,4,9,12,-3,5,9,7
3849,3697,3703,36,12,7,1,4,2,6,8,-2,6,8,7
3850,3697,3703,21,9,7,2,2,3,5,9,-4,6,8,8
3851,3697,3703,4,15,7,1,2,4,9,13,-4,4,10,5
3852,3697,3703,39,11,7,2,1,4,9,15,-6,5,9,7
3853,3697,3703,27,16,7,1,2,4,6,12,-6,4,10,5
3854,3697,3703,1,3,7,4,2,1,16,7,9,10,4,14
3855,4145,4151,39,7,15,6,3,6,14,21,-7,15,15,21
3856,4145,4151,21,9,15,5,3,7,19,18,1,13,17,18
3857,4145,4151,52,5,15,7,3,5,18,13,5,17,13,24
3858,4145,4151,36,8,15,5,4,6,16,26,-10,14,16,19
3859,4145,4151,28,11,15,4,4,7,13,17,-4,12,18,16
3860,4145,4151,1,1,15,11,4,0,37,10,27,26,4,37
3861,4145,4151,17,15,15,3,4,8,15,26,-11,10,20,13
3862,4145,4151,41,10,15,5,2,8,14,29,-15,12,18,17
3863,4145,4151,20,14,15,3,4,8,17,21,-4,10,20,13
3864,4145,4151,43,3,15,8,4,3,33,17,16,20,10,28
3865,4145,4151,57,4,15,8,3,4,16,12,4,19,11,27
3866,4145,4151,24,6,15,6,5,4,18,9,9,17,13,23
3867,4145,4151,26,12,15,3,6,6,8,16,-8,12,18,15
3868,4145,4151,49,2,15,10,4,1,30,8,22,24,6,34
3869,4145,4151,37,13,15,4,2,9,14,27,-13,10,20,14
3870,4145,4151,53,16,15,3,3,9,12,24,-12,9,21,12
3871,4173,4179,53,14,19,5,4,10,18,27,-9,14,24,19
3872,4173,4179,49,2,19,11,6,2,34,12,22,28,10,39
3873,4173,4179,37,16,19,4,4,11,14,31,-17,12,26,16
3874,4173,4179,43,3,19,11,5,3,41,19,22,27,11,38
3875,4173,4179,57,5,19,8,4,7,17,16,1,20,18,28
3876,4173,4179,24,6,19,7,7,5,23,14,9,21,17,28
3877,4173,4179,26,13,19,4,8,7,13,21,-8,16,22,20
3878,4173,4179,41,11,19,6,3,10,19,34,-15,15,23,21
3879,4173,4179,20,15,19,4,4,11,21,31,-10,12,26,16
3880,4173,4179,17,10,19,6,4,9,22,32,-10,16,22,22
3881,4173,4179,1,1,19,14,4,1,45,15,30,32,6,46
3882,4173,4179,52,4,19,9,5,5,26,18,8,23,15,32
3883,4173,4179,36,7,19,6,6,7,20,30,-10,18,20,24
3884,4173,4179,28,8,19,6,5,8,19,22,-3,17,21,23
3885,4173,4179,21,12,19,5,6,8,22,22,0,16,22,21
3886,4173,4179,39,9,19,6,5,8,16,26,-10,17,21,23
3887,4180,4186,39,10,20,6,6,8,17,27,-10,18,22,24
3888,4180,4186,1,1,20,15,4,1,46,15,31,34,6,49
3889,4180,4186,21,9,20,6,6,8,23,22,1,18,22,24
3890,4180,4186,52,4,20,9,5,6,26,19,7,23,17,32
3891,4180,4186,36,7,20,7,6,7,22,31,-9,20,20,27
3892,4180,4186,28,11,20,6,5,9,19,25,-6,17,23,23
3893,4180,4186,17,8,20,7,4,9,23,32,-9,18,22,25
3894,4180,4186,41,13,20,6,3,11,20,36,-16,15,25,21
3895,4180,4186,20,15,20,4,5,11,22,32,-10,13,27,17
3896,4180,4186,43,3,20,11,5,4,41,20,21,27,13,38
3897,4180,4186,57,5,20,8,5,7,18,17,1,21,19,29
3898,4180,4186,24,6,20,7,7,6,23,15,8,21,19,28
3899,4180,4186,26,14,20,4,9,7,14,22,-8,17,23,21
3900,4180,4186,49,2,20,12,6,2,37,12,25,30,10,42
3901,4180,4186,37,16,20,4,4,12,14,32,-18,12,28,16
3902,4180,4186,53,12,20,6,4,10,19,27,-8,16,24,22
3903,4187,4193,53,13,21,6,5,10,19,27,-8,17,25,23
3904,4187,4193,49,2,21,12,7,2,38,13,25,31,11,43
3905,4187,4193,37,16,21,4,4,13,14,34,-20,12,30,16
3906,4187,4193,43,3,21,11,6,4,42,21,21,28,14,39
3907,3116,3122,7,16,23,3,4,16,20,52,-32,10,36,13
3908,3116,3122,53,11,23,8,4,11,34,41,-7,20,26,28
3909,3116,3122,1,2,23,12,7,4,50,24,26,31,15,43
3910,3172,3290,1,4,30,13,9,8,55,33,22,35,25,48
3911,3172,3290,53,14,30,8,7,15,39,51,-12,23,37,31
3912,3172,3290,4,11,30,8,12,10,33,39,-6,28,32,36
3913,3172,3290,7,16,30,5,5,20,27,65,-38,15,45,20
3914,3172,3290,20,8,30,12,5,13,50,50,0,29,31,41
3915,3172,3290,41,9,30,12,4,14,35,44,-9,28,32,40
3916,3172,3290,43,5,30,12,12,6,59,33,26,36,24,48
3917,3172,3290,24,15,30,6,8,16,32,57,-25,20,40,26
3918,3172,3290,28,7,30,11,11,8,40,41,-1,33,27,44
3919,3172,3290,52,12,30,8,9,13,29,39,-10,25,35,33
3920,3172,3290,17,3,30,13,10,7,49,36,13,36,24,49
3921,3172,3290,8,10,30,10,9,11,32,41,-9,29,31,39
3922,3172,3290,49,1,30,19,7,4,62,18,44,45,15,64
3923,3172,3290,37,6,30,12,9,9,45,44,1,33,27,45
3924,3172,3290,27,2,30,17,6,7,42,26,16,40,20,57
3925,3172,3290,39,13,30,8,9,13,30,42,-12,25,35,33
3926,3480,3500,27,7,26,11,3,12,36,37,-1,25,27,36
3927,3480,3500,39,13,26,6,8,12,22,38,-16,20,32,26
3928,3480,3500,17,9,26,9,8,9,32,37,-5,26,26,35
3929,3480,3500,8,16,26,3,10,13,24,41,-17,16,36,19
3930,3480,3500,49,1,26,19,5,2,58,20,38,43,9,62
3931,3480,3500,37,6,26,12,6,8,38,27,11,30,22,42
3932,3480,3500,5,15,26,4,7,15,22,53,-31,15,37,19
3933,3480,3500,43,5,26,12,6,8,55,25,30,30,22,42
3934,3480,3500,26,14,26,5,6,15,20,48,-28,16,36,21
3935,3480,3500,20,10,26,8,9,9,31,41,-10,25,27,33
3936,3480,3500,41,11,26,7,6,13,30,40,-10,20,32,27
3937,3480,3500,52,8,26,9,9,8,32,33,-1,27,25,36
3938,3480,3500,28,12,26,7,6,13,32,51,-19,20,32,27
3939,3480,3500,53,4,26,12,7,7,34,22,12,31,21,43
3940,3480,3500,1,2,26,17,4,5,59,31,28,38,14,55
3941,3480,3500,4,3,26,14,6,6,44,25,19,34,18,48
3942,3711,3717,21,4,9,4,2,3,12,10,2,10,8,14
3943,3711,3717,4,14,9,2,2,5,11,16,-5,6,12,8
3944,3711,3717,1,3,9,5,3,1,21,9,12,13,5,18
3945,3711,3717,53,8,9,3,3,3,11,12,-1,9,9,12
3946,3711,3717,28,6,9,3,4,2,12,14,-2,10,8,13
3947,3711,3717,52,9,9,3,2,4,11,13,-2,8,10,11
3948,3711,3717,36,15,9,1,4,4,6,14,-8,6,12,7
3949,3711,3717,20,5,9,3,5,1,12,6,6,11,7,14
3950,3711,3717,41,12,9,3,1,5,7,16,-9,7,11,10
3951,3711,3717,43,1,9,7,1,1,21,8,13,15,3,22
3952,3711,3717,26,11,9,3,2,4,10,15,-5,8,10,11
3953,3711,3717,49,2,9,5,3,1,22,9,13,13,5,18
3954,3711,3717,37,13,9,2,3,4,5,10,-5,7,11,9
3955,3711,3717,17,7,9,4,0,5,13,10,3,8,10,12
3956,3711,3717,39,10,9,3,2,4,12,16,-4,8,10,11
3957,3711,3717,27,16,9,1,3,5,10,18,-8,5,13,6
3958,4152,4158,39,7,16,6,3,7,16,24,-8,15,17,21
3959,4152,4158,17,12,16,4,4,8,18,28,-10,12,20,16
3960,4152,4158,49,2,16,10,4,2,32,11,21,24,8,34
3961,4152,4158,37,14,16,4,2,10,14,28,-14,10,22,14
3962,4152,4158,43,3,16,9,4,3,35,18,17,22,10,31
3963,4152,4158,57,5,16,8,3,5,16,13,3,19,13,27
3964,4152,4158,24,6,16,7,5,4,19,9,10,19,13,26
3965,4152,4158,26,13,16,3,7,6,9,17,-8,13,19,16
3966,4152,4158,41,11,16,5,3,8,14,29,-15,13,19,18
3967,4152,4158,20,15,16,3,4,9,19,24,-5,10,22,13
3968,4152,4158,52,4,16,8,3,5,21,15,6,19,13,27
3969,4152,4158,36,8,16,5,5,6,17,27,-10,15,17,20
3970,4152,4158,28,10,16,5,4,7,14,17,-3,14,18,19
3971,4152,4158,53,16,16,3,3,10,13,26,-13,9,23,12
3972,4152,4158,1,1,16,12,4,0,40,12,28,28,4,40
3973,4152,4158,21,9,16,5,4,7,19,18,1,14,18,19
3974,4222,4235,21,12,26,7,8,11,30,29,1,22,30,29
3975,4222,4235,1,1,26,17,6,3,50,19,31,40,12,57
3976,4222,4235,53,11,26,8,5,13,23,32,-9,21,31,29
3977,4222,4235,52,4,26,12,7,7,33,22,11,31,21,43
3978,4222,4235,28,9,26,8,8,10,26,33,-7,24,28,32
3979,4222,4235,36,10,26,7,9,10,24,38,-14,23,29,30
3980,4222,4235,41,8,26,10,3,13,33,42,-9,23,29,33
3981,4222,4235,20,14,26,6,6,14,26,39,-13,18,34,24
3982,4222,4235,49,3,26,14,10,2,44,15,29,38,14,52
3983,4222,4235,37,16,26,5,5,16,18,43,-25,15,37,20
3984,4222,4235,43,2,26,16,6,4,55,22,33,38,14,54
3985,1254,1260,4,8,21,9,4,8,32,35,-3,22,20,31
3986,1254,1260,7,12,21,5,7,9,24,33,-9,17,25,22
3987,1254,1260,53,3,21,11,6,4,41,21,20,28,14,39
3988,1254,1260,44,13,21,5,7,9,18,27,-9,17,25,22
3989,1254,1260,41,5,21,10,4,7,27,21,6,24,18,34
3990,1254,1260,49,4,21,11,5,5,45,23,22,27,15,38
3991,1254,1260,8,2,21,12,6,3,30,19,11,30,12,42
3992,1254,1260,17,11,21,5,7,9,27,30,-3,17,25,22
3993,1254,1260,36,6,21,10,4,7,31,26,5,24,18,34
3994,1254,1260,28,9,21,6,6,9,31,39,-8,18,24,24
3995,1254,1260,48,15,21,4,4,13,17,39,-22,12,30,16
3996,1254,1260,43,1,21,15,5,1,58,16,42,35,7,50
3997,1254,1260,57,10,21,6,6,9,16,29,-13,18,24,24
3998,1254,1260,24,16,21,2,5,14,16,41,-25,9,33,11
3999,1254,1260,1,14,21,4,5,12,21,39,-18,13,29,17
4000,1548,1554,43,1,11,11,0,0,36,9,27,22,0,33
4001,1548,1554,57,13,11,2,4,5,11,26,-15,8,14,10
4002,1548,1554,28,4,11,5,3,3,20,14,6,13,9,18
4003,1548,1554,36,15,11,1,5,5,13,19,-6,7,15,8
4004,1548,1554,48,16,11,1,3,7,8,25,-17,5,17,6
4005,1548,1554,17,3,11,6,1,4,22,19,3,13,9,19
4006,1548,1554,8,5,11,5,2,4,23,21,2,12,10,17
4007,1548,1554,49,2,11,7,3,1,24,10,14,17,5,24
4008,1548,1554,30,6,11,4,4,3,20,14,6,12,10,16
4009,1548,1554,41,7,11,4,3,4,18,15,3,11,11,15
4010,1548,1554,53,8,11,4,3,4,16,13,3,11,11,15
4011,1548,1554,4,9,11,3,5,3,17,16,1,11,11,14
4012,1548,1554,21,11,11,3,3,5,11,22,-11,9,13,12
4013,1548,1554,7,14,11,2,3,6,9,24,-15,7,15,9
4014,1548,1554,1,12,11,2,5,4,16,14,2,9,13,11
4015,1548,1554,39,10,11,3,3,5,14,17,-3,9,13,12
4016,1471,1477,39,6,2,1,0,1,3,3,0,2,2,3
4017,1471,1477,7,10,2,1,0,1,1,6,-5,2,2,3
4018,1471,1477,4,14,2,0,1,1,3,6,-3,1,3,1
4019,1471,1477,21,15,2,0,1,1,1,7,-6,1,3,1
4020,1471,1477,53,8,2,1,0,1,1,2,-1,2,2,3
4021,1471,1477,41,4,2,1,1,0,11,6,5,3,1,4
4022,1471,1477,30,13,2,0,1,1,1,3,-2,1,3,1
4023,1471,1477,49,5,2,1,1,0,7,2,5,3,1,4
4024,1471,1477,17,2,2,2,0,0,5,1,4,4,0,6
4025,1471,1477,8,9,2,1,0,1,6,9,-3,2,2,3
4026,1471,1477,48,7,2,1,0,1,1,1,0,2,2,3
4027,1471,1477,36,11,2,0,1,1,2,3,-1,1,3,1
4028,1471,1477,28,12,2,0,1,1,0,1,-1,1,3,1
4029,1471,1477,43,1,2,2,0,0,8,0,8,4,0,6
4030,1471,1477,57,16,2,0,0,2,1,7,-6,0,4,0
4031,1471,1477,1,3,2,1,1,0,7,1,6,3,1,4
4032,1828,1834,1,15,1,0,0,1,1,3,-2,0,2,0
4033,1828,1834,43,2,1,1,0,0,3,1,2,2,0,3
4034,1828,1834,24,9,1,0,1,0,0,0,0,1,1,1
4035,1828,1834,57,14,1,0,0,1,0,1,-1,0,2,0
4036,1828,1834,28,6,1,1,0,0,1,0,1,2,0,3
4037,1828,1834,48,11,1,0,0,1,1,2,-1,0,2,0
4038,1828,1834,52,11,1,0,0,1,1,2,-1,0,2,0
4039,1828,1834,49,7,1,0,1,0,2,2,0,1,1,1
4040,1828,1834,17,3,1,1,0,0,2,1,1,2,0,3
4041,1828,1834,8,16,1,0,0,1,0,5,-5,0,2,0
4042,1828,1834,41,1,1,1,0,0,5,0,5,2,0,3
4043,1828,1834,30,11,1,0,0,1,1,2,-1,0,2,0
4044,1828,1834,53,3,1,1,0,0,2,1,1,2,0,3
4045,1828,1834,4,3,1,1,0,0,2,1,1,2,0,3
4046,1828,1834,21,7,1,0,1,0,2,2,0,1,1,1
4047,1828,1834,7,9,1,0,1,0,0,0,0,1,1,1
4048,1919,1925,4,6,12,5,3,4,21,25,-4,13,11,18
4049,1919,1925,21,8,12,4,4,4,17,18,-1,12,12,16
4050,1919,1925,7,11,12,3,4,5,8,9,-1,10,14,13
4051,1919,1925,53,3,12,8,2,2,17,10,7,18,6,26
4052,1919,1925,41,5,12,5,4,3,21,12,9,14,10,19
4053,1919,1925,30,9,12,4,3,5,11,17,-6,11,13,15
4054,1919,1925,8,13,12,3,2,7,11,23,-12,8,16,11
4055,1919,1925,17,15,12,1,4,7,6,21,-15,6,18,7
4056,1919,1925,49,7,12,4,4,4,14,10,4,12,12,16
4057,1919,1925,28,1,12,11,1,0,26,8,18,23,1,34
4058,1919,1925,48,12,12,3,3,6,11,16,-5,9,15,12
4059,1919,1925,52,14,12,2,2,8,8,21,-13,6,18,8
4060,1919,1925,43,2,12,10,1,1,29,3,26,21,3,31
4061,1919,1925,24,4,12,6,2,4,12,9,3,14,10,20
4062,1919,1925,57,16,12,0,4,8,4,18,-14,4,20,4
4063,1919,1925,1,10,12,3,5,4,23,19,4,11,13,14
4064,2003,2009,43,1,23,18,2,3,64,12,52,38,8,56
4065,2003,2009,24,5,23,12,3,8,26,26,0,27,19,39
4066,1555,1561,1,13,12,2,5,5,17,17,0,9,15,11
4067,1555,1561,39,11,12,3,3,6,15,21,-6,9,15,12
4068,1555,1561,28,5,12,5,4,3,22,16,6,14,10,19
4069,1555,1561,36,14,12,2,5,5,17,20,-3,9,15,11
4070,1555,1561,48,16,12,1,3,8,8,26,-18,5,19,6
4071,1555,1561,43,1,12,12,0,0,39,10,29,24,0,36
4072,1555,1561,57,10,12,3,4,5,15,29,-14,10,14,13
4073,1555,1561,30,4,12,5,4,3,30,15,15,14,10,19
4074,1555,1561,41,7,12,5,3,4,19,15,4,13,11,18
4075,1555,1561,49,2,12,7,4,1,24,10,14,18,6,25
4076,1555,1561,17,3,12,6,1,5,25,23,2,13,11,19
4077,1555,1561,8,8,12,5,3,4,25,23,2,13,11,18
4078,1555,1561,4,9,12,3,6,3,17,16,1,12,12,15
4079,1555,1561,21,12,12,3,3,6,12,32,-20,9,15,12
4080,1555,1561,7,15,12,2,3,7,9,28,-19,7,17,9
4081,1555,1561,53,6,12,5,3,4,20,13,7,13,11,18
4082,1968,1974,53,3,18,10,5,3,26,17,9,25,11,35
4083,1968,1974,21,7,18,7,4,7,28,28,0,18,18,25
4084,1968,1974,4,8,18,7,4,7,31,38,-7,18,18,25
4085,1968,1974,7,11,18,5,4,9,17,17,0,14,22,19
4086,1968,1974,8,13,18,5,2,11,20,34,-14,12,24,17
4087,1968,1974,17,15,18,3,6,9,13,30,-17,12,24,15
4088,1968,1974,49,4,18,10,4,4,28,13,15,24,12,34
4089,1968,1974,41,6,18,7,4,7,35,30,5,18,18,25
4090,1968,1974,30,9,18,6,5,7,18,27,-9,17,19,23
4091,1968,1974,43,1,18,15,1,2,49,10,39,31,5,46
4092,1968,1974,24,5,18,9,2,7,22,24,-2,20,16,29
4093,1968,1974,57,16,18,2,4,12,11,29,-18,8,28,10
4094,1968,1974,28,2,18,14,1,3,31,14,17,29,7,43
4095,1968,1974,52,12,18,5,3,10,22,28,-6,13,23,18
4096,1968,1974,48,14,18,4,4,10,15,32,-17,12,24,16
4097,1968,1974,1,10,18,5,7,6,29,24,5,17,19,22
4098,2290,2296,1,1,13,9,1,3,28,16,12,19,7,28
4099,2290,2296,27,15,13,1,7,5,8,18,-10,9,17,10
4100,2290,2296,28,6,13,5,4,4,22,20,2,14,12,19
4101,2290,2296,52,16,13,1,5,7,10,24,-14,7,19,8
4102,2290,2296,43,2,13,8,4,1,26,6,20,20,6,28
4103,2290,2296,24,13,13,1,8,4,12,19,-7,10,16,11
4104,2290,2296,41,4,13,7,4,2,15,8,7,18,8,25
4105,2290,2296,20,7,13,4,6,3,11,9,2,14,12,18
4106,2290,2296,30,14,13,3,1,9,14,28,-14,7,19,10
4107,2290,2296,49,5,13,7,3,3,24,15,9,17,9,24
4108,2290,2296,8,8,13,4,5,4,23,19,4,13,13,17
4109,2290,2296,17,9,13,4,4,5,13,14,-1,12,14,16
4110,2290,2296,21,3,13,7,4,2,19,10,9,18,8,25
4111,2290,2296,7,10,13,3,5,5,19,23,-4,11,15,14
4112,2290,2296,4,12,13,2,6,5,12,20,-8,10,16,12
4113,2290,2296,53,11,13,3,3,7,19,26,-7,9,17,12
4114,2297,2317,53,12,14,3,3,8,22,31,-9,9,19,12
4115,2297,2317,21,3,14,7,5,2,20,11,9,19,9,26
4116,2297,2317,7,10,14,3,6,5,21,25,-4,12,16,15
4117,2297,2317,4,11,14,3,6,5,14,21,-7,12,16,15
4118,2297,2317,17,8,14,5,4,5,14,14,0,14,14,19
4119,2297,2317,8,9,14,4,6,4,25,21,4,14,14,18
4120,2297,2317,49,4,14,7,4,3,25,16,9,18,10,25
4121,2297,2317,41,5,14,7,4,3,16,10,6,18,10,25
4122,2297,2317,20,6,14,5,6,3,13,10,3,16,12,21
4123,2297,2317,30,15,14,3,1,10,15,30,-15,7,21,10
4124,2297,2317,43,1,14,9,4,1,33,6,27,22,6,31
4125,2297,2317,24,13,14,1,9,4,13,20,-7,11,17,12
4126,2297,2317,28,7,14,5,4,5,22,21,1,14,14,19
4127,2297,2317,52,14,14,2,5,7,15,27,-12,9,19,11
4128,2297,2317,27,16,14,1,7,6,8,25,-17,9,19,10
4129,2297,2317,1,2,14,9,2,3,29,17,12,20,8,29
4130,2318,2324,1,2,15,10,2,3,31,18,13,22,8,32
4131,2318,2324,27,16,15,1,7,7,10,28,-18,9,21,10
4132,2318,2324,28,7,15,5,5,5,23,22,1,15,15,20
4133,2318,2324,52,14,15,2,6,7,15,27,-12,10,20,12
4134,2318,2324,43,1,15,10,4,1,37,7,30,24,6,34
4135,2318,2324,24,13,15,1,10,4,14,21,-7,12,18,13
4136,2318,2324,41,5,15,7,5,3,17,11,6,19,11,26
4137,2318,2324,20,6,15,5,7,3,13,10,3,17,13,22
4138,2318,2324,30,15,15,3,2,10,16,31,-15,8,22,11
4139,2318,2324,49,4,15,8,4,3,28,18,10,20,10,28
4140,2318,2324,17,8,15,5,4,6,15,18,-3,14,16,19
4141,2318,2324,8,9,15,4,6,5,26,23,3,14,16,18
4142,2318,2324,21,3,15,8,5,2,22,12,10,21,9,29
4143,2318,2324,7,11,15,3,6,6,22,27,-5,12,18,15
4144,2318,2324,4,12,15,3,6,6,15,25,-10,12,18,15
4145,2325,2331,7,11,16,3,7,6,22,27,-5,13,19,16
4146,2325,2331,28,8,16,5,5,6,23,25,-2,15,17,20
4147,2325,2331,52,15,16,2,6,8,16,29,-13,10,22,12
4148,2325,2331,43,1,16,11,4,1,38,7,31,26,6,37
4149,2325,2331,24,14,16,1,11,4,16,23,-7,13,19,14
4150,2374,2380,43,2,23,15,5,3,51,10,41,35,11,50
4151,2374,2380,24,13,23,4,12,7,26,33,-7,20,26,24
4152,2374,2380,28,6,23,8,7,8,31,31,0,23,23,31
4153,2374,2380,52,15,23,4,8,11,23,40,-17,16,30,20
4154,2374,2380,21,5,23,11,7,5,31,17,14,29,17,40
4155,2374,2380,4,9,23,7,6,10,24,40,-16,20,26,27
4156,2374,2380,7,12,23,5,9,9,28,37,-9,19,27,24
4157,2374,2380,41,4,23,12,5,6,34,20,14,29,17,41
4158,2374,2380,20,7,23,7,10,6,18,16,2,24,22,31
4159,2374,2380,30,16,23,5,4,14,22,47,-25,14,32,19
4160,2374,2380,17,8,23,7,6,10,23,28,-5,20,26,27
4161,2374,2380,8,11,23,5,9,9,35,40,-5,19,27,24
4162,2374,2380,49,3,23,12,6,5,40,25,15,30,16,42
4163,2374,2380,1,1,23,16,3,4,50,27,23,35,11,51
4164,2374,2380,53,10,23,6,6,11,37,47,-10,18,28,24
4165,2374,2380,27,14,23,4,9,10,23,38,-15,17,29,21
4166,2381,2401,27,14,24,4,10,10,24,39,-15,18,30,22
4167,2381,2401,53,10,24,6,7,11,37,47,-10,19,29,25
4168,2381,2401,1,1,24,16,3,5,50,28,22,35,13,51
4169,2381,2401,49,3,24,13,6,5,41,25,16,32,16,45
4170,2381,2401,17,8,24,8,6,10,26,29,-3,22,26,30
4171,2381,2401,8,11,24,5,10,9,36,41,-5,20,28,25
4172,2381,2401,41,4,24,13,5,6,35,20,15,31,17,44
4173,2381,2401,20,7,24,7,11,6,19,17,2,25,23,32
4174,2381,2401,30,16,24,5,4,15,22,48,-26,14,34,19
4175,2381,2401,28,6,24,9,7,8,33,31,2,25,23,34
4176,2381,2401,52,15,24,4,9,11,25,42,-17,17,31,21
4177,2381,2401,43,2,24,15,6,3,51,10,41,36,12,51
4178,2381,2401,21,5,24,11,8,5,32,18,14,30,18,41
4179,2381,2401,4,9,24,7,6,11,24,42,-18,20,28,27
4180,2381,2401,7,12,24,5,10,9,30,39,-9,20,28,25
4181,2381,2401,24,13,24,4,12,8,27,36,-9,20,28,24
4182,2402,2408,43,2,25,16,6,3,54,10,44,38,12,54
4183,2402,2408,24,13,25,4,12,9,29,40,-11,20,30,24
4184,2402,2408,21,5,25,11,9,5,33,19,14,31,19,42
4185,2402,2408,4,9,25,7,7,11,26,44,-18,21,29,28
4186,2402,2408,7,11,25,5,11,9,32,41,-9,21,29,26
4187,2402,2408,28,6,25,10,7,8,37,33,4,27,23,37
4188,2402,2408,52,15,25,4,9,12,25,45,-20,17,33,21
4189,2402,2408,41,3,25,14,5,6,37,20,17,33,17,47
4190,2402,2408,20,8,25,7,12,6,20,18,2,26,24,33
4191,2402,2408,30,16,25,5,4,16,22,53,-31,14,36,19
4192,2402,2408,49,4,25,13,6,6,41,27,14,32,18,45
4193,2402,2408,17,7,25,9,6,10,31,29,2,24,26,33
4194,2402,2408,8,10,25,5,11,9,37,42,-5,21,29,26
4195,2402,2408,1,1,25,17,3,5,52,29,23,37,13,54
4196,2402,2408,53,12,25,6,7,12,38,49,-11,19,31,25
4197,2402,2408,27,14,25,4,11,10,25,40,-15,19,31,23
4198,2434,2436,27,13,29,7,11,11,31,44,-13,25,33,32
4199,2434,2436,53,11,29,8,8,13,46,55,-9,24,34,32
4200,2434,2436,1,2,29,20,3,6,57,32,25,43,15,63
4201,2434,2436,21,5,29,11,9,9,33,26,7,31,27,42
4202,2434,2436,7,12,29,7,11,11,39,47,-8,25,33,32
4203,2434,2436,4,15,29,7,8,14,29,52,-23,22,36,29
4204,2434,2436,17,8,29,9,7,13,32,37,-5,25,33,34
4205,2434,2436,8,9,29,7,12,10,43,45,-2,26,32,33
4206,2434,2436,49,4,29,14,7,8,46,32,14,35,23,49
4207,2434,2436,41,3,29,16,6,7,42,26,16,38,20,54
4208,2434,2436,20,7,29,9,12,8,28,26,2,30,28,39
4209,2434,2436,30,16,29,6,4,19,26,60,-34,16,42,22
4210,2434,2436,28,6,29,11,7,11,42,41,1,29,29,40
4211,2434,2436,52,14,29,7,10,12,33,46,-13,24,34,31
4212,2434,2436,43,1,29,19,7,3,61,12,49,45,13,64
4213,2434,2436,24,10,29,7,12,10,36,43,-7,26,32,33
4214,2556,2562,24,2,1,1,0,0,3,1,2,2,0,3
4215,2556,2562,43,4,1,1,0,0,3,2,1,2,0,3
4216,2556,2562,52,7,1,0,1,0,1,1,0,1,1,1
4217,2556,2562,28,7,1,0,1,0,1,1,0,1,1,1
4218,2556,2562,20,5,1,1,0,0,1,0,1,2,0,3
4219,2556,2562,41,7,1,0,1,0,1,1,0,1,1,1
4220,2556,2562,21,11,1,0,0,1,2,3,-1,0,2,0
4221,2556,2562,7,16,1,0,0,1,1,4,-3,0,2,0
4222,2556,2562,49,2,1,1,0,0,3,1,2,2,0,3
4223,2556,2562,37,7,1,0,1,0,1,1,0,1,1,1
4224,3368,3374,27,13,12,3,2,7,11,17,-6,8,16,11
4225,3298,3304,39,8,2,1,0,1,2,1,1,2,2,3
4226,3298,3304,27,11,2,0,1,1,1,2,-1,1,3,1
4227,3298,3304,43,13,2,0,1,1,1,3,-2,1,3,1
4228,3298,3304,26,14,2,0,0,2,2,4,-2,0,4,0
4229,3298,3304,8,6,2,1,1,0,2,1,1,3,1,4
4230,3298,3304,17,11,2,0,1,1,1,2,-1,1,3,1
4231,3298,3304,20,4,2,1,1,0,3,1,2,3,1,4
4232,3298,3304,41,15,2,0,0,2,1,4,-3,0,4,0
4233,3298,3304,5,16,2,0,0,2,0,6,-6,0,4,0
4234,3298,3304,37,7,2,1,1,0,1,0,1,3,1,4
4235,3298,3304,49,10,2,1,0,1,1,3,-2,2,2,3
4236,3298,3304,53,1,2,2,0,0,4,0,4,4,0,6
4237,3298,3304,52,3,2,1,1,0,5,1,4,3,1,4
4238,3298,3304,28,5,2,1,1,0,3,2,1,3,1,4
4239,3298,3304,4,9,2,1,0,1,3,3,0,2,2,3
4240,3298,3304,1,2,2,2,0,0,5,2,3,4,0,6
4241,3333,3339,1,1,7,6,0,1,15,8,7,12,2,18
4242,3333,3339,4,4,7,4,2,1,12,7,5,10,4,14
4243,3333,3339,52,7,7,2,4,1,13,8,5,8,6,10
4244,3333,3339,28,10,7,2,2,3,7,10,-3,6,8,8
4245,3333,3339,53,6,7,3,2,2,8,4,4,8,6,11
4246,3333,3339,49,2,7,5,1,1,9,5,4,11,3,16
4247,3333,3339,37,3,7,4,2,1,13,7,6,10,4,14
4248,3333,3339,5,15,7,1,2,4,4,16,-12,4,10,5
4249,3333,3339,20,9,7,2,4,1,10,13,-3,8,6,10
4250,3333,3339,41,16,7,1,0,6,6,10,-4,2,12,3
4251,3333,3339,17,8,7,2,4,1,6,2,4,8,6,10
4252,3333,3339,8,14,7,1,2,4,4,11,-7,4,10,5
4253,3333,3339,43,5,7,3,2,2,15,6,9,8,6,11
4254,3333,3339,26,13,7,1,2,4,7,13,-6,4,10,5
4255,3333,3339,39,11,7,1,3,3,4,8,-4,5,9,6
4256,3333,3339,27,12,7,1,2,4,6,11,-5,4,10,5
4257,3732,3738,39,12,11,3,3,5,13,18,-5,9,13,12
4258,3732,3738,27,14,11,2,3,6,12,22,-10,7,15,9
4259,3732,3738,28,10,11,3,5,3,14,17,-3,11,11,14
4260,3732,3738,36,15,11,1,6,4,8,16,-8,8,14,9
4261,3732,3738,17,6,11,5,0,6,15,13,2,10,12,15
4262,3732,3738,4,16,11,2,2,7,11,20,-9,6,16,8
4263,3732,3738,20,8,11,3,6,2,13,8,5,12,10,15
4264,3732,3738,41,13,11,3,2,6,7,17,-10,8,14,11
4265,3732,3738,37,11,11,3,4,4,7,10,-3,10,12,13
4266,3732,3738,49,2,11,6,4,1,27,10,17,16,6,22
4267,3732,3738,53,5,11,4,4,3,13,13,0,12,10,16
4268,3732,3738,43,1,11,9,1,1,26,10,16,19,3,28
4269,3732,3738,26,9,11,4,2,5,11,16,-5,10,12,14
4270,3732,3738,52,7,11,4,3,4,16,15,1,11,11,15
4271,3732,3738,21,4,11,5,2,4,15,13,2,12,10,17
4272,3732,3738,1,3,11,6,3,2,23,13,10,15,7,21
4273,4243,4249,1,1,28,18,7,3,55,20,35,43,13,61
4274,4243,4249,21,13,28,7,8,13,30,32,-2,22,34,29
4275,4243,4249,52,4,28,13,8,7,39,25,14,34,22,47
4276,4243,4249,36,9,28,8,9,11,26,43,-17,25,31,33
4277,4243,4249,28,11,28,8,8,12,26,36,-10,24,32,32
4278,4243,4249,26,14,28,6,11,11,17,32,-15,23,33,29
4279,4243,4249,53,10,28,9,5,14,29,37,-8,23,33,32
4280,4243,4249,49,3,28,14,11,3,46,18,28,39,17,53
4281,4243,4249,37,16,28,5,5,18,19,49,-30,15,41,20
4282,4243,4249,41,8,28,11,3,14,35,46,-11,25,31,36
4283,4243,4249,20,15,28,7,7,14,28,39,-11,21,35,28
4284,4243,4249,17,7,28,10,8,10,35,40,-5,28,28,38
4285,4243,4249,43,2,28,17,7,4,59,22,37,41,15,58
4286,4243,4249,57,5,28,11,8,9,27,23,4,30,26,41
4287,4243,4249,24,6,28,10,11,7,32,22,10,31,25,41
4288,4243,4249,39,12,28,8,8,12,21,40,-19,24,32,32
4289,4467,4473,39,14,11,1,5,5,5,14,-9,7,15,8
4290,4467,4473,17,4,11,5,4,2,18,16,2,14,8,19
4291,4467,4473,8,8,11,4,4,3,11,13,-2,12,10,16
4292,4467,4473,41,10,11,4,3,4,8,10,-2,11,11,15
4293,4467,4473,49,5,11,5,3,3,15,10,5,13,9,18
4294,4467,4473,53,3,11,6,1,4,19,15,4,13,9,19
4295,4467,4473,43,2,11,6,2,3,18,11,7,14,8,20
4296,4467,4473,57,6,11,5,3,3,13,13,0,13,9,18
4297,4467,4473,24,11,11,3,5,3,15,13,2,11,11,14
4298,4467,4473,26,15,11,1,4,6,6,13,-7,6,16,7
4299,4467,4473,52,9,11,3,7,1,10,5,5,13,9,16
4300,4467,4473,48,12,11,3,3,5,8,11,-3,9,13,12
4301,4467,4473,28,13,11,1,5,5,6,11,-5,7,15,8
4302,4467,4473,36,16,11,1,2,8,9,25,-16,4,18,5
4303,4467,4473,21,7,11,5,1,5,14,11,3,11,11,16
4304,4467,4473,1,1,11,8,2,1,26,10,16,18,4,26
4305,4026,4032,36,15,2,0,1,1,1,6,-5,1,3,1
4306,4026,4032,53,14,2,0,1,1,1,3,-2,1,3,1
4307,4026,4032,1,1,2,2,0,0,8,1,7,4,0,6
4308,4068,4074,1,2,8,5,3,0,18,6,12,13,3,18
4309,4068,4074,21,8,8,3,1,4,13,12,1,7,9,10
4310,4068,4074,53,16,8,1,2,5,7,13,-6,4,12,5
4311,4068,4074,52,3,8,5,2,1,12,4,8,12,4,17
4312,4068,4074,28,6,8,3,3,2,9,7,2,9,7,12
4313,4068,4074,36,15,8,1,3,4,6,13,-7,5,11,6
4314,4068,4074,49,1,8,6,1,1,18,5,13,13,3,19
4315,4068,4074,37,12,8,2,1,5,8,13,-5,5,11,7
4316,4068,4074,20,9,8,2,3,3,10,10,0,7,9,9
4317,4068,4074,41,13,8,2,1,5,8,19,-11,5,11,7
4318,4068,4074,43,4,8,4,2,2,15,11,4,10,6,14
4319,4068,4074,57,7,8,3,2,3,6,7,-1,8,8,11
4320,4068,4074,24,11,8,2,3,3,5,7,-2,7,9,9
4321,4068,4074,26,14,8,1,4,3,3,7,-4,6,10,7
4322,4068,4074,17,10,8,2,3,3,9,9,0,7,9,9
4323,4068,4074,39,5,8,4,2,2,6,10,-4,10,6,14
4324,4845,4851,17,10,12,3,5,4,14,18,-4,11,13,14
4325,4845,4851,8,13,12,3,3,6,11,21,-10,9,15,12
4326,4845,4851,43,1,12,8,2,2,30,12,18,18,6,26
4327,4845,4851,24,4,12,5,5,2,16,11,5,15,9,20
4328,4845,4851,57,11,12,3,3,6,17,21,-4,9,15,12
4329,4845,4851,20,5,12,5,5,2,19,19,0,15,9,20
4330,4845,4851,41,9,12,4,4,4,20,18,2,12,12,16
4331,4845,4851,37,3,12,5,6,1,16,9,7,16,8,21
4332,4845,4851,49,7,12,5,3,4,15,14,1,13,11,18
4333,4845,4851,52,2,12,6,5,1,21,7,14,17,7,23
4334,4845,4851,48,12,12,3,3,6,13,23,-10,9,15,12
4335,4845,4851,36,14,12,2,4,6,13,19,-6,8,16,10
4336,4845,4851,28,15,12,1,6,5,10,17,-7,8,16,9
4337,4845,4851,53,16,12,0,6,6,9,23,-14,6,18,6
4338,4845,4851,21,8,12,5,3,4,13,12,1,13,11,18
4339,4845,4851,1,6,12,5,3,4,21,14,7,13,11,18
4340,4943,4949,1,5,24,10,5,9,49,33,16,25,23,35
4341,4943,4949,21,2,24,12,7,5,39,25,14,31,17,43
4342,4943,4949,52,3,24,10,11,3,36,18,18,31,17,41
4343,4943,4949,36,10,24,7,8,9,36,38,-2,22,26,29
4344,4943,4949,48,11,24,7,7,10,29,40,-11,21,27,28
4345,4943,4949,28,16,24,4,10,10,23,41,-18,18,30,22
4346,4943,4949,49,6,24,8,9,7,30,27,3,25,23,33
4347,4943,4949,37,12,24,6,10,8,20,23,-3,22,26,28
4348,4943,4949,41,7,24,8,7,9,36,38,-2,23,25,31
4349,4943,4949,20,8,24,7,10,7,34,42,-8,24,24,31
4350,4943,4949,53,13,24,6,7,11,32,43,-11,19,29,25
4351,4943,4949,17,14,24,4,11,9,26,37,-11,19,29,23
4352,4943,4949,8,15,24,5,7,12,22,46,-24,17,31,22
4353,4943,4949,43,1,24,15,6,3,60,27,33,36,12,51
4354,4943,4949,24,4,24,10,9,5,29,23,6,29,19,39
4355,4943,4949,57,9,24,7,8,9,39,39,0,22,26,29
4356,4761,4767,52,1,3,2,1,0,6,0,6,5,1,7
4357,4761,4767,48,4,3,2,0,1,4,5,-1,4,2,6
4358,4761,4767,36,12,3,0,2,1,4,5,-1,2,4,2
4359,4761,4767,28,13,3,0,2,1,3,4,-1,2,4,2
4360,4761,4767,43,3,3,2,0,1,7,6,1,4,2,6
4361,4761,4767,24,8,3,1,1,1,3,2,1,3,3,4
4362,4761,4767,57,9,3,1,1,1,3,3,0,3,3,4
4363,4761,4767,8,15,3,0,1,2,2,7,-5,1,5,1
4364,4761,4767,21,14,3,0,1,2,0,4,-4,1,5,1
4365,4761,4767,41,6,3,1,2,0,5,4,1,4,2,5
4366,4761,4767,20,16,3,0,1,2,2,9,-7,1,5,1
4367,4761,4767,49,2,3,2,1,0,5,2,3,5,1,7
4368,4761,4767,37,10,3,0,3,0,3,3,0,3,3,3
4369,4761,4767,53,10,3,0,3,0,3,3,0,3,3,3
4370,4761,4767,1,7,3,1,1,1,7,3,4,3,3,4
4371,4761,4767,17,5,3,1,2,0,5,2,3,4,2,5
4372,4775,4781,1,4,5,2,2,1,10,4,6,6,4,8
4373,4775,4781,21,11,5,1,2,2,3,6,-3,4,6,5
4374,4775,4781,17,10,5,1,3,1,7,8,-1,5,5,6
4375,4775,4781,8,13,5,1,1,3,4,11,-7,3,7,4
4376,4775,4781,53,14,5,0,4,1,5,7,-2,4,6,4
4377,4775,4781,52,1,5,3,2,0,11,2,9,8,2,11
4378,4775,4781,48,8,5,2,1,2,5,8,-3,5,5,7
4379,4775,4781,28,15,5,0,3,2,4,8,-4,3,7,3
4380,4775,4781,36,16,5,0,2,3,6,11,-5,2,8,2
4381,4775,4781,41,5,5,2,2,1,10,6,4,6,4,8
4382,4775,4781,20,12,5,1,2,2,5,11,-6,4,6,5
4383,4775,4781,49,2,5,3,1,1,7,4,3,7,3,10
4384,4775,4781,37,9,5,1,3,1,7,5,2,5,5,6
4385,4775,4781,43,3,5,3,0,2,10,7,3,6,4,9
4386,4187,4193,57,5,21,9,5,7,19,17,2,23,19,32
4387,4187,4193,24,6,21,7,8,6,24,16,8,22,20,29
4388,4187,4193,26,14,21,4,10,7,14,22,-8,18,24,22
4389,4187,4193,41,10,21,7,3,11,25,36,-11,17,25,24
4390,4187,4193,20,15,21,5,5,11,24,32,-8,15,27,20
4391,4187,4193,17,9,21,7,4,10,25,35,-10,18,24,25
4392,4187,4193,52,4,21,10,5,6,27,19,8,25,17,35
4393,4187,4193,36,7,21,7,7,7,23,32,-9,21,21,28
4394,4187,4193,28,8,21,7,5,9,22,27,-5,19,23,26
4395,4187,4193,21,11,21,6,6,9,23,23,0,18,24,24
4396,4187,4193,1,1,21,15,4,2,46,16,30,34,8,49
4397,4187,4193,39,12,21,6,6,9,17,32,-15,18,24,24
4398,4236,4242,39,11,27,8,8,11,21,39,-18,24,30,32
4399,4236,4242,1,1,27,17,7,3,51,20,31,41,13,58
4400,4236,4242,52,4,27,12,8,7,35,24,11,32,22,44
4401,4236,4242,28,10,27,8,8,11,26,34,-8,24,30,32
4402,4236,4242,36,12,27,7,9,11,25,43,-18,23,31,30
4403,4236,4242,21,13,27,7,8,12,30,31,-1,22,32,29
4404,4236,4242,17,7,27,10,7,10,35,40,-5,27,27,37
4405,4236,4242,41,8,27,10,3,14,33,46,-13,23,31,33
4406,4236,4242,20,14,27,7,6,14,28,39,-11,20,34,27
4407,4236,4242,43,2,27,17,6,4,59,22,37,40,14,57
4408,4236,4242,57,5,27,11,7,9,27,23,4,29,25,40
4409,4236,4242,24,6,27,9,11,7,31,22,9,29,25,38
4410,4236,4242,26,15,27,5,11,11,16,32,-16,21,33,26
4411,4236,4242,49,3,27,14,11,2,46,17,29,39,15,53
4412,4236,4242,37,16,27,5,5,17,19,45,-26,15,39,20
4413,4236,4242,53,9,27,9,5,13,28,33,-5,23,31,32
4414,4250,4263,53,9,29,10,5,14,30,37,-7,25,33,35
4415,4250,4263,49,3,29,15,11,3,48,18,30,41,17,56
4416,4250,4263,37,16,29,5,6,18,21,51,-30,16,42,21
4417,4250,4263,43,2,29,18,7,4,62,24,38,43,15,61
4418,4250,4263,57,5,29,11,8,10,27,24,3,30,28,41
4419,4250,4263,24,6,29,10,11,8,34,25,9,31,27,41
4420,4250,4263,26,14,29,6,12,11,17,32,-15,24,34,30
4421,4250,4263,41,8,29,11,4,14,35,46,-11,26,32,37
4422,4250,4263,20,15,29,7,7,15,28,41,-13,21,37,28
4423,4250,4263,17,7,29,10,8,11,35,42,-7,28,30,38
4424,4250,4263,21,13,29,7,9,13,31,33,-2,23,35,30
4425,4250,4263,52,4,29,13,9,7,41,27,14,35,23,48
4426,4250,4263,28,10,29,9,8,12,30,37,-7,26,32,35
4427,4250,4263,36,12,29,8,9,12,27,47,-20,25,33,33
4428,4250,4263,1,1,29,18,8,3,56,21,35,44,14,62
4429,4250,4263,39,11,29,9,8,12,23,40,-17,26,32,35
4430,4474,4480,39,13,12,1,6,5,6,15,-9,8,16,9
4431,4474,4480,1,1,12,9,2,1,28,10,18,20,4,29
4432,4474,4480,52,7,12,4,7,1,13,5,8,15,9,19
4433,4474,4480,48,12,12,3,4,5,9,12,-3,10,14,13
4434,4474,4480,28,14,12,1,5,6,6,14,-8,7,17,8
4435,4474,4480,36,16,12,1,2,9,9,26,-17,4,20,5
4436,4474,4480,21,8,12,5,2,5,15,12,3,12,12,17
4437,4474,4480,8,10,12,4,4,4,13,16,-3,12,12,16
4438,4474,4480,49,4,12,6,3,3,18,10,8,15,9,21
4439,4474,4480,17,3,12,6,4,2,21,18,3,16,8,22
4440,4474,4480,41,9,12,4,4,4,9,11,-2,12,12,16
4441,4474,4480,57,5,12,6,3,3,14,13,1,15,9,21
4442,4474,4480,43,6,12,6,2,4,18,13,5,14,10,20
4443,4474,4480,24,11,12,3,5,4,15,16,-1,11,13,14
4444,4474,4480,26,15,12,1,4,7,6,14,-8,6,18,7
4445,4474,4480,53,2,12,7,1,4,20,15,5,15,9,22
4446,4488,4508,53,3,14,8,1,5,22,17,5,17,11,25
4447,4488,4508,43,5,14,6,4,4,21,16,5,16,12,22
4448,4488,4508,57,6,14,6,4,4,15,15,0,16,12,22
4449,4488,4508,24,8,14,5,5,4,18,16,2,15,13,20
4450,4488,4508,26,13,14,2,5,7,9,15,-6,9,19,11
4451,4488,4508,49,2,14,8,3,3,20,10,10,19,9,27
4452,4488,4508,17,7,14,6,4,4,24,26,-2,16,12,22
4453,4488,4508,8,11,14,4,5,5,13,17,-4,13,15,17
4454,4488,4508,21,10,14,5,3,6,17,16,1,13,15,18
4455,4488,4508,52,4,14,5,8,1,18,6,12,18,10,23
4456,4488,4508,48,12,14,4,4,6,10,13,-3,12,16,16
4457,4488,4508,28,14,14,1,6,7,7,17,-10,8,20,9
4458,4488,4508,36,16,14,2,2,10,12,29,-17,6,22,8
4459,4488,4508,41,9,14,5,4,5,12,14,-2,14,14,19
4460,4488,4508,1,1,14,11,2,1,31,10,21,24,4,35
4461,4488,4508,39,15,14,1,6,7,6,18,-12,8,20,9
4462,4831,4837,43,1,10,7,1,2,27,11,16,15,5,22
4463,4831,4837,24,3,10,5,3,2,15,10,5,13,7,18
4464,4222,4235,57,5,26,11,6,9,25,21,4,28,24,39
4465,4222,4235,24,6,26,9,10,7,29,20,9,28,24,37
4466,4222,4235,26,15,26,4,11,11,14,31,-17,19,33,23
4467,4222,4235,17,7,26,10,6,10,34,39,-5,26,26,36
4468,4222,4235,39,13,26,7,8,11,20,39,-19,22,30,29
4469,4481,4487,39,14,13,1,6,6,6,16,-10,8,18,9
4470,4481,4487,43,5,13,6,3,4,20,15,5,15,11,21
4471,4481,4487,57,6,13,6,3,4,15,15,0,15,11,21
4472,4481,4487,24,10,13,4,5,4,16,16,0,13,13,17
4473,4481,4487,26,13,13,2,4,7,9,15,-6,8,18,10
4474,4481,4487,49,3,13,7,3,3,19,10,9,17,9,24
4475,4481,4487,41,8,13,5,4,4,12,13,-1,14,12,19
4476,4481,4487,52,7,13,4,8,1,13,5,8,16,10,20
4477,4481,4487,48,12,13,3,4,6,9,13,-4,10,16,13
4478,4481,4487,28,15,13,1,5,7,6,16,-10,7,19,8
4479,4481,4487,36,16,13,1,2,10,10,29,-19,4,22,5
4480,4481,4487,53,2,13,8,1,4,22,16,6,17,9,25
4481,4481,4487,1,1,13,10,2,1,30,10,20,22,4,32
4482,4481,4487,21,9,13,5,3,5,17,14,3,13,13,18
4483,4481,4487,17,4,13,6,4,3,23,21,2,16,10,22
4484,4481,4487,8,11,13,4,5,4,13,16,-3,13,13,17
4485,4530,4536,17,7,18,7,7,4,25,26,-1,21,15,28
4486,4530,4536,8,12,18,4,7,7,16,24,-8,15,21,19
4487,4530,4536,1,1,18,12,4,2,34,14,20,28,8,40
4488,4530,4536,53,4,18,9,3,6,24,19,5,21,15,30
4489,4530,4536,49,2,18,9,6,3,22,11,11,24,12,33
4490,4530,4536,41,11,18,6,5,7,15,18,-3,17,19,23
4491,4530,4536,21,9,18,7,3,8,23,22,1,17,19,24
4492,4530,4536,43,5,18,8,6,4,28,19,9,22,14,30
4493,4530,4536,24,6,18,8,6,4,26,19,7,22,14,30
4494,4530,4536,57,8,18,7,5,6,22,21,1,19,17,26
4495,4530,4536,26,16,18,2,5,11,9,25,-16,9,27,11
4496,4530,4536,52,3,18,7,10,1,25,7,18,24,12,31
4497,4530,4536,48,10,18,6,6,6,16,15,1,18,18,24
4498,4530,4536,28,13,18,2,8,8,12,23,-11,12,24,14
4499,4530,4536,36,15,18,3,2,13,15,34,-19,8,28,11
4500,4530,4536,39,14,18,2,7,9,8,23,-15,11,25,13
4501,4579,4585,39,14,24,4,8,12,14,31,-17,16,32,20
4502,4579,4585,49,2,24,11,10,3,33,18,15,32,16,43
4503,4579,4585,17,6,24,10,8,6,38,33,5,28,20,38
4504,4579,4585,8,10,24,8,7,9,24,29,-5,23,25,31
4505,4579,4585,41,12,24,7,8,9,22,28,-6,22,26,29
4506,4579,4585,43,3,24,11,8,5,41,23,18,30,18,41
4507,4579,4585,24,7,24,8,12,4,30,23,7,28,20,36
4508,4579,4585,57,11,24,7,9,8,27,31,-4,23,25,30
4509,4579,4585,26,16,24,2,6,16,13,45,-32,10,38,12
4510,4579,4585,53,5,24,11,6,7,30,25,5,28,20,39
4511,4579,4585,52,4,24,9,13,2,35,12,23,31,17,40
4512,4579,4585,48,9,24,8,8,8,20,20,0,24,24,32
4513,4579,4585,28,13,24,4,10,10,20,31,-11,18,30,22
4514,4579,4585,36,15,24,4,3,17,20,47,-27,11,37,15
4515,4579,4585,21,8,24,10,4,10,33,27,6,24,24,34
4516,4579,4585,1,1,24,14,8,2,42,19,23,36,12,50
4517,4586,4592,1,1,25,15,8,2,43,19,24,38,12,53
4518,4586,4592,21,8,25,11,4,10,36,29,7,26,24,37
4519,4586,4592,8,11,25,8,7,10,25,32,-7,23,27,31
4520,4586,4592,52,5,25,9,13,3,36,14,22,31,19,40
4521,4586,4592,48,9,25,9,8,8,22,21,1,26,24,35
4522,4586,4592,28,13,25,4,11,10,20,31,-11,19,31,23
4523,4586,4592,36,15,25,4,4,17,22,49,-27,12,38,16
4524,4586,4592,53,3,25,12,6,7,31,25,6,30,20,42
4525,4586,4592,43,4,25,11,8,6,41,24,17,30,20,41
4526,4586,4592,24,6,25,9,12,4,31,23,8,30,20,39
4527,4586,4592,57,10,25,8,9,8,30,32,-2,25,25,33
4528,4586,4592,26,16,25,2,6,17,15,48,-33,10,40,12
4529,4586,4592,41,12,25,7,8,10,22,29,-7,22,28,29
4530,4586,4592,17,7,25,10,8,7,38,34,4,28,22,38
4531,4586,4592,49,2,25,11,11,3,35,20,15,33,17,44
4532,4586,4592,39,14,25,4,9,12,14,31,-17,17,33,21
4533,4607,4620,39,15,28,4,10,14,16,36,-20,18,38,22
4534,4607,4620,52,4,28,10,15,3,41,15,26,35,21,45
4535,4607,4620,48,8,28,11,8,9,26,25,1,30,26,41
4536,4607,4620,28,13,28,5,12,11,26,37,-11,22,34,27
4537,4607,4620,36,14,28,6,5,17,27,51,-24,17,39,23
4538,4607,4620,49,3,28,11,13,4,38,24,14,35,21,46
4539,4607,4620,24,5,28,10,14,4,35,26,9,34,22,44
4540,4607,4620,43,7,28,11,10,7,43,27,16,32,24,43
4541,4607,4620,57,12,28,8,9,11,30,42,-12,25,31,33
4542,2318,2324,53,10,15,4,3,8,26,32,-6,11,19,15
4543,2339,2345,53,11,18,5,4,9,32,37,-5,14,22,19
4544,2339,2345,1,2,18,12,2,4,38,23,15,26,10,38
4545,2339,2345,21,3,18,9,5,4,25,14,11,23,13,32
4546,2339,2345,7,10,18,4,8,6,24,28,-4,16,20,20
4547,2339,2345,4,12,18,4,6,8,18,30,-12,14,22,18
4548,2339,2345,17,7,18,6,4,8,16,23,-7,16,20,22
4549,2339,2345,8,8,18,5,7,6,30,25,5,17,19,22
4550,2339,2345,49,4,18,9,5,4,31,22,9,23,13,32
4551,2339,2345,41,5,18,9,5,4,23,15,8,23,13,32
4552,2339,2345,20,6,18,6,8,4,14,11,3,20,16,26
4553,2339,2345,30,13,18,5,2,11,20,36,-16,12,24,17
4554,2339,2345,43,1,18,13,4,1,43,7,36,30,6,43
4555,2339,2345,24,14,18,2,11,5,19,26,-7,15,21,17
4556,2339,2345,28,9,18,5,6,7,23,26,-3,16,20,21
4557,2339,2345,52,15,18,3,6,9,19,32,-13,12,24,15
4558,2339,2345,27,16,18,1,9,8,15,35,-20,11,25,12
4559,2346,2352,27,16,19,2,9,8,16,35,-19,13,25,15
4560,2346,2352,28,7,19,6,6,7,24,26,-2,18,20,24
4561,2346,2352,52,15,19,3,6,10,19,36,-17,12,26,15
4562,2346,2352,43,1,19,13,4,2,43,8,35,30,8,43
4563,2346,2352,24,14,19,2,12,5,20,27,-7,16,22,18
4564,2346,2352,41,5,19,9,5,5,23,16,7,23,15,32
4565,2346,2352,20,6,19,6,9,4,14,11,3,21,17,27
4566,2346,2352,30,13,19,5,3,11,20,36,-16,13,25,18
4567,2346,2352,49,3,19,10,5,4,36,23,13,25,13,35
4568,2346,2352,8,8,19,5,8,6,31,26,5,18,20,23
4569,2346,2352,17,10,19,6,4,9,16,24,-8,16,22,22
4570,2346,2352,21,4,19,9,5,5,25,15,10,23,15,32
4571,2346,2352,7,9,19,5,8,6,25,28,-3,18,20,23
4572,2346,2352,4,11,19,5,6,8,19,30,-11,16,22,21
4573,2346,2352,1,2,19,13,2,4,42,23,19,28,10,41
4574,2346,2352,53,12,19,5,4,10,33,42,-9,14,24,19
4575,2661,2681,53,13,13,3,5,5,9,14,-5,11,15,14
4576,2661,2681,1,2,13,8,3,2,25,9,16,19,7,27
4577,2661,2681,7,6,13,6,0,7,19,25,-6,12,14,18
4578,2661,2681,21,16,13,2,4,7,12,22,-10,8,18,10
4579,2661,2681,24,12,13,4,2,7,16,20,-4,10,16,14
4580,2661,2681,17,3,13,8,1,4,29,22,7,17,9,25
4581,2661,2681,8,7,13,5,3,5,22,25,-3,13,13,18
4582,2661,2681,49,4,13,7,4,2,23,16,7,18,8,25
4583,2661,2681,37,5,13,6,2,5,19,20,-1,14,12,20
4584,2661,2681,20,8,13,5,3,5,16,20,-4,13,13,18
4585,2661,2681,41,15,13,3,3,7,15,24,-9,9,17,12
4586,2661,2681,43,1,13,9,2,2,32,13,19,20,6,29
4587,2661,2681,28,10,13,4,4,5,21,20,1,12,14,16
4588,2661,2681,52,11,13,4,3,6,22,23,-1,11,15,15
4589,2661,2681,18,14,13,3,3,7,12,20,-8,9,17,12
4590,2661,2681,27,9,13,5,2,6,21,20,1,12,14,17
4591,2766,2786,27,9,25,9,4,12,30,35,-5,22,28,31
4592,2766,2786,28,8,25,10,6,9,38,33,5,26,24,36
4593,2766,2786,52,11,25,7,8,10,33,37,-4,22,28,29
4594,2766,2786,43,1,25,18,4,3,60,20,40,40,10,58
4595,2766,2786,24,12,25,8,4,13,30,36,-6,20,30,28
4596,2766,2786,20,4,25,11,8,6,34,28,6,30,20,41
4597,2766,2786,41,15,25,6,7,12,27,40,-13,19,31,25
4598,2766,2786,49,3,25,13,7,5,44,29,15,33,17,46
4599,2766,2786,37,13,25,7,7,11,24,33,-9,21,29,28
4600,2766,2786,17,5,25,11,3,11,48,53,-5,25,25,36
4601,2766,2786,8,10,25,9,4,12,37,46,-9,22,28,31
4602,2766,2786,7,6,25,11,3,11,36,44,-8,25,25,36
4603,2766,2786,21,16,25,4,8,13,17,37,-20,16,34,20
4604,2766,2786,1,2,25,14,7,4,44,19,25,35,15,49
4605,2766,2786,18,14,25,7,4,14,23,42,-19,18,32,25
4606,2766,2786,53,7,25,10,6,9,34,27,7,26,24,36
4607,2787,2793,53,8,26,10,6,10,36,30,6,26,26,36
4608,2787,2793,1,2,26,15,7,4,46,19,27,37,15,52
4609,2787,2793,18,15,26,7,4,15,24,45,-21,18,34,25
4610,2787,2793,7,7,26,11,3,12,36,48,-12,25,27,36
4611,2787,2793,21,16,26,5,8,13,20,38,-18,18,34,23
4612,2787,2793,17,6,26,11,3,12,48,55,-7,25,27,36
4613,2787,2793,8,10,26,9,4,13,38,48,-10,22,30,31
4614,2787,2793,49,3,26,14,7,5,48,29,19,35,17,49
4615,2787,2793,37,11,26,8,7,11,27,35,-8,23,29,31
4616,2787,2793,20,4,26,11,8,7,35,31,4,30,22,41
4617,2787,2793,41,14,26,7,7,12,29,40,-11,21,31,28
4618,2787,2793,43,1,26,18,5,3,61,21,40,41,11,59
4619,2787,2793,24,13,26,8,4,14,30,38,-8,20,32,28
4620,4523,4529,1,1,17,11,4,2,33,14,19,26,8,37
4621,4523,4529,17,7,17,7,6,4,25,26,-1,20,14,27
4622,4523,4529,8,12,17,4,7,6,15,22,-7,15,19,19
4623,4523,4529,43,4,17,8,5,4,28,19,9,21,13,29
4624,4523,4529,24,6,17,7,6,4,24,18,6,20,14,27
4625,4523,4529,57,9,17,6,5,6,19,21,-2,17,17,23
4626,4523,4529,26,16,17,2,5,10,9,22,-13,9,25,11
4627,4523,4529,53,3,17,9,3,5,24,18,6,21,13,30
4628,4523,4529,49,2,17,9,5,3,21,10,11,23,11,32
4629,4523,4529,41,11,17,5,5,7,14,18,-4,15,19,20
4630,4523,4529,21,8,17,7,3,7,23,21,2,17,17,24
4631,4523,4529,52,5,17,6,10,1,22,7,15,22,12,28
4632,4523,4529,48,10,17,5,6,6,14,14,0,16,18,21
4633,4523,4529,28,13,17,2,7,8,11,22,-11,11,23,13
4634,4523,4529,36,15,17,3,2,12,14,32,-18,8,26,11
4635,4523,4529,39,14,17,2,7,8,8,20,-12,11,23,13
4636,4537,4543,39,13,19,3,7,9,10,23,-13,13,25,16
4637,4537,4543,21,10,19,7,3,9,23,24,-1,17,21,24
4638,4537,4543,41,11,19,6,6,7,17,20,-3,18,20,24
4639,4537,4543,49,2,19,10,6,3,24,11,13,26,12,36
4640,4537,4543,53,5,19,9,4,6,25,20,5,22,16,31
4641,4537,4543,43,3,19,9,6,4,34,20,14,24,14,33
4642,4537,4543,24,6,19,8,7,4,28,21,7,23,15,31
4643,4537,4543,57,8,19,7,6,6,23,22,1,20,18,27
4644,4537,4543,26,16,19,2,5,12,10,31,-21,9,29,11
4645,4537,4543,17,7,19,7,7,5,26,28,-2,21,17,28
4646,4537,4543,8,12,19,4,7,8,16,26,-10,15,23,19
4647,4537,4543,1,1,19,13,4,2,36,15,21,30,8,43
4648,4537,4543,52,4,19,7,11,1,26,8,18,25,13,32
4649,4537,4543,48,9,19,6,7,6,17,16,1,19,19,25
4650,4537,4543,36,14,19,4,2,13,18,36,-18,10,28,14
4651,4537,4543,28,15,19,2,8,9,14,26,-12,12,26,14
4652,4439,4445,52,10,8,2,5,1,6,3,3,9,7,11
4653,4439,4445,48,12,8,2,3,3,6,7,-1,7,9,9
4654,4439,4445,28,14,8,1,3,4,4,8,-4,5,11,6
4655,4439,4445,36,16,8,0,1,7,6,20,-14,1,15,1
4656,4439,4445,17,3,8,4,2,2,10,9,1,10,6,14
4657,4439,4445,1,1,8,6,2,0,19,6,13,14,2,20
4658,4439,4445,21,4,8,4,1,3,10,6,4,9,7,13
4659,4439,4445,26,13,8,1,4,3,3,5,-2,6,10,7
4660,4439,4445,53,5,8,4,1,3,12,9,3,9,7,13
4661,4439,4445,49,7,8,3,3,2,8,6,2,9,7,12
4662,4439,4445,41,8,8,3,3,2,6,5,1,9,7,12
4663,4439,4445,8,11,8,2,4,2,7,9,-2,8,8,10
4664,4439,4445,43,2,8,5,1,2,14,7,7,11,5,16
4665,4439,4445,24,6,8,3,3,2,13,10,3,9,7,12
4666,4439,4445,57,9,8,3,2,3,6,11,-5,8,8,11
4667,4439,4445,39,15,8,0,4,4,4,13,-9,4,12,4
4668,4852,4858,17,11,13,3,5,5,15,20,-5,11,15,14
4669,4852,4858,8,13,13,3,3,7,11,26,-15,9,17,12
4670,4852,4858,20,3,13,6,5,2,20,19,1,17,9,23
4671,4852,4858,41,9,13,4,5,4,20,18,2,13,13,17
4672,4852,4858,49,5,13,6,3,4,17,15,2,15,11,21
4673,4852,4858,37,6,13,5,6,2,16,10,6,16,10,21
4674,4852,4858,53,16,13,1,6,6,10,23,-13,8,18,9
4675,4852,4858,43,1,13,9,2,2,33,13,20,20,6,29
4676,4852,4858,24,7,13,5,6,2,16,11,5,16,10,21
4677,4852,4858,57,10,13,4,3,6,21,24,-3,11,15,15
4678,4852,4858,21,8,13,5,3,5,14,15,-1,13,13,18
4679,4852,4858,1,4,13,6,3,4,26,14,12,15,11,21
4680,4852,4858,52,2,13,6,6,1,21,7,14,18,8,24
4681,4852,4858,48,12,13,3,3,7,13,24,-11,9,17,12
4682,4852,4858,36,14,13,2,4,7,16,23,-7,8,18,10
4683,4852,4858,28,15,13,1,7,5,10,17,-7,9,17,10
4684,5167,5173,52,2,11,6,5,0,22,9,13,17,5,23
4685,5167,5173,48,15,11,2,6,3,9,10,-1,10,12,12
4686,5167,5173,36,19,11,0,5,6,5,19,-14,5,17,5
4687,5167,5173,1,4,11,5,4,2,21,12,9,14,8,19
4688,5167,5173,18,17,11,2,5,4,11,20,-9,9,13,11
4689,5167,5173,17,5,11,5,3,3,18,12,6,13,9,18
4690,5167,5173,8,16,11,3,2,6,10,19,-9,8,14,11
4691,5167,5173,21,3,11,6,2,3,15,9,6,14,8,20
4692,5167,5173,43,1,11,6,5,0,27,6,21,17,5,23
4693,5167,5173,57,8,11,4,5,2,14,13,1,13,9,17
4694,5167,5173,24,10,11,4,4,3,11,9,2,12,10,16
4695,5167,5173,22,20,11,0,2,9,7,28,-21,2,20,2
4696,5167,5173,53,6,11,5,3,3,17,12,5,13,9,18
4697,5167,5173,12,7,11,5,2,4,20,22,-2,12,10,17
4698,5167,5173,49,9,11,4,4,3,19,15,4,12,10,16
4699,5167,5173,5,11,11,4,4,3,20,19,1,12,10,16
4700,4831,4837,20,4,10,5,3,2,17,17,0,13,7,18
4701,4831,4837,41,8,10,4,3,3,19,16,3,11,9,15
4702,4831,4837,21,9,10,4,3,3,11,8,3,11,9,15
4703,4831,4837,52,2,10,5,5,0,18,6,12,15,5,20
4704,4831,4837,48,12,10,2,2,6,10,23,-13,6,14,8
4705,4831,4837,28,14,10,1,5,4,9,15,-6,7,13,8
4706,4831,4837,36,15,10,1,4,5,12,16,-4,6,14,7
4707,4831,4837,1,7,10,4,3,3,17,10,7,11,9,15
4708,4831,4837,17,11,10,2,4,4,10,15,-5,8,12,10
4709,4831,4837,8,13,10,2,2,6,6,19,-13,6,14,8
4710,4831,4837,57,10,10,3,3,4,15,15,0,9,11,12
4711,4831,4837,49,5,10,5,2,3,13,10,3,12,8,17
4712,4831,4837,37,6,10,4,5,1,14,8,6,13,7,17
4713,4831,4837,53,16,10,0,4,6,8,22,-14,4,16,4
4714,4887,4893,53,13,17,4,6,7,22,29,-7,14,20,18
4715,4887,4893,49,5,17,7,5,5,22,21,1,19,15,26
4716,4887,4893,37,6,17,5,9,3,19,15,4,19,15,24
4717,4887,4893,43,1,17,11,4,2,41,17,24,26,8,37
4718,4887,4893,24,8,17,5,8,4,19,17,2,18,16,23
4719,4887,4893,57,12,17,5,4,8,27,31,-4,14,20,19
4720,4887,4893,20,4,17,7,6,4,27,30,-3,20,14,27
4721,4887,4893,41,7,17,6,5,6,28,26,2,17,17,23
4722,4887,4893,17,11,17,4,8,5,24,27,-3,16,18,20
4723,4887,4893,8,14,17,4,4,9,14,33,-19,12,22,16
4724,4887,4893,1,9,17,6,4,7,29,24,5,16,18,22
4725,4887,4893,21,3,17,8,4,5,27,19,8,20,14,28
4726,4887,4893,52,2,17,8,7,2,27,12,15,23,11,31
4727,4887,4893,48,10,17,5,5,7,23,30,-7,15,19,20
4728,4887,4893,36,15,17,3,6,8,25,32,-7,12,22,15
4729,4887,4893,28,16,17,1,9,7,15,26,-11,11,23,12
4730,4950,4956,20,8,25,7,11,7,35,43,-8,25,25,32
4731,4950,4956,21,2,25,12,8,5,40,26,14,32,18,44
4732,4950,4956,52,3,25,11,11,3,39,18,21,33,17,44
4733,4950,4956,36,10,25,7,8,10,36,41,-5,22,28,29
4734,4950,4956,48,11,25,7,8,10,29,40,-11,22,28,29
4735,4950,4956,28,14,25,5,10,10,24,41,-17,20,30,25
4736,4950,4956,17,15,25,4,12,9,27,38,-11,20,30,24
4737,4950,4956,8,16,25,5,8,12,22,46,-24,18,32,23
4738,4950,4956,49,7,25,8,9,8,30,28,2,25,25,33
4739,4950,4956,37,12,25,6,11,8,20,23,-3,23,27,29
4740,4950,4956,41,6,25,9,7,9,39,39,0,25,25,34
4741,4950,4956,43,1,25,15,6,4,61,30,31,36,14,51
4742,4950,4956,24,4,25,10,9,6,31,28,3,29,21,39
4743,4950,4956,57,9,25,7,9,9,39,39,0,23,27,30
4744,4950,4956,53,13,25,6,8,11,33,44,-11,20,30,26
4745,4950,4956,1,5,25,11,5,9,54,35,19,27,23,38
4746,5188,5194,1,6,14,6,5,3,25,15,10,17,11,23
4747,5188,5194,18,12,14,4,6,4,17,24,-7,14,14,18
4748,5188,5194,27,13,14,4,5,5,14,21,-7,13,15,17
4749,5188,5194,53,3,14,7,3,4,21,14,7,17,11,24
4750,5188,5194,12,10,14,5,3,6,22,28,-6,13,15,18
4751,5188,5194,43,2,14,7,6,1,29,8,21,20,8,27
4752,5188,5194,57,5,14,6,6,2,18,15,3,18,10,24
4753,5188,5194,24,8,14,5,5,4,12,10,2,15,13,20
4754,5188,5194,22,20,14,1,4,9,14,32,-18,6,22,7
4755,5188,5194,49,9,14,5,4,5,22,18,4,14,14,19
4756,5188,5194,5,11,14,4,6,4,26,28,-2,14,14,18
4757,5188,5194,37,16,14,3,6,5,13,14,-1,12,16,15
4758,5188,5194,17,7,14,6,3,5,21,18,3,15,13,21
4759,5188,5194,8,15,14,4,3,7,13,20,-7,11,17,15
4760,5188,5194,52,1,14,8,6,0,33,12,21,22,6,30
4761,5188,5194,48,14,14,3,7,4,11,12,-1,13,15,16
4762,5188,5194,36,19,14,1,5,8,7,29,-22,7,21,8
4763,5188,5194,21,4,14,7,3,4,19,13,6,17,11,24
4764,5188,5194,20,18,14,2,7,5,14,16,-2,11,17,13
4765,5188,5194,41,17,14,3,5,6,14,18,-4,11,17,14
4766,5251,5257,20,17,21,5,7,9,20,26,-6,17,25,22
4767,5251,5257,41,18,21,5,6,10,21,28,-7,16,26,21
4768,5251,5257,21,5,21,10,7,4,34,20,14,27,15,37
4769,5251,5257,52,1,21,13,8,0,54,21,33,34,8,47
4770,5251,5257,48,16,21,4,11,6,16,19,-3,19,23,23
4771,5251,5257,36,19,21,4,6,11,15,38,-23,14,28,18
4772,5251,5257,17,7,21,9,3,9,30,33,-3,21,21,30
4773,5251,5257,8,11,21,6,6,9,23,31,-8,18,24,24
4774,5251,5257,43,3,21,10,9,2,38,14,24,29,13,39
4775,5251,5257,57,9,21,7,8,6,23,25,-2,22,20,29
4776,5251,5257,24,10,21,6,8,7,14,17,-3,20,22,26
4777,5251,5257,22,20,21,1,8,12,18,42,-24,10,32,11
4778,5251,5257,49,2,21,12,4,5,37,19,18,28,14,40
4779,4019,4025,37,12,1,0,0,1,0,1,-1,0,2,0
4780,4019,4025,53,7,1,0,1,0,1,1,0,1,1,1
4781,4019,4025,1,2,1,1,0,0,3,1,2,2,0,3
4782,4166,4172,1,1,18,14,4,0,45,14,31,32,4,46
4783,4166,4172,21,10,18,5,6,7,21,20,1,16,20,21
4784,4166,4172,41,9,18,6,3,9,18,32,-14,15,21,21
4785,4166,4172,20,16,18,3,4,11,20,31,-11,10,26,13
4786,4166,4172,49,3,18,10,6,2,32,11,21,26,10,36
4787,4166,4172,37,15,18,4,3,11,14,31,-17,11,25,15
4788,4166,4172,53,14,18,4,4,10,15,26,-11,12,24,16
4789,4166,4172,17,12,18,5,4,9,20,31,-11,14,22,19
4790,4166,4172,52,4,18,9,4,5,25,17,8,22,14,31
4791,4166,4172,28,7,18,6,5,7,18,19,-1,17,19,23
4792,4166,4172,36,11,18,5,6,7,18,29,-11,16,20,21
4793,4166,4172,43,2,18,11,4,3,40,18,22,26,10,37
4794,4166,4172,57,5,18,8,4,6,16,14,2,20,16,28
4795,4166,4172,24,6,18,7,6,5,22,13,9,20,16,27
4796,4166,4172,26,13,18,4,7,7,12,20,-8,15,21,19
4797,4166,4172,39,8,18,6,4,8,16,26,-10,16,20,22
4798,4208,4214,39,12,24,7,7,10,18,34,-16,21,27,28
4799,4208,4214,43,3,24,14,6,4,51,21,30,34,14,48
4800,4208,4214,57,5,24,10,6,8,22,19,3,26,22,36
4801,4208,4214,24,6,24,9,9,6,27,16,11,27,21,36
4802,4208,4214,26,14,24,4,10,10,14,30,-16,18,30,22
4803,4208,4214,52,4,24,10,7,7,28,21,7,27,21,37
4804,4208,4214,28,9,24,8,6,10,24,31,-7,22,26,30
4805,4208,4214,36,10,24,7,9,8,24,35,-11,23,25,30
4806,4208,4214,17,7,24,9,5,10,32,38,-6,23,25,32
4807,4208,4214,53,13,24,7,5,12,20,30,-10,19,29,26
4808,4208,4214,21,11,24,7,7,10,28,26,2,21,27,28
4809,4208,4214,41,8,24,9,3,12,31,39,-8,21,27,30
4810,4208,4214,20,15,24,5,6,13,24,38,-14,16,32,21
4811,4208,4214,49,2,24,14,8,2,42,13,29,36,12,50
4812,4208,4214,37,16,24,4,5,15,16,40,-24,13,35,17
4813,4208,4214,1,1,24,16,5,3,48,18,30,37,11,53
4814,4565,4571,1,1,22,13,7,2,40,19,21,33,11,46
4815,4565,4571,53,5,22,10,5,7,29,25,4,25,19,35
4816,4565,4571,52,4,22,8,12,2,32,12,20,28,16,36
4817,4565,4571,48,9,22,7,8,7,19,18,1,22,22,29
4818,4565,4571,28,14,22,3,9,10,17,30,-13,15,29,18
4819,4565,4571,36,15,22,4,2,16,20,45,-25,10,34,14
4820,4565,4571,41,11,22,7,8,7,21,23,-2,22,22,29
4821,4565,4571,49,2,22,10,9,3,28,15,13,29,15,39
4822,4565,4571,21,8,22,9,4,9,30,26,4,22,22,31
4823,4565,4571,17,7,22,8,8,6,30,33,-3,24,20,32
4824,4565,4571,8,12,22,7,7,8,22,27,-5,21,23,28
4825,4565,4571,43,3,22,10,7,5,39,23,16,27,17,37
4826,4565,4571,24,6,22,8,10,4,29,22,7,26,18,34
4827,4565,4571,57,10,22,7,8,7,25,26,-1,22,22,29
4828,4565,4571,26,16,22,2,6,14,12,36,-24,10,34,12
4829,4565,4571,39,13,22,4,8,10,14,27,-13,16,28,20
4830,4600,4606,39,14,27,4,10,13,16,35,-19,18,36,22
4831,4600,4606,43,5,27,11,10,6,42,25,17,32,22,43
4832,4600,4606,24,6,27,9,14,4,34,26,8,32,22,41
4833,4600,4606,48,9,27,10,8,9,24,24,0,28,26,38
4834,4600,4606,28,13,27,5,12,10,23,33,-10,22,32,27
4835,4600,4606,36,15,27,5,5,17,25,50,-25,15,39,20
4836,4600,4606,57,11,27,8,9,10,30,38,-8,25,29,33
4837,4600,4606,26,16,27,2,7,18,16,51,-35,11,43,13
4838,4600,4606,21,7,27,12,4,11,40,34,6,28,26,40
4839,4600,4606,49,3,27,11,13,3,37,22,15,35,19,46
4840,4600,4606,41,10,27,8,9,10,28,32,-4,25,29,33
4841,4600,4606,52,4,27,10,14,3,41,15,26,34,20,44
4842,4600,4606,53,2,27,13,7,7,35,26,9,33,21,46
4843,4600,4606,1,1,27,16,9,2,46,20,26,41,13,57
4844,4600,4606,17,8,27,10,9,8,39,36,3,29,25,39
4845,4600,4606,8,12,27,8,8,11,26,35,-9,24,30,32
4846,4964,4977,1,4,27,12,5,10,57,39,18,29,25,41
4847,4964,4977,41,5,27,11,7,9,42,39,3,29,25,40
4848,4964,4977,20,10,27,7,11,9,35,45,-10,25,29,32
4849,4964,4977,49,7,27,9,10,8,33,29,4,28,26,37
4850,4964,4977,37,12,27,6,13,8,21,24,-3,25,29,31
4851,4964,4977,21,2,27,13,8,6,41,28,13,34,20,47
4852,4964,4977,53,13,27,7,9,11,34,44,-10,23,31,30
4853,4964,4977,17,15,27,5,12,10,31,43,-12,22,32,27
4854,4964,4977,8,16,27,6,8,13,23,47,-24,20,34,26
4855,4964,4977,52,3,27,11,12,4,42,22,20,34,20,45
4856,4964,4977,36,9,27,8,9,10,40,44,-4,25,29,33
4857,2787,2793,28,5,26,11,6,9,41,34,7,28,24,39
4858,2787,2793,52,12,26,7,9,10,34,38,-4,23,29,30
4859,2787,2793,27,9,26,10,4,12,32,36,-4,24,28,34
4860,2808,2814,27,8,29,11,5,13,33,38,-5,27,31,38
4861,2808,2814,28,5,29,13,6,10,47,38,9,32,26,45
4862,2808,2814,52,13,29,8,9,12,39,44,-5,25,33,33
4863,2808,2814,43,1,29,19,6,4,65,24,41,44,14,63
4864,2808,2814,20,4,29,13,8,8,38,34,4,34,24,47
4865,2808,2814,41,11,29,9,7,13,31,41,-10,25,33,34
4866,2808,2814,24,14,29,9,5,15,32,40,-8,23,35,32
4867,2808,2814,49,3,29,15,8,6,52,31,21,38,20,53
4868,2808,2814,37,12,29,9,7,13,30,40,-10,25,33,34
4869,2808,2814,17,6,29,12,3,14,50,61,-11,27,31,39
4870,2808,2814,8,9,29,11,4,14,42,49,-7,26,32,37
4871,2808,2814,1,2,29,18,7,4,52,21,31,43,15,61
4872,2808,2814,18,15,29,8,4,17,28,50,-22,20,38,28
4873,2808,2814,7,10,29,11,4,14,36,51,-15,26,32,37
4874,2808,2814,21,16,29,6,9,14,23,40,-17,21,37,27
4875,2808,2814,53,7,29,11,6,12,39,35,4,28,30,39
4876,2997,3003,53,7,10,4,2,4,21,19,2,10,10,14
4877,2997,3003,1,3,10,5,2,3,15,10,5,12,8,17
4878,2997,3003,17,5,10,3,6,1,18,12,6,12,8,15
4879,2997,3003,8,9,10,3,3,4,12,16,-4,9,11,12
4880,2997,3003,4,13,10,2,4,4,11,15,-4,8,12,10
4881,2997,3003,7,15,10,2,3,5,10,19,-9,7,13,9
4882,2997,3003,49,2,10,6,2,2,22,9,13,14,6,20
4883,2997,3003,37,10,10,2,5,3,19,18,1,9,11,11
4884,2997,3003,20,8,10,3,3,4,16,20,-4,9,11,12
4885,2997,3003,41,12,10,3,1,6,14,22,-8,7,13,10
4886,2997,3003,43,4,10,3,6,1,24,12,12,12,8,15
4887,2997,3003,24,16,10,2,3,5,13,25,-12,7,13,9
4888,2997,3003,28,6,10,3,6,1,17,12,5,12,8,15
4889,2997,3003,52,11,10,2,5,3,14,19,-5,9,11,11
4890,2997,3003,27,1,10,7,1,2,18,10,8,15,5,22
4891,2997,3003,39,14,10,2,4,4,11,17,-6,8,12,10
4892,3102,3108,27,2,21,12,3,6,35,23,12,27,15,39
4893,3102,3108,39,14,21,4,8,9,19,31,-12,16,26,20
4894,3102,3108,28,10,21,6,9,6,29,32,-3,21,21,27
4895,3102,3108,52,12,21,6,6,9,22,29,-7,18,24,24
4896,3102,3108,43,4,21,9,8,4,45,24,21,26,16,35
4897,3102,3108,24,15,21,4,5,12,22,41,-19,13,29,17
4898,3102,3108,20,8,21,8,4,9,35,35,0,20,22,28
4899,3102,3108,41,13,21,6,4,11,24,35,-11,16,26,22
4900,3102,3108,49,1,21,13,5,3,42,13,29,31,11,44
4901,3102,3108,37,6,21,8,6,7,30,32,-2,22,20,30
4902,3102,3108,4,11,21,6,9,6,21,24,-3,21,21,27
4903,3102,3108,7,16,21,3,4,14,17,41,-24,10,32,13
4904,3102,3108,17,5,21,9,8,4,37,27,10,26,16,35
4905,3102,3108,8,7,21,8,6,7,23,28,-5,22,20,30
4906,3102,3108,1,3,21,11,6,4,40,21,19,28,14,39
4907,3102,3108,53,9,21,8,3,10,33,38,-5,19,23,27
4908,2948,2954,53,6,4,2,0,2,5,8,-3,4,4,6
4909,2948,2954,8,5,4,2,0,2,6,8,-2,4,4,6
4910,2948,2954,17,8,4,1,2,1,9,6,3,4,4,5
4911,2948,2954,4,15,4,0,2,2,2,6,-4,2,6,2
4912,2948,2954,7,16,4,0,2,2,4,9,-5,2,6,2
4913,2948,2954,49,2,4,3,0,1,12,3,9,6,2,9
4914,2948,2954,37,9,4,1,2,1,9,8,1,4,4,5
4915,2948,2954,41,13,4,1,1,2,5,12,-7,3,5,4
4916,2948,2954,20,14,4,1,0,3,5,10,-5,2,6,3
4917,2948,2954,43,4,4,2,1,1,15,4,11,5,3,7
4918,2948,2954,24,11,4,1,1,2,6,8,-2,3,5,4
4919,2948,2954,28,7,4,1,3,0,7,4,3,5,3,6
4920,2948,2954,52,12,4,1,1,2,5,11,-6,3,5,4
4921,2948,2954,27,1,4,3,1,0,8,2,6,7,1,10
4922,2948,2954,39,10,4,1,2,1,3,6,-3,4,4,5
4923,2948,2954,1,3,4,3,0,1,9,5,4,6,2,9
4924,2983,2989,27,1,8,6,1,1,16,7,9,13,3,19
4925,2983,2989,39,16,8,1,3,4,8,16,-8,5,11,6
4926,2983,2989,28,9,8,2,5,1,13,10,3,9,7,11
4927,2983,2989,52,11,8,2,3,3,13,18,-5,7,9,9
4928,2983,2989,43,4,8,3,4,1,23,11,12,10,6,13
4929,2983,2989,24,12,8,2,2,4,10,16,-6,6,10,8
4930,2983,2989,20,6,8,3,2,3,13,16,-3,8,8,11
4931,2983,2989,41,13,8,2,1,5,10,20,-10,5,11,7
4932,2983,2989,49,2,8,6,0,2,22,9,13,12,4,18
4933,2983,2989,37,10,8,2,4,2,18,15,3,8,8,10
4934,2983,2989,4,14,8,1,3,4,8,13,-5,5,11,6
4935,2983,2989,7,15,8,1,3,4,9,15,-6,5,11,6
4936,2983,2989,8,5,8,3,2,3,11,13,-2,8,8,11
4937,5167,5173,37,14,11,2,6,3,9,9,0,10,12,12
4938,5167,5173,41,13,11,3,3,5,10,12,-2,9,13,12
4939,5167,5173,20,18,11,1,6,4,10,14,-4,8,14,9
4940,5167,5173,27,12,11,3,4,4,12,18,-6,10,12,13
4941,5202,5215,27,9,16,6,5,5,18,21,-3,17,15,23
4942,5202,5215,49,6,16,7,4,5,26,19,7,18,14,25
4943,5202,5215,37,12,16,4,7,5,15,14,1,15,17,19
4944,5202,5215,5,13,16,4,7,5,29,32,-3,15,17,19
4945,5202,5215,20,17,16,3,7,6,16,18,-2,13,19,16
4946,5202,5215,41,18,16,3,6,7,14,19,-5,12,20,15
4947,5202,5215,53,3,16,8,4,4,24,16,8,20,12,28
4948,5202,5215,12,11,16,5,5,6,23,29,-6,15,17,20
4949,5202,5215,43,4,16,7,7,2,30,11,19,21,11,28
4950,5202,5215,57,8,16,6,6,4,18,20,-2,18,14,24
4951,5202,5215,24,10,16,5,7,4,12,10,2,17,15,22
4952,5202,5215,22,19,16,1,6,9,15,33,-18,8,24,9
4953,5202,5215,21,5,16,7,5,4,22,16,6,19,13,26
4954,5202,5215,17,7,16,7,3,6,23,20,3,17,15,24
4955,5202,5215,8,16,16,4,4,8,16,24,-8,12,20,16
4956,5202,5215,1,2,16,8,5,3,30,16,14,21,11,29
4957,5202,5215,18,14,16,4,7,5,17,26,-9,15,17,19
4958,5202,5215,52,1,16,9,7,0,39,15,24,25,7,34
4959,5202,5215,48,15,16,3,8,5,11,14,-3,14,18,17
4960,5202,5215,36,20,16,1,6,9,9,34,-25,8,24,9
4961,5321,5323,48,15,30,6,13,11,25,36,-11,25,35,31
4962,5321,5323,36,18,30,7,7,16,21,52,-31,21,39,28
4963,5321,5323,52,1,30,19,10,1,74,28,46,48,12,67
4964,5321,5323,18,17,30,6,11,13,26,57,-31,23,37,29
4965,5321,5323,17,5,30,16,4,10,44,39,5,36,24,52
4966,5321,5323,8,13,30,9,8,13,37,45,-8,26,34,35
4967,5321,5323,1,3,30,16,8,6,59,25,34,40,20,56
4968,5321,5323,21,6,30,15,7,8,55,28,27,37,23,52
4969,5321,5323,37,11,30,9,10,11,24,29,-5,28,32,37
4970,5321,5323,5,19,30,6,9,15,45,65,-20,21,39,27
4971,5321,5323,49,4,30,16,6,8,50,29,21,38,22,54
4972,5321,5323,43,2,30,16,11,3,59,16,43,43,17,59
4973,5321,5323,57,9,30,9,11,10,31,35,-4,29,31,38
4974,5321,5323,24,16,30,7,9,14,17,30,-13,23,37,30
4975,5321,5323,22,20,30,1,10,19,21,63,-42,12,48,13
4976,5321,5323,53,7,30,15,7,8,44,28,16,37,23,52
4977,5321,5323,12,8,30,11,10,9,41,41,0,32,28,43
4978,5321,5323,20,10,30,9,10,11,30,35,-5,28,32,37
4979,5321,5323,41,14,30,9,7,14,34,41,-7,25,35,34
4980,5321,5323,27,12,30,9,10,11,31,46,-15,28,32,37
4981,5118,5124,27,11,5,2,1,2,6,7,-1,5,5,7
4982,5118,5124,41,6,5,2,2,1,5,4,1,6,4,8
4983,5118,5124,20,17,5,0,4,1,5,6,-1,4,6,4
4984,5118,5124,5,9,5,2,1,2,5,4,1,5,5,7
4985,5118,5124,37,13,5,1,4,0,5,2,3,6,4,7
4986,5118,5124,49,16,5,1,2,2,8,10,-2,4,6,5
4987,5118,5124,53,3,5,3,0,2,5,4,1,6,4,9
4988,5118,5124,12,12,5,2,1,2,8,12,-4,5,5,7
4989,5118,5124,43,4,5,2,3,0,11,3,8,7,3,9
4990,5118,5124,57,8,5,2,2,1,6,6,0,6,4,8
4991,5118,5124,24,10,5,2,1,2,5,5,0,5,5,7
4992,5118,5124,22,20,5,0,1,4,3,10,-7,1,9,1
4993,5118,5124,21,2,5,3,0,2,9,7,2,6,4,9
4994,5118,5124,1,7,5,2,2,1,8,8,0,6,4,8
4995,5118,5124,18,15,5,1,3,1,4,4,0,5,5,6
4996,5118,5124,17,1,5,3,1,1,7,3,4,7,3,10
4997,5118,5124,8,18,5,1,0,4,5,10,-5,2,8,3
4998,5118,5124,52,5,5,2,3,0,9,5,4,7,3,9
4999,5118,5124,48,14,5,1,3,1,5,3,2,5,5,6
5000,5118,5124,36,19,5,0,2,3,2,8,-6,2,8,2
5001,5650,5663,52,6,24,12,6,6,39,23,16,30,18,42
5002,5650,5663,48,18,25,2,10,13,16,42,-26,14,36,16
5003,5650,5663,54,19,24,4,4,16,12,45,-33,12,36,16
5004,5650,5663,20,4,25,11,9,5,45,26,19,31,19,42
5005,5650,5663,41,10,24,9,7,8,42,41,1,25,23,34
5006,5650,5663,17,5,25,13,4,8,48,31,17,30,20,43
5007,5650,5663,8,17,25,5,7,13,19,41,-22,17,33,22
5008,5650,5663,1,1,25,15,6,4,51,23,28,36,14,51
5009,5650,5663,21,8,25,10,9,6,29,30,-1,29,21,39
5010,5650,5663,37,7,25,10,10,5,27,13,14,30,20,40
5011,5650,5663,49,9,24,10,7,7,34,30,4,27,21,37
5012,5650,5663,5,13,24,6,9,9,30,36,-6,21,27,27
5013,5650,5663,43,2,24,13,6,5,48,28,20,32,16,45
5014,5650,5663,57,12,25,7,10,8,35,38,-3,24,26,31
5015,5650,5663,24,15,25,5,8,12,27,42,-15,18,32,23
5016,5650,5663,40,16,25,4,10,11,26,44,-18,18,32,22
5017,4775,4781,57,6,5,2,2,1,7,5,2,6,4,8
5018,4775,4781,24,6,5,2,2,1,7,5,2,6,4,8
5019,4796,4816,43,1,8,5,1,2,21,11,10,11,5,16
5020,4796,4816,24,3,8,4,3,1,13,8,5,11,5,15
5021,4796,4816,57,9,8,2,3,3,12,13,-1,7,9,9
5022,4796,4816,49,4,8,4,1,3,10,9,1,9,7,13
5023,4796,4816,37,5,8,3,4,1,11,7,4,10,6,13
5024,4796,4816,41,7,8,3,3,2,17,12,5,9,7,12
5025,4796,4816,20,8,8,3,3,2,12,16,-4,9,7,12
5026,4796,4816,52,2,8,4,4,0,17,6,11,12,4,16
5027,4796,4816,48,12,8,2,2,4,9,17,-8,6,10,8
5028,4796,4816,28,13,8,1,5,2,8,10,-2,7,9,8
5029,4796,4816,36,15,8,1,3,4,12,15,-3,5,11,6
5030,4796,4816,53,16,8,0,4,4,7,16,-9,4,12,4
5031,4796,4816,17,11,8,2,3,3,10,14,-4,7,9,9
5032,4796,4816,8,14,8,2,1,5,6,17,-11,5,11,7
5033,4796,4816,21,10,8,2,3,3,7,8,-1,7,9,9
5034,4796,4816,1,6,8,3,3,2,15,8,7,9,7,12
5035,5223,5236,1,3,18,9,5,4,36,19,17,23,13,32
5036,5223,5236,18,13,18,5,7,6,20,31,-11,17,19,22
5037,5223,5236,17,8,18,7,3,8,24,28,-4,17,19,24
5038,5223,5236,8,17,18,4,5,9,16,27,-11,13,23,17
5039,5223,5236,20,15,18,4,7,7,17,20,-3,15,21,19
5040,5223,5236,41,18,18,3,6,9,14,24,-10,12,24,15
5041,5223,5236,49,6,18,9,4,5,31,19,12,22,14,31
5042,5223,5236,5,11,18,5,8,5,33,33,0,18,18,23
5043,5223,5236,37,14,18,4,8,6,15,17,-2,16,20,20
5044,5223,5236,21,4,18,9,5,4,29,19,10,23,13,32
5045,5223,5236,53,2,18,10,4,4,30,16,14,24,12,34
5046,5223,5236,12,10,18,6,5,7,25,31,-6,17,19,23
5047,5223,5236,52,1,18,11,7,0,47,17,30,29,7,40
5048,5223,5236,48,16,18,3,9,6,13,17,-4,15,21,18
5049,5223,5236,36,19,18,2,6,10,10,35,-25,10,26,12
5050,5223,5236,43,5,18,8,8,2,34,13,21,24,12,32
5051,5223,5236,57,7,18,6,8,4,18,20,-2,20,16,26
5052,5223,5236,24,12,18,5,8,5,12,12,0,18,18,23
5053,5223,5236,22,20,18,1,7,10,16,37,-21,9,27,10
5054,5223,5236,27,9,18,6,6,6,20,25,-5,18,18,24
5055,5517,5523,27,18,10,1,3,6,7,15,-8,5,15,6
5056,5517,5523,43,8,9,4,3,2,15,10,5,11,7,15
5057,5517,5523,57,12,9,2,4,3,13,12,1,8,10,10
5058,5517,5523,40,14,10,1,5,4,10,15,-5,7,13,8
5059,5517,5523,24,17,9,0,5,4,8,15,-7,5,13,5
5060,5517,5523,17,3,10,6,1,3,22,11,11,13,7,19
5061,5517,5523,8,19,9,1,1,7,7,25,-18,3,15,4
5062,5517,5523,12,2,10,7,0,3,20,12,8,14,6,21
5063,5517,5523,53,10,9,4,2,3,15,15,0,10,8,14
5064,5517,5523,37,6,10,4,4,2,12,5,7,12,8,16
5065,5517,5523,49,9,10,4,3,3,10,8,2,11,9,15
5066,5517,5523,5,13,10,1,6,3,10,12,-2,8,12,9
5067,5517,5523,20,1,9,5,4,0,16,5,11,14,4,19
5068,5517,5523,41,11,10,4,2,4,17,19,-2,10,10,14
5069,5517,5523,21,4,10,5,3,2,15,15,0,13,7,18
5070,5517,5523,1,7,9,4,3,2,17,11,6,11,7,15
5071,5517,5523,52,5,9,5,2,2,18,10,8,12,6,17
5072,5517,5523,54,15,9,3,1,5,6,16,-10,7,11,10
5073,5517,5523,48,16,9,1,4,4,6,13,-7,6,12,7
5074,5615,5621,52,4,19,11,4,4,36,19,17,26,12,37
5075,5615,5621,48,18,20,2,7,11,13,35,-22,11,29,13
5076,5615,5621,54,19,19,4,2,13,10,37,-27,10,28,14
5077,5615,5621,37,5,20,8,8,4,23,10,13,24,16,32
5078,5615,5621,49,8,20,9,5,6,28,23,5,23,17,32
5079,5615,5621,5,13,20,4,8,8,24,30,-6,16,24,20
5080,5615,5621,21,10,20,8,6,6,23,27,-4,22,18,30
5081,5615,5621,17,6,20,10,3,7,38,27,11,23,17,33
5082,5615,5621,8,15,20,5,4,11,15,34,-19,14,26,19
5083,5615,5621,12,3,20,12,2,6,40,23,17,26,14,38
5084,5615,5621,53,9,20,8,6,6,32,32,0,22,18,30
5085,5615,5621,20,7,20,8,7,5,32,23,9,23,17,31
5086,5615,5621,41,12,20,7,6,7,34,36,-2,20,20,27
5087,5615,5621,43,2,20,12,4,4,42,24,18,28,12,40
5088,5615,5621,57,11,20,6,9,5,29,28,1,21,19,27
5089,5615,5621,24,14,20,4,7,9,24,32,-8,15,25,19
5090,5615,5621,40,17,20,2,9,9,16,32,-16,13,27,15
5091,5615,5621,27,16,20,4,5,11,24,32,-8,13,27,17
5092,5615,5621,1,1,20,12,4,4,41,20,21,28,12,40
5093,5681,5684,1,1,29,18,6,5,60,26,34,42,16,60
5094,5681,5684,27,17,28,6,7,15,35,52,-17,19,37,25
5095,5681,5684,43,5,28,14,7,7,49,32,17,35,21,49
5096,5681,5684,57,12,29,8,12,9,37,39,-2,28,30,36
5097,4607,4620,26,16,28,2,7,19,17,53,-36,11,45,13
5098,4607,4620,21,6,28,13,4,11,42,35,7,30,26,43
5099,4607,4620,41,10,28,9,9,10,31,32,-1,27,29,36
5100,4607,4620,53,2,28,14,7,7,39,26,13,35,21,49
5101,4607,4620,17,9,28,10,9,9,39,39,0,29,27,39
5102,4607,4620,8,11,28,8,9,11,26,35,-9,25,31,33
5103,4607,4620,1,1,28,17,9,2,50,23,27,43,13,60
5104,4628,4731,1,1,30,17,11,2,53,26,27,45,15,62
5105,4628,4731,17,9,30,10,11,9,43,43,0,31,29,41
5106,4628,4731,8,12,30,8,10,12,28,39,-11,26,34,34
5107,4628,4731,53,2,30,14,8,8,40,33,7,36,24,50
5108,4628,4731,41,10,30,9,11,10,34,35,-1,29,31,38
5109,4628,4731,21,7,30,13,5,12,43,38,5,31,29,44
5110,4628,4731,43,5,30,12,10,8,47,30,17,34,26,46
5111,4628,4731,24,6,30,10,16,4,37,28,9,36,24,46
5112,4628,4731,57,11,30,9,10,11,33,44,-11,28,32,37
5113,4628,4731,26,16,30,3,7,20,20,56,-36,13,47,16
5114,4628,4731,49,3,30,12,14,4,45,25,20,38,22,50
5115,4628,4731,52,4,30,10,17,3,45,19,26,37,23,47
5116,4628,4731,48,8,30,11,9,10,28,28,0,31,29,42
5117,4628,4731,28,13,30,6,13,11,31,41,-10,25,35,31
5118,4628,4731,36,14,30,8,5,17,30,51,-21,21,39,29
5119,4628,4731,39,15,30,4,11,15,17,38,-21,19,41,23
5120,4432,4438,39,15,7,0,4,3,4,10,-6,4,10,4
5121,4432,4438,43,2,7,4,1,2,10,7,3,9,5,13
5122,4432,4438,24,5,7,3,2,2,11,8,3,8,6,11
5123,4432,4438,57,12,7,2,2,3,5,11,-6,6,8,8
5124,4432,4438,26,13,7,1,4,2,3,4,-1,6,8,7
5125,4432,4438,49,4,7,3,3,1,8,5,3,9,5,12
5126,4432,4438,41,6,7,3,2,2,6,5,1,8,6,11
5127,4432,4438,52,9,7,2,4,1,6,3,3,8,6,10
5128,4432,4438,48,10,7,2,3,2,6,6,0,7,7,9
5129,4432,4438,28,14,7,1,2,4,2,6,-4,4,10,5
5130,4432,4438,36,16,7,0,1,6,6,16,-10,1,13,1
5131,4432,4438,53,3,7,4,0,3,12,9,3,8,6,12
5132,4432,4438,17,7,7,3,2,2,9,9,0,8,6,11
5133,4432,4438,8,11,7,2,3,2,7,9,-2,7,7,9
5134,4432,4438,1,1,7,5,2,0,16,6,10,12,2,17
5135,4432,4438,21,8,7,3,1,3,9,6,3,7,7,10
5136,4838,4844,21,9,11,4,3,4,12,12,0,11,11,15
5137,4838,4844,1,5,11,5,3,3,21,12,9,13,9,18
5138,4838,4844,53,16,11,0,5,6,9,23,-14,5,17,5
5139,4838,4844,28,14,11,1,6,4,10,16,-6,8,14,9
5140,4838,4844,36,15,11,1,4,6,12,19,-7,6,16,7
5141,4838,4844,20,4,11,5,4,2,18,18,0,14,8,19
5142,4838,4844,41,8,11,4,4,3,20,17,3,12,10,16
5143,4838,4844,43,1,11,7,2,2,28,12,16,16,6,23
5144,4838,4844,24,3,11,5,4,2,16,11,5,14,8,19
5145,4838,4844,57,10,11,3,3,5,15,18,-3,9,13,12
5146,4838,4844,52,2,11,6,5,0,21,6,15,17,5,23
5147,4838,4844,48,11,11,3,2,6,13,23,-10,8,14,11
5148,4838,4844,8,12,11,3,2,6,10,20,-10,8,14,11
5149,4838,4844,17,13,11,2,5,4,11,16,-5,9,13,11
5150,4838,4844,37,6,11,4,6,1,15,9,6,14,8,18
5151,4838,4844,49,7,11,5,2,4,15,14,1,12,10,17
5152,4929,4935,17,14,22,4,10,8,25,35,-10,18,26,22
5153,4929,4935,8,15,22,4,7,11,19,40,-21,15,29,19
5154,4929,4935,49,8,22,7,8,7,25,27,-2,22,22,29
5155,4929,4935,37,11,22,5,10,7,19,21,-2,20,24,25
5156,4929,4935,43,1,22,14,6,2,53,22,31,34,10,48
5157,4929,4935,24,4,22,9,9,4,28,21,7,27,17,36
5158,4929,4935,57,10,22,6,8,8,33,35,-2,20,24,26
5159,4929,4935,41,6,22,8,7,7,36,32,4,23,21,31
5160,4929,4935,20,7,22,7,9,6,33,40,-7,23,21,30
5161,4929,4935,52,3,22,9,10,3,34,18,16,28,16,37
5162,4929,4935,48,9,22,7,7,8,27,35,-8,21,23,28
5163,4929,4935,36,13,22,5,8,9,33,37,-4,18,26,23
5164,4929,4935,28,16,22,2,10,10,20,41,-21,14,30,16
5165,4929,4935,53,12,22,6,6,10,29,36,-7,18,26,24
5166,4929,4935,1,5,22,9,5,8,44,30,14,23,21,32
5167,4929,4935,21,2,22,11,6,5,34,22,12,28,16,39
5168,4936,4942,21,2,23,11,7,5,35,23,12,29,17,40
5169,4936,4942,1,5,23,10,5,8,48,31,17,25,21,35
5170,4936,4942,53,12,23,6,7,10,30,37,-7,19,27,25
5171,4936,4942,52,4,23,9,11,3,34,18,16,29,17,38
5172,4936,4942,48,9,23,7,7,9,27,36,-9,21,25,28
5173,4936,4942,36,10,23,6,8,9,34,37,-3,20,26,26
5174,4936,4942,28,16,23,3,10,10,22,41,-19,16,30,19
5175,4936,4942,41,6,23,8,7,8,36,33,3,23,23,31
5176,2003,2009,57,16,23,3,5,15,15,39,-24,11,35,14
5177,2003,2009,28,4,23,14,2,7,32,24,8,30,16,44
5178,2003,2009,52,11,23,7,5,11,27,34,-7,19,27,26
5179,2003,2009,48,15,23,4,7,12,21,41,-20,15,31,19
5180,2003,2009,49,2,23,13,6,4,35,15,20,32,14,45
5181,2003,2009,17,12,23,5,9,9,20,31,-11,19,27,24
5182,2003,2009,8,14,23,6,4,13,26,40,-14,16,30,22
5183,2003,2009,41,7,23,8,6,9,37,33,4,22,24,30
5184,2003,2009,30,9,23,7,9,7,23,31,-8,23,23,30
5185,2003,2009,53,3,23,13,6,4,33,21,12,32,14,45
5186,2003,2009,4,6,23,8,7,8,36,45,-9,23,23,31
5187,2003,2009,21,8,23,8,6,9,32,32,0,22,24,30
5188,2003,2009,7,13,23,6,5,12,20,27,-7,17,29,23
5189,2003,2009,1,10,23,6,10,7,34,30,4,22,24,28
5190,2017,2023,1,9,25,7,11,7,39,32,7,25,25,32
5191,2017,2023,4,6,25,9,8,8,40,48,-8,26,24,35
5192,2017,2023,21,7,25,9,7,9,36,33,3,25,25,34
5193,2017,2023,7,12,25,6,6,13,20,28,-8,18,32,24
5194,2017,2023,53,4,25,14,7,4,38,25,13,35,15,49
5195,2017,2023,41,8,25,9,6,10,40,36,4,24,26,33
5196,2017,2023,30,10,25,7,10,8,25,34,-9,24,26,31
5197,2017,2023,17,13,25,5,9,11,21,36,-15,19,31,24
5198,2017,2023,8,14,25,6,5,14,26,44,-18,17,33,23
5199,2017,2023,49,2,25,15,6,4,41,16,25,36,14,51
5200,2017,2023,28,3,25,16,2,7,37,25,12,34,16,50
5201,2017,2023,52,11,25,7,6,12,28,38,-10,20,30,27
5202,2017,2023,48,15,25,4,8,13,21,44,-23,16,34,20
5203,2017,2023,43,1,25,18,4,3,67,15,52,40,10,58
5204,2017,2023,24,5,25,12,5,8,28,28,0,29,21,41
5205,2017,2023,57,16,25,3,6,16,16,41,-25,12,38,15
5206,2073,2079,43,1,29,20,5,4,76,18,58,45,13,65
5207,2073,2079,24,5,29,13,6,10,34,38,-4,32,26,45
5208,2073,2079,57,15,29,5,6,18,19,49,-30,16,42,21
5209,2073,2079,28,2,29,18,3,8,43,29,14,39,19,57
5210,2073,2079,52,11,29,8,8,13,33,43,-10,24,34,32
5211,2073,2079,48,16,29,4,9,16,24,52,-28,17,41,21
5212,2073,2079,49,3,29,16,7,6,46,23,23,39,19,55
5213,2073,2079,17,12,29,7,10,12,26,40,-14,24,34,31
5214,2073,2079,8,14,29,7,6,16,28,49,-21,20,38,27
5215,2073,2079,41,8,29,11,7,11,52,42,10,29,29,40
5216,2073,2079,30,9,29,9,11,9,30,37,-7,29,29,38
5217,2073,2079,53,4,29,14,9,6,40,29,11,37,21,51
5218,2073,2079,4,7,29,11,8,10,47,57,-10,30,28,41
5219,2073,2079,21,10,29,10,7,12,41,43,-2,27,31,37
5220,2073,2079,7,13,29,7,9,13,25,31,-6,23,35,30
5221,2073,2079,1,6,29,11,11,7,52,36,16,33,25,44
5222,2213,2219,1,5,4,2,0,2,9,7,2,4,4,6
5223,2213,2219,27,12,4,0,4,0,3,3,0,4,4,4
5224,2213,2219,21,1,4,3,1,0,8,3,5,7,1,10
5225,2213,2219,7,10,4,1,2,1,5,6,-1,4,4,5
5226,2213,2219,4,14,4,0,3,1,5,7,-2,3,5,3
5227,2213,2219,53,3,4,2,1,1,7,4,3,5,3,7
5228,2213,2219,41,4,4,2,1,1,4,4,0,5,3,7
5229,2213,2219,30,7,4,2,0,2,7,10,-3,4,4,6
5230,2213,2219,20,9,4,1,2,1,5,5,0,4,4,5
5231,2213,2219,8,2,4,3,0,1,13,6,7,6,2,9
5232,2213,2219,17,16,4,0,1,3,2,7,-5,1,7,1
5233,2213,2219,49,6,4,2,0,2,9,8,1,4,4,6
5234,2213,2219,28,11,4,1,1,2,6,7,-1,3,5,4
5235,2213,2219,52,13,4,1,0,3,4,7,-3,2,6,3
5236,2213,2219,43,8,4,1,3,0,5,4,1,5,3,6
5237,2213,2219,24,15,4,0,3,1,4,8,-4,3,5,3
5238,2710,2716,28,10,18,6,5,7,26,27,-1,17,19,23
5239,2710,2716,52,12,18,5,5,8,26,30,-4,15,21,20
5240,2710,2716,49,3,18,9,6,3,31,20,11,24,12,33
5241,2710,2716,37,8,18,7,5,6,23,23,0,19,17,26
5242,2710,2716,17,4,18,9,2,7,39,39,0,20,16,29
5243,2710,2716,8,5,18,8,3,7,32,32,0,19,17,27
5244,2710,2716,20,7,18,7,6,5,23,21,2,20,16,27
5245,2710,2716,41,13,18,4,5,9,16,28,-12,13,23,17
5246,2710,2716,43,1,18,13,2,3,43,14,29,28,8,41
5247,2710,2716,24,14,18,4,3,11,17,27,-10,11,25,15
5248,2710,2716,53,6,18,7,6,5,21,16,5,20,16,27
5249,2710,2716,7,9,18,8,1,9,25,32,-7,17,19,25
5250,2710,2716,21,16,18,3,5,10,14,30,-16,11,25,14
5251,2710,2716,1,2,18,12,4,2,34,11,23,28,8,40
5252,2710,2716,18,15,18,4,3,11,15,30,-15,11,25,15
5253,2710,2716,27,11,18,6,3,9,22,27,-5,15,21,21
5254,2717,2723,1,2,19,12,4,3,34,12,22,28,10,40
5255,5251,5257,5,13,21,5,8,8,34,38,-4,18,24,23
5256,5251,5257,37,14,21,5,8,8,17,21,-4,18,24,23
5257,5251,5257,53,4,21,11,4,6,34,21,13,26,16,37
5258,5251,5257,12,8,21,8,6,7,31,32,-1,22,20,30
5259,5251,5257,27,12,21,6,6,9,21,36,-15,18,24,24
5260,5251,5257,1,6,21,9,7,5,38,22,16,25,17,34
5261,5251,5257,18,15,21,5,8,8,21,36,-15,18,24,23
5262,5314,5320,27,10,29,9,9,11,30,45,-15,27,31,36
5263,5314,5320,53,7,29,14,7,8,42,28,14,35,23,49
5264,5314,5320,12,8,29,11,10,8,41,39,2,32,26,43
5265,5314,5320,43,2,29,15,11,3,57,16,41,41,17,56
5266,5314,5320,57,9,29,9,11,9,31,33,-2,29,29,38
5267,5314,5320,24,18,29,6,9,14,15,30,-15,21,37,27
5268,5314,5320,22,20,29,1,10,18,21,61,-40,12,46,13
5269,5314,5320,17,6,29,15,4,10,43,39,4,34,24,49
5270,5314,5320,8,11,29,9,8,12,37,44,-7,26,32,35
5271,5314,5320,1,3,29,15,8,6,57,25,32,38,20,53
5272,5314,5320,18,16,29,6,11,12,26,55,-29,23,35,29
5273,5314,5320,49,5,29,15,6,8,45,27,18,36,22,51
5274,5314,5320,37,13,29,8,10,11,22,29,-7,26,32,34
5275,5314,5320,5,19,29,6,9,14,43,60,-17,21,37,27
5276,5314,5320,52,1,29,18,10,1,72,28,44,46,12,64
5277,5314,5320,48,15,29,6,13,10,25,35,-10,25,33,31
5278,5314,5320,36,17,29,7,7,15,21,50,-29,21,37,28
5279,5314,5320,20,12,29,8,10,11,29,35,-6,26,32,34
5280,5314,5320,41,14,29,9,6,14,33,40,-7,24,34,33
5281,5314,5320,21,4,29,15,7,7,55,26,29,37,21,52
5282,5363,5460,22,20,38,5,13,20,30,69,-39,23,53,28
5283,5363,5460,20,9,38,13,13,12,48,42,6,39,37,52
5284,5363,5460,41,10,38,14,7,17,48,53,-5,35,41,49
5285,5363,5460,21,2,38,22,8,8,75,29,46,52,24,74
5286,5363,5460,49,6,38,18,8,12,59,42,17,44,32,62
5287,5363,5460,37,12,38,11,12,15,28,41,-13,34,42,45
5288,5363,5460,5,16,38,9,12,17,60,81,-21,30,46,39
5289,5363,5460,17,7,38,18,6,14,52,52,0,42,34,60
5290,5363,5460,8,13,38,11,11,16,45,55,-10,33,43,44
5291,5363,5460,43,3,38,19,14,5,72,25,47,52,24,71
5292,5363,5460,57,11,38,12,13,13,37,43,-6,37,39,49
5293,5363,5460,24,17,38,9,10,19,25,47,-22,28,48,37
5294,5363,5460,53,5,38,19,10,9,58,34,24,48,28,67
5295,5363,5460,27,14,38,10,13,15,44,60,-16,33,43,43
5296,5363,5460,52,1,38,25,11,2,92,39,53,61,15,86
5297,5363,5460,48,15,38,8,16,14,34,47,-13,32,44,40
5298,5363,5460,36,18,38,8,7,23,32,70,-38,23,53,31
5299,5363,5460,1,4,38,19,11,8,79,34,45,49,27,68
5300,5363,5460,18,19,38,6,11,21,29,87,-58,23,53,29
5301,5363,5460,12,8,38,15,12,11,51,48,3,42,34,57
5302,5111,5117,1,12,4,1,2,1,4,6,-2,4,4,5
5303,5111,5117,18,18,4,0,3,1,2,3,-1,3,5,3
5304,5111,5117,27,5,4,2,1,1,5,4,1,5,3,7
5305,5111,5117,53,8,4,2,0,2,3,4,-1,4,4,6
5306,5111,5117,12,15,4,1,1,2,6,11,-5,3,5,4
5307,5111,5117,43,2,4,2,2,0,10,2,8,6,2,8
5308,5111,5117,24,6,4,2,1,1,4,3,1,5,3,7
5309,5111,5117,57,11,4,1,2,1,5,6,-1,4,4,5
5310,5111,5117,22,20,4,0,1,3,2,8,-6,1,7,1
5311,5111,5117,17,4,4,2,1,1,4,2,2,5,3,7
5312,5111,5117,8,17,4,1,0,3,3,6,-3,2,6,3
5313,5111,5117,37,9,4,1,3,0,5,2,3,5,3,6
5314,5111,5117,5,13,4,1,1,2,3,3,0,3,5,4
5315,5111,5117,49,14,4,1,1,2,5,7,-2,3,5,4
5316,5111,5117,21,1,4,3,0,1,9,5,4,6,2,9
5317,5111,5117,52,3,4,2,2,0,6,2,4,6,2,8
5318,5111,5117,48,10,4,1,2,1,5,3,2,4,4,5
5319,5111,5117,36,19,4,0,2,2,2,7,-5,2,6,2
5320,5111,5117,41,6,4,2,1,1,4,3,1,5,3,7
5321,5111,5117,20,16,4,0,4,0,4,4,0,4,4,4
5322,5699,5705,20,5,32,14,11,7,53,34,19,39,25,53
5323,5699,5705,41,12,32,10,9,13,50,58,-8,29,35,39
5324,5699,5705,52,4,32,15,10,7,52,27,25,40,24,55
5325,5699,5705,48,18,33,4,10,19,21,54,-33,18,48,22
5326,5699,5705,54,19,32,5,6,21,21,59,-38,16,48,21
5327,5699,5705,21,10,32,10,12,10,34,44,-10,32,32,42
5328,5699,5705,37,6,32,13,13,6,34,20,14,39,25,52
5329,5699,5705,49,9,32,14,8,10,50,41,9,36,28,50
5330,5699,5705,5,14,32,9,9,14,37,55,-18,27,37,36
5331,5699,5705,17,8,32,14,8,10,56,40,16,36,28,50
5332,5699,5705,8,16,32,7,9,16,25,48,-23,23,41,30
5333,5699,5705,43,2,32,17,8,7,60,34,26,42,22,59
5334,2556,2562,17,12,1,0,0,1,0,1,-1,0,2,0
5335,2556,2562,8,14,1,0,0,1,1,3,-2,0,2,0
5336,2556,2562,1,1,1,1,0,0,4,1,3,2,0,3
5337,2556,2562,18,14,1,0,0,1,1,3,-2,0,2,0
5338,2556,2562,53,12,1,0,0,1,0,1,-1,0,2,0
5339,2556,2562,27,5,1,1,0,0,1,0,1,2,0,3
5340,2563,2569,27,10,2,1,0,1,1,2,-1,2,2,3
5341,2563,2569,53,12,2,0,1,1,1,2,-1,1,3,1
5342,2563,2569,1,2,2,2,0,0,6,1,5,4,0,6
5343,2563,2569,18,13,2,0,1,1,1,3,-2,1,3,1
5344,2563,2569,21,11,2,0,1,1,2,3,-1,1,3,1
5345,2563,2569,7,16,2,0,0,2,1,6,-5,0,4,0
5346,2563,2569,17,6,2,1,0,1,5,3,2,2,2,3
5347,2563,2569,8,7,2,1,0,1,5,5,0,2,2,3
5348,2563,2569,37,4,2,1,1,0,3,1,2,3,1,4
5349,2563,2569,49,8,2,1,0,1,3,3,0,2,2,3
5350,2563,2569,41,4,2,1,1,0,3,1,2,3,1,4
5351,2563,2569,20,9,2,1,0,1,3,4,-1,2,2,3
5352,2563,2569,52,14,2,0,1,1,3,6,-3,1,3,1
5353,2563,2569,28,15,2,0,1,1,2,6,-4,1,3,1
5354,2563,2569,43,1,2,2,0,0,8,3,5,4,0,6
5355,2563,2569,24,3,2,1,1,0,4,2,2,3,1,4
5356,2738,2744,43,1,21,15,3,3,49,17,32,33,9,48
5357,2738,2744,24,15,21,5,3,13,21,33,-12,13,29,18
5358,2738,2744,28,10,21,7,6,8,30,31,-1,20,22,27
5359,2738,2744,52,12,21,6,6,9,29,33,-4,18,24,24
5360,2738,2744,20,4,21,9,7,5,29,24,5,25,17,34
5361,2738,2744,41,14,21,4,7,10,21,34,-13,15,27,19
5362,2738,2744,7,8,21,9,2,10,33,41,-8,20,22,29
5363,2738,2744,21,16,21,3,7,11,15,33,-18,13,29,16
5364,2738,2744,49,3,21,10,7,4,37,24,13,27,15,37
5365,2738,2744,37,11,21,7,6,8,24,28,-4,20,22,27
5366,2738,2744,17,6,21,10,2,9,45,47,-2,22,20,32
5367,2738,2744,8,7,21,9,4,8,34,35,-1,22,20,31
5368,2738,2744,53,5,21,9,6,6,28,20,8,24,18,33
5369,2738,2744,1,2,21,13,5,3,38,14,24,31,11,44
5370,2738,2744,18,13,21,5,4,12,19,34,-15,14,28,19
5371,2738,2744,27,9,21,8,3,10,25,29,-4,19,23,27
5372,2570,2576,27,13,3,1,0,2,2,5,-3,2,4,3
5373,2570,2576,1,3,3,2,0,1,7,3,4,4,2,6
5374,2570,2576,18,16,3,0,1,2,2,6,-4,1,5,1
5375,2570,2576,7,12,3,1,0,2,6,8,-2,2,4,3
5376,2570,2576,21,15,3,0,1,2,4,8,-4,1,5,1
5377,2570,2576,53,14,3,0,2,1,1,2,-1,2,4,2
5378,2570,2576,17,5,3,1,1,1,7,5,2,3,3,4
5379,2570,2576,8,7,3,1,1,1,6,6,0,3,3,4
5380,2570,2576,37,2,3,2,1,0,5,2,3,5,1,7
5381,2570,2576,49,8,3,1,1,1,5,5,0,3,3,4
5382,2570,2576,41,4,3,1,2,0,4,2,2,4,2,5
5383,2570,2576,20,10,3,1,1,1,3,4,-1,3,3,4
5384,2570,2576,52,9,3,1,1,1,6,7,-1,3,3,4
5385,2570,2576,28,11,3,1,1,1,4,7,-3,3,3,4
5386,2570,2576,43,1,3,3,0,0,11,4,7,6,0,9
5387,2570,2576,24,6,3,1,1,1,5,4,1,3,3,4
5388,3123,3129,28,6,24,9,9,6,36,35,1,27,21,36
5389,3123,3129,52,13,24,7,7,10,25,32,-7,21,27,28
5390,3123,3129,20,10,24,8,4,12,36,41,-5,20,28,28
5391,3123,3129,41,12,24,8,4,12,27,40,-13,20,28,28
5392,3123,3129,4,9,24,7,11,6,25,27,-2,25,23,32
5393,3123,3129,7,16,24,4,4,16,21,52,-31,12,36,16
5394,3123,3129,49,1,24,15,6,3,51,15,36,36,12,51
5395,3123,3129,37,7,24,9,7,8,34,36,-2,25,23,34
5396,3123,3129,43,5,24,11,8,5,51,28,23,30,18,41
5397,3123,3129,24,15,24,4,6,14,24,46,-22,14,34,18
5398,3123,3129,17,4,24,11,9,4,41,27,14,31,17,42
5399,3123,3129,8,8,24,9,6,9,25,32,-7,24,24,33
5400,3123,3129,53,11,24,8,4,12,34,42,-8,20,28,28
5401,3123,3129,1,3,24,12,7,5,50,25,25,31,17,43
5402,3123,3129,27,2,24,14,3,7,39,26,13,31,17,45
5403,3123,3129,39,14,24,4,9,11,20,35,-15,17,31,21
5404,3158,3164,27,2,28,17,4,7,42,26,16,38,18,55
5405,3158,3164,39,11,28,8,9,11,28,38,-10,25,31,33
5406,3158,3164,1,4,28,13,8,7,54,31,23,34,22,47
5407,3158,3164,4,12,28,7,12,9,28,35,-7,26,30,33
5408,3158,3164,7,15,28,5,5,18,25,58,-33,15,41,20
5409,3158,3164,53,13,28,8,6,14,36,46,-10,22,34,30
5410,3158,3164,28,7,28,9,11,8,38,41,-3,29,27,38
5411,3158,3164,52,14,28,7,9,12,28,38,-10,23,33,30
5412,3158,3164,17,3,28,13,9,6,47,33,14,35,21,48
5413,3158,3164,8,9,28,9,9,10,30,38,-8,27,29,36
5414,3158,3164,41,8,28,11,4,13,33,43,-10,26,30,37
5415,4936,4942,20,7,23,7,10,6,34,41,-7,24,22,31
5416,4936,4942,43,1,23,14,6,3,54,25,29,34,12,48
5417,4936,4942,24,3,23,10,9,4,29,21,8,29,17,39
5418,4936,4942,57,11,23,6,8,9,34,39,-5,20,26,26
5419,4936,4942,49,8,23,7,9,7,25,27,-2,23,23,30
5420,4936,4942,37,13,23,5,10,8,19,23,-4,20,26,25
5421,4936,4942,17,14,23,4,11,8,26,36,-10,19,27,23
5422,4936,4942,8,15,23,5,7,11,22,41,-19,17,29,22
5423,4978,4984,8,14,28,7,8,13,25,48,-23,22,34,29
5424,4978,4984,17,16,28,5,12,11,31,48,-17,22,34,27
5425,4978,4984,49,6,28,10,10,8,38,29,9,30,26,40
5426,4978,4984,37,10,28,7,13,8,23,25,-2,27,29,34
5427,4978,4984,43,1,28,16,6,6,66,35,31,38,18,54
5428,4978,4984,24,7,28,10,10,8,32,31,1,30,26,40
5429,4978,4984,41,5,28,11,8,9,42,39,3,30,26,41
5430,4978,4984,20,11,28,7,11,10,36,47,-11,25,31,32
5431,4978,4984,52,3,28,12,12,4,46,24,22,36,20,48
5432,4978,4984,36,9,28,8,10,10,41,45,-4,26,30,34
5433,4978,4984,48,12,28,7,11,10,31,42,-11,25,31,32
5434,4978,4984,28,15,28,6,10,12,29,48,-19,22,34,28
5435,4978,4984,53,13,28,7,10,11,34,44,-10,24,32,31
5436,4978,4984,57,8,28,8,10,10,45,45,0,26,30,34
5437,4978,4984,1,4,28,12,5,11,58,41,17,29,27,41
5438,4978,4984,21,2,28,14,8,6,43,29,14,36,20,50
5439,4992,5096,8,8,30,9,8,13,29,48,-19,26,34,35
5440,4992,5096,17,15,30,6,13,11,35,51,-16,25,35,31
5441,4992,5096,1,5,30,13,6,11,61,43,18,32,28,45
5442,4992,5096,21,2,30,15,9,6,48,33,15,39,21,54
5443,4992,5096,53,12,30,8,10,12,36,47,-11,26,34,34
5444,4992,5096,52,3,30,13,13,4,50,25,25,39,21,52
5445,4992,5096,36,11,30,8,10,12,44,51,-7,26,34,34
5446,4992,5096,48,14,30,7,12,11,33,45,-12,26,34,33
5447,4992,5096,28,16,30,6,11,13,30,50,-20,23,37,29
5448,4992,5096,41,6,30,11,9,10,42,42,0,31,29,42
5449,4992,5096,20,10,30,8,11,11,38,49,-11,27,33,35
5450,4992,5096,43,1,30,17,7,6,72,38,34,41,19,58
5451,4992,5096,24,7,30,10,11,9,34,35,-1,31,29,41
5452,4992,5096,57,9,30,8,11,11,46,48,-2,27,33,35
5453,4992,5096,49,4,30,12,10,8,43,30,13,34,26,46
5454,4992,5096,37,13,30,7,13,10,24,30,-6,27,33,34
5455,5244,5250,5,12,20,5,8,7,34,37,-3,18,22,23
5456,5244,5250,37,17,20,4,8,8,15,20,-5,16,24,20
5457,5244,5250,43,4,20,9,9,2,36,14,22,27,13,36
5458,5244,5250,57,8,20,7,8,5,23,23,0,22,18,29
5459,5244,5250,24,10,20,6,8,6,14,16,-2,20,20,26
5460,5244,5250,22,20,20,1,8,11,17,40,-23,10,30,11
5461,5244,5250,21,3,20,10,6,4,34,20,14,26,14,36
5462,5244,5250,20,14,20,5,7,8,19,23,-4,17,23,22
5463,5244,5250,41,15,20,5,6,9,20,24,-4,16,24,21
5464,5244,5250,48,18,20,3,11,6,15,19,-4,17,23,20
5465,5244,5250,36,19,20,3,6,11,13,37,-24,12,28,15
5466,5244,5250,52,1,20,12,8,0,51,20,31,32,8,44
5467,5244,5250,53,5,20,10,4,6,33,21,12,24,16,34
5468,5244,5250,12,7,20,8,5,7,31,32,-1,21,19,29
5469,5244,5250,49,2,20,11,4,5,36,19,17,26,14,37
5470,5244,5250,18,13,20,5,8,7,20,34,-14,18,22,23
5471,5244,5250,8,16,20,5,6,9,21,31,-10,16,24,21
5472,5244,5250,17,9,20,8,3,9,26,32,-6,19,21,27
5473,5244,5250,27,11,20,6,6,8,21,34,-13,18,22,24
5474,5244,5250,1,6,20,9,7,4,38,21,17,25,15,34
5475,5328,5334,27,13,32,9,11,12,32,50,-18,29,35,38
5476,5328,5334,17,6,32,17,5,10,45,39,6,39,25,56
5477,5328,5334,8,14,32,9,9,14,40,49,-9,27,37,36
5478,5328,5334,1,5,32,16,9,7,61,28,33,41,23,57
5479,5328,5334,18,19,32,6,11,15,26,61,-35,23,41,29
5480,5328,5334,49,4,32,17,6,9,53,32,21,40,24,57
5481,5328,5334,37,11,32,9,11,12,24,30,-6,29,35,38
5482,5328,5334,5,18,32,7,10,15,48,67,-19,24,40,31
5483,5328,5334,53,7,32,15,8,9,45,30,15,38,26,53
5484,5328,5334,12,8,32,12,10,10,44,44,0,34,30,46
5485,5328,5334,21,3,32,17,7,8,60,28,32,41,23,58
5486,5328,5334,43,2,32,17,11,4,60,17,43,45,19,62
5487,5328,5334,57,9,32,11,11,10,35,37,-2,33,31,44
5488,5328,5334,24,15,32,8,9,15,22,33,-11,25,39,33
5489,5328,5334,22,20,32,2,11,19,24,64,-40,15,49,17
5490,5328,5334,41,10,32,11,7,14,38,43,-5,29,35,40
5491,5328,5334,20,12,32,9,11,12,32,39,-7,29,35,38
5492,5328,5334,52,1,32,20,10,2,77,31,46,50,14,70
5493,5699,5705,57,11,33,9,13,11,40,44,-4,31,35,40
5494,5699,5705,24,13,33,9,9,15,41,56,-15,27,39,36
5495,5699,5705,40,15,32,6,14,12,37,54,-17,26,38,32
5496,5699,5705,12,3,32,19,4,9,57,31,26,42,22,61
5497,5699,5705,53,7,32,15,8,9,53,48,5,38,26,53
5498,5699,5705,27,17,32,7,8,17,43,60,-17,22,42,29
5499,5699,5705,1,1,33,21,7,5,74,31,43,49,17,70
5500,5853,5859,1,2,1,1,0,0,2,0,2,2,0,3
5501,5853,5859,27,3,1,1,0,0,2,1,1,2,0,3
5502,5853,5859,53,1,1,1,0,0,6,2,4,2,0,3
5503,5853,5859,12,5,1,1,0,0,1,0,1,2,0,3
5504,5853,5859,24,5,1,1,0,0,1,0,1,2,0,3
5505,5853,5859,57,7,1,0,1,0,1,1,0,1,1,1
5506,5853,5859,8,13,1,0,0,1,1,2,-1,0,2,0
5507,5853,5859,17,18,1,0,0,1,2,6,-4,0,2,0
5508,5853,5859,49,11,1,0,1,0,0,0,0,1,1,1
5509,5853,5859,37,13,1,0,0,1,1,2,-1,0,2,0
5510,5853,5859,5,15,1,0,0,1,0,1,-1,0,2,0
5511,5853,5859,52,11,1,0,1,0,0,0,0,1,1,1
5512,5853,5859,41,7,1,0,1,0,1,1,0,1,1,1
5513,5853,5859,56,7,1,0,1,0,1,1,0,1,1,1
5514,5853,5859,20,17,1,0,0,1,0,2,-2,0,2,0
5515,5853,5859,21,3,1,1,0,0,2,1,1,2,0,3
5516,5853,5859,43,7,1,0,1,0,1,1,0,1,1,1
5517,5853,5859,22,15,1,0,0,1,0,1,-1,0,2,0
5518,6042,6055,43,3,26,14,6,6,55,31,24,34,18,48
5519,6042,6055,57,8,26,10,8,8,48,39,9,28,24,38
5520,6042,6055,22,13,26,7,8,11,29,33,-4,22,30,29
5521,6042,6055,24,16,26,5,7,14,28,47,-19,17,35,22
5522,6042,6055,20,11,26,9,6,11,37,35,2,24,28,33
5523,6042,6055,56,12,26,8,9,9,33,37,-4,25,27,33
5524,6042,6055,41,17,26,5,5,16,19,59,-40,15,37,20
5525,6042,6055,21,6,26,11,8,7,34,33,1,30,22,41
5526,6042,6055,49,5,26,11,8,7,32,21,11,30,22,41
5527,6042,6055,37,10,26,9,8,9,26,30,-4,26,26,35
5528,6042,6055,5,18,26,4,6,16,30,54,-24,14,38,18
5529,6042,6055,17,9,26,10,5,11,33,34,-1,25,27,35
5530,6042,6055,8,14,26,7,8,11,32,37,-5,22,30,29
5531,6042,6055,12,4,26,12,6,8,37,26,11,30,22,42
5532,6042,6055,53,7,26,10,10,6,51,39,12,30,22,40
5533,6042,6055,52,2,26,14,7,5,41,29,12,35,17,49
5534,6042,6055,27,15,26,7,8,11,22,32,-10,22,30,29
5535,6042,6055,1,1,26,17,5,4,52,23,29,39,13,56
5536,6105,6188,1,1,34,23,6,5,72,30,42,52,16,75
5537,6105,6188,27,16,34,8,9,17,30,50,-20,25,43,33
5538,6105,6188,12,5,34,15,8,11,53,39,14,38,30,53
5539,6105,6188,53,10,34,11,13,10,58,51,7,35,33,46
5540,6105,6188,52,4,34,18,8,8,62,37,25,44,24,62
5541,6105,6188,17,7,34,14,6,14,47,50,-3,34,34,48
5542,6105,6188,8,15,34,8,10,16,40,57,-17,26,42,34
5543,6105,6188,49,3,34,18,9,7,51,26,25,45,23,63
5544,6105,6188,37,13,34,11,9,14,35,43,-8,31,37,42
5545,6105,6188,5,18,34,6,8,20,39,72,-33,20,48,26
5546,6105,6188,21,8,34,13,9,12,43,49,-6,35,33,48
5547,6105,6188,20,6,34,14,7,13,46,39,7,35,33,49
5548,6105,6188,56,12,34,11,10,13,42,47,-5,32,36,43
5549,6105,6188,41,14,34,10,5,19,39,79,-40,25,43,35
5550,6105,6188,43,2,34,21,6,7,74,37,37,48,20,69
5551,6105,6188,57,9,34,12,11,11,58,53,5,35,33,47
5552,6105,6188,22,11,34,12,8,14,44,45,-1,32,36,44
5553,6105,6188,24,17,34,6,8,20,38,67,-29,20,48,26
5554,5874,5876,21,2,5,4,1,0,9,4,5,9,1,13
5555,5874,5876,43,5,5,2,3,0,11,5,6,7,3,9
5556,5874,5876,57,10,5,2,2,1,6,8,-2,6,4,8
5557,5874,5876,24,14,5,1,1,3,4,9,-5,3,7,4
5558,5874,5876,22,18,5,0,0,5,3,8,-5,0,10,0
5559,5874,5876,56,8,5,2,2,1,6,6,0,6,4,8
5560,5874,5876,41,12,5,1,2,2,5,8,-3,4,6,5
5561,5874,5876,20,13,5,1,1,3,4,8,-4,3,7,4
5562,5874,5876,52,6,5,2,2,1,5,3,2,6,4,8
5563,5874,5876,49,8,5,2,2,1,6,6,0,6,4,8
5564,5874,5876,5,15,5,1,0,4,8,9,-1,2,8,3
5565,5874,5876,37,17,5,0,3,2,3,7,-4,3,7,3
5566,5874,5876,17,4,5,3,1,1,8,8,0,7,3,10
5567,5874,5876,8,16,5,1,0,4,5,7,-2,2,8,3
5568,5874,5876,53,3,5,3,1,1,13,8,5,7,3,10
5569,5874,5876,12,6,5,2,2,1,5,3,2,6,4,8
5570,5874,5876,27,11,5,2,0,3,5,6,-1,4,6,6
5571,5874,5876,1,1,5,4,1,0,10,3,7,9,1,13
5572,5877,5880,1,1,6,5,1,0,14,4,10,11,1,16
5573,2983,2989,17,8,8,2,5,1,14,10,4,9,7,11
5574,2983,2989,53,6,8,3,2,3,13,16,-3,8,8,11
5575,2983,2989,1,3,8,4,2,2,13,9,4,10,6,14
5576,3396,3409,53,6,16,7,4,5,20,12,8,18,14,25
5577,3396,3409,52,9,16,5,5,6,19,25,-6,15,17,20
5578,3396,3409,28,10,16,5,4,7,24,27,-3,14,18,19
5579,3396,3409,17,5,16,7,6,3,23,13,10,20,12,27
5580,3396,3409,8,16,16,2,6,8,15,25,-10,10,22,12
5581,3396,3409,4,2,16,10,2,4,30,17,13,22,10,32
5582,3396,3409,49,1,16,10,4,2,31,13,18,24,8,34
5583,3396,3409,37,4,16,8,5,3,23,13,10,21,11,29
5584,3396,3409,5,13,16,3,5,8,14,29,-15,11,21,14
5585,3396,3409,20,12,16,4,5,7,15,32,-17,13,19,17
5586,3396,3409,41,15,16,3,3,10,18,27,-9,9,23,12
5587,3396,3409,43,8,16,6,5,5,30,16,14,17,15,23
5588,3396,3409,26,14,16,3,4,9,15,36,-21,10,22,13
5589,3396,3409,27,7,16,7,2,7,24,20,4,16,16,23
5590,3396,3409,39,11,16,4,6,6,16,24,-8,14,18,18
5591,3396,3409,1,3,16,10,2,4,32,20,12,22,10,32
5592,3466,3472,1,2,24,16,4,4,54,29,25,36,12,52
5593,3466,3472,27,10,24,9,3,12,31,36,-5,21,27,30
5594,3466,3472,39,13,24,6,8,10,21,33,-12,20,28,26
5595,3466,3472,20,9,24,8,8,8,30,38,-8,24,24,32
5596,3466,3472,41,12,24,7,5,12,29,38,-9,19,29,26
5597,3466,3472,49,1,24,17,5,2,55,20,35,39,9,56
5598,3466,3472,37,5,24,11,6,7,36,26,10,28,20,39
5599,3466,3472,5,14,24,4,6,14,20,49,-29,14,34,18
5600,3466,3472,17,8,24,8,8,8,30,30,0,24,24,32
5601,3466,3472,8,16,24,3,8,13,23,40,-17,14,34,17
5602,3466,3472,43,6,24,10,6,8,46,24,22,26,22,36
5603,3466,3472,26,15,24,4,5,15,19,48,-29,13,35,17
5604,3466,3472,52,7,24,8,9,7,29,32,-3,25,23,33
5605,3466,3472,28,11,24,7,6,11,32,43,-11,20,28,27
5606,3466,3472,53,4,24,11,6,7,32,21,11,28,20,39
5607,3466,3472,4,3,24,14,5,5,42,22,20,33,15,47
5608,3326,3332,4,3,6,4,1,1,12,7,5,9,3,13
5609,3326,3332,1,2,6,5,0,1,11,8,3,10,2,15
5610,3326,3332,53,5,6,3,2,1,8,3,5,8,4,11
5611,3326,3332,17,8,6,2,3,1,6,2,4,7,5,9
5612,3326,3332,8,14,6,1,1,4,4,11,-7,3,9,4
5613,3326,3332,49,1,6,5,0,1,9,5,4,10,2,15
5614,3326,3332,37,4,6,3,2,1,12,7,5,8,4,11
5615,3326,3332,5,12,6,1,2,3,4,12,-8,4,8,5
5616,3326,3332,20,9,6,2,3,1,8,11,-3,7,5,9
5617,3326,3332,41,15,6,1,0,5,6,8,-2,2,10,3
5618,3326,3332,43,6,6,3,1,2,15,6,9,7,5,10
5619,3326,3332,26,13,6,1,1,4,5,11,-6,3,9,4
5620,3326,3332,52,7,6,2,3,1,13,8,5,7,5,9
5621,3326,3332,28,11,6,1,2,3,5,10,-5,4,8,5
5622,3326,3332,39,10,6,1,3,2,4,7,-3,5,7,6
5623,3326,3332,27,16,6,0,2,4,5,11,-6,2,10,2
5624,3340,3346,39,13,8,1,3,4,4,12,-8,5,11,6
5625,3340,3346,27,14,8,1,2,5,7,13,-6,4,12,5
5626,3340,3346,52,9,8,2,4,2,13,11,2,8,8,10
5627,3340,3346,28,10,8,2,3,3,8,11,-3,7,9,9
5628,3340,3346,43,8,8,3,3,2,16,7,9,9,7,12
5629,3340,3346,26,11,8,1,3,4,8,14,-6,5,11,6
5630,3340,3346,20,7,8,3,4,1,12,14,-2,10,6,13
5631,3340,3346,41,16,8,1,0,7,6,14,-8,2,14,3
5632,3340,3346,49,2,8,6,1,1,11,6,5,13,3,19
5633,3340,3346,37,5,8,4,2,2,14,9,5,10,6,14
5634,3340,3346,5,15,8,1,2,5,5,18,-13,4,12,5
5635,3340,3346,17,6,8,3,4,1,8,3,5,10,6,13
5636,3340,3346,8,12,8,1,3,4,5,12,-7,5,11,6
5637,3340,3346,53,4,8,4,2,2,12,4,8,10,6,14
5638,3340,3346,1,1,8,7,0,1,18,8,10,14,2,21
5639,3340,3346,4,3,8,5,2,1,16,7,9,12,4,17
5640,3718,3731,21,4,10,5,2,3,15,12,3,12,8,17
5641,3718,3731,4,15,10,2,2,6,11,18,-7,6,14,8
5642,3718,3731,53,7,10,3,4,3,12,13,-1,10,10,13
5643,3718,3731,28,8,10,3,4,3,14,17,-3,10,10,13
5644,3718,3731,52,10,10,3,3,4,12,14,-2,9,11,12
5645,3718,3731,36,16,10,1,5,4,7,15,-8,7,13,8
5646,3718,3731,43,1,10,8,1,1,24,9,15,17,3,25
5647,3718,3731,26,5,10,4,2,4,11,15,-4,10,10,14
5648,3718,3731,17,9,10,4,0,6,14,13,1,8,12,12
5649,3718,3731,20,6,10,3,5,2,12,7,5,11,9,14
5650,3718,3731,41,12,10,3,1,6,7,17,-10,7,13,10
5651,3718,3731,49,3,10,5,4,1,23,10,13,14,6,19
5652,3718,3731,37,13,10,2,4,4,5,10,-5,8,12,10
5653,2717,2723,18,13,19,5,3,11,17,31,-14,13,25,18
5654,2717,2723,27,11,19,7,3,9,23,27,-4,17,21,24
5655,2717,2723,7,9,19,8,2,9,29,36,-7,18,20,26
5656,2717,2723,53,7,19,7,6,6,22,19,3,20,18,27
5657,2717,2723,21,16,19,3,6,10,14,30,-16,12,26,15
5658,2717,2723,43,1,19,13,3,3,44,15,29,29,9,42
5659,2717,2723,20,6,19,7,7,5,24,22,2,21,17,28
5660,2717,2723,41,14,19,4,6,9,20,32,-12,14,24,18
5661,2717,2723,17,4,19,10,2,7,42,40,2,22,16,32
5662,2717,2723,8,5,19,8,4,7,32,32,0,20,18,28
5663,2717,2723,49,3,19,9,6,4,33,23,10,24,14,33
5664,2717,2723,37,8,19,7,6,6,23,23,0,20,18,27
5665,2717,2723,28,10,19,7,5,7,29,29,0,19,19,26
5666,2717,2723,52,12,19,5,6,8,26,30,-4,16,22,21
5667,2717,2723,24,15,19,4,3,12,18,29,-11,11,27,15
5668,2724,2737,43,1,20,14,3,3,45,15,30,31,9,45
5669,2724,2737,24,16,20,4,3,13,18,32,-14,11,29,15
5670,2724,2737,28,10,20,7,6,7,29,29,0,20,20,27
5671,2724,2737,52,12,20,5,6,9,28,33,-5,16,24,21
5672,2724,2737,49,3,20,10,6,4,36,23,13,26,14,36
5673,2724,2737,37,11,20,7,6,7,24,26,-2,20,20,27
5674,2724,2737,17,4,20,10,2,8,43,43,0,22,18,32
5675,2724,2737,8,8,20,8,4,8,32,35,-3,20,20,28
5676,2724,2737,20,5,20,8,7,5,27,23,4,23,17,31
5677,2724,2737,41,14,20,4,6,10,20,33,-13,14,26,18
5678,2724,2737,7,7,20,9,2,9,32,38,-6,20,20,29
5679,2724,2737,21,15,20,3,7,10,14,30,-16,13,27,16
5680,2724,2737,53,6,20,8,6,6,25,19,6,22,18,30
5681,2724,2737,27,9,20,8,3,9,25,28,-3,19,21,27
5682,2724,2737,1,2,20,13,4,3,37,13,24,30,10,43
5683,2724,2737,18,13,20,5,3,12,18,33,-15,13,27,18
5684,2752,2758,1,2,23,14,6,3,42,16,26,34,12,48
5685,2752,2758,18,14,23,6,4,13,20,35,-15,16,30,22
5686,2752,2758,27,10,23,8,3,12,28,35,-7,19,27,27
5687,2752,2758,53,8,23,9,6,8,29,25,4,24,22,33
5688,2752,2758,20,4,23,10,7,6,32,27,5,27,19,37
5689,2752,2758,41,15,23,5,7,11,25,38,-13,17,29,22
5690,2752,2758,17,5,23,11,2,10,48,49,-1,24,22,35
5691,2752,2758,8,9,23,9,4,10,34,40,-6,22,24,31
5692,2752,2758,49,3,23,11,7,5,39,28,11,29,17,40
5693,2752,2758,37,11,23,7,6,10,24,31,-7,20,26,27
5694,2752,2758,28,7,23,9,6,8,36,31,5,24,22,33
5695,2752,2758,52,12,23,6,7,10,29,35,-6,19,27,25
5696,2752,2758,43,1,23,17,3,3,56,18,38,37,9,54
5697,2752,2758,24,13,23,7,3,13,24,34,-10,17,29,24
5698,2752,2758,7,6,23,11,2,10,35,41,-6,24,22,35
5699,2752,2758,21,16,23,4,7,12,17,35,-18,15,31,19
5700,2577,2583,7,6,4,2,0,2,9,9,0,4,4,6
5701,2577,2583,21,12,4,1,1,2,5,8,-3,3,5,4
5702,2577,2583,1,2,4,3,0,1,8,3,5,6,2,9
5703,2577,2583,18,16,4,0,2,2,2,6,-4,2,6,2
5704,2577,2583,43,1,4,4,0,0,16,4,12,8,0,12
5705,2577,2583,24,7,4,1,2,1,5,4,1,4,4,5
5706,2577,2583,28,10,4,1,2,1,6,9,-3,4,4,5
5707,2577,2583,52,11,4,1,1,2,9,11,-2,3,5,4
5708,2577,2583,37,4,4,2,1,1,5,3,2,5,3,7
5709,2577,2583,49,8,4,1,2,1,7,7,0,4,4,5
5710,2577,2583,17,3,4,2,1,1,11,7,4,5,3,7
5711,2577,2583,8,5,4,2,1,1,10,9,1,5,3,7
5712,2577,2583,41,9,4,1,2,1,5,5,0,4,4,5
5713,2577,2583,20,13,4,1,1,2,3,9,-6,3,5,4
5714,2577,2583,53,15,4,0,2,2,3,6,-3,2,6,2
5715,2577,2583,27,14,4,1,0,3,2,6,-4,2,6,3
5716,3144,3150,27,2,26,16,3,7,41,26,15,35,17,51
5717,3144,3150,39,14,26,6,9,11,25,37,-12,21,31,27
5718,3144,3150,53,12,26,8,5,13,35,44,-9,21,31,29
5719,3144,3150,4,11,26,7,12,7,28,31,-3,26,26,33
5720,3144,3150,7,15,26,5,4,17,23,54,-31,14,38,19
5721,3144,3150,20,8,26,10,4,12,42,44,-2,24,28,34
5722,3144,3150,41,9,26,10,4,12,30,41,-11,24,28,34
5723,3144,3150,43,5,26,11,9,6,52,30,22,31,21,42
5724,3144,3150,28,7,26,9,10,7,37,37,0,28,24,37
5725,3144,3150,49,1,26,16,7,3,54,16,38,39,13,55
5726,3144,3150,37,6,26,10,7,9,37,40,-3,27,25,37
5727,3144,3150,17,3,26,12,9,5,43,30,13,33,19,45
5728,3144,3150,8,10,26,9,7,10,27,35,-8,25,27,34
5729,3144,3150,52,13,26,7,7,12,28,38,-10,21,31,28
5730,3144,3150,24,16,26,4,7,15,26,49,-23,15,37,19
5731,3144,3150,1,4,26,12,8,6,52,28,24,32,20,44
5732,5650,5663,12,3,25,14,3,8,47,28,19,31,19,45
5733,5650,5663,53,11,24,9,7,8,41,42,-1,25,23,34
5734,5650,5663,27,14,25,6,6,13,32,45,-13,18,32,24
5735,5678,5680,27,17,27,6,7,14,34,48,-14,19,35,25
5736,5678,5680,1,1,28,17,6,5,59,26,33,40,16,57
5737,5678,5680,12,2,28,16,3,9,50,29,21,35,21,51
5738,5678,5680,53,9,27,11,8,8,44,43,1,30,24,41
5739,5678,5680,37,5,28,11,12,5,29,14,15,34,22,45
5740,5678,5680,49,8,27,12,7,8,40,32,8,31,23,43
5741,5678,5680,43,4,27,14,6,7,49,32,17,34,20,48
5742,5678,5680,57,12,28,7,12,9,35,39,-4,26,30,33
5743,5678,5680,24,14,28,8,8,12,35,43,-8,24,32,32
5744,5678,5680,40,15,27,4,12,11,28,46,-18,20,34,24
5745,5678,5680,20,7,28,11,10,7,46,31,15,32,24,43
5746,5678,5680,21,10,28,10,10,8,30,36,-6,30,26,40
5747,5678,5680,17,6,27,13,6,8,51,34,17,32,22,45
5748,5678,5680,8,16,28,6,8,14,21,44,-23,20,36,26
5749,5678,5680,41,11,27,9,9,9,44,44,0,27,27,36
5750,5678,5680,52,3,27,13,8,6,44,23,21,34,20,47
5751,5678,5680,48,18,28,3,10,15,19,48,-29,16,40,19
5752,5678,5680,54,19,27,4,5,18,15,52,-37,13,41,17
5753,5678,5680,5,13,27,8,9,10,32,41,-9,25,29,33
5754,5685,5691,37,4,30,12,13,5,32,16,16,37,23,49
5755,5685,5691,49,9,29,12,7,10,42,37,5,31,27,43
5756,5685,5691,5,14,29,8,9,12,33,46,-13,25,33,33
5757,5685,5691,52,3,29,14,9,6,46,23,23,37,21,51
5758,5685,5691,48,18,30,3,10,17,19,51,-32,16,44,19
5759,5685,5691,54,19,29,4,5,20,16,56,-40,13,45,17
5760,5685,5691,20,7,29,12,10,7,47,31,16,34,24,46
5761,5685,5691,41,12,29,10,9,10,48,47,1,29,29,39
5762,5685,5691,17,6,29,13,8,8,52,35,17,34,24,47
5763,5685,5691,8,16,30,7,8,15,23,45,-22,22,38,29
5764,5685,5691,21,10,29,10,11,8,30,36,-6,31,27,41
5765,5685,5691,43,5,29,14,8,7,51,34,17,36,22,50
5766,5685,5691,57,11,30,9,12,9,39,39,0,30,30,39
5767,5685,5691,24,13,30,8,9,13,37,47,-10,25,35,33
5768,5685,5691,40,15,29,5,12,12,31,49,-18,22,36,27
5769,5685,5691,12,2,30,18,3,9,54,30,24,39,21,57
5770,5685,5691,53,8,29,13,8,8,49,44,5,34,24,47
5771,5685,5691,1,1,30,19,6,5,61,26,35,44,16,63
5772,5685,5691,27,17,29,6,7,16,36,54,-18,19,39,25
5773,5944,5950,27,14,14,3,4,7,10,19,-9,10,18,13
5774,5944,5950,53,4,14,7,3,4,30,21,9,17,11,24
5775,5944,5950,12,10,14,5,4,5,17,15,2,14,14,19
5776,5944,5950,49,8,14,6,5,3,15,10,5,17,11,23
5777,5944,5950,37,16,14,2,6,6,11,21,-10,10,18,12
5778,5944,5950,5,18,14,2,3,9,18,30,-12,7,21,9
5779,5944,5950,17,5,14,7,3,4,18,16,2,17,11,24
5780,5944,5950,8,11,14,5,2,7,21,19,2,12,16,17
5781,5944,5950,21,7,14,7,3,4,17,17,0,17,11,24
5782,5944,5950,1,1,14,9,3,2,28,11,17,21,7,30
5783,5944,5950,56,6,14,7,3,4,18,17,1,17,11,24
5784,5944,5950,20,13,14,4,1,9,17,25,-8,9,19,13
5785,5944,5950,41,15,14,3,3,8,12,33,-21,9,19,12
5786,5944,5950,52,2,14,8,4,2,24,12,12,20,8,28
5787,5944,5950,43,3,14,7,5,2,32,18,14,19,9,26
5788,5944,5950,57,9,14,6,4,4,29,21,8,16,12,22
5789,5944,5950,22,12,14,4,4,6,16,16,0,12,16,16
5790,5944,5950,24,17,14,2,4,8,13,25,-12,8,20,10
5791,5986,5992,56,8,19,8,5,6,26,25,1,21,17,29
5792,5986,5992,20,12,19,7,3,9,29,29,0,17,21,24
5793,5986,5992,41,17,19,3,4,12,12,48,-36,10,28,13
5794,5986,5992,21,6,19,8,6,5,27,25,2,22,16,30
5795,5986,5992,49,9,19,7,7,5,19,16,3,21,17,28
5796,5986,5992,37,14,19,4,8,7,17,25,-8,16,22,20
5797,5986,5992,5,18,19,2,4,13,22,41,-19,8,30,10
5798,5986,5992,17,7,19,8,5,6,25,23,2,21,17,29
5799,5986,5992,8,13,19,6,4,9,25,29,-4,16,22,22
5800,5986,5992,53,4,19,9,6,4,39,28,11,24,14,33
5801,5986,5992,12,10,19,7,6,6,25,20,5,20,18,27
5802,5986,5992,43,3,19,10,5,4,44,24,20,25,13,35
5803,5986,5992,57,5,19,8,6,5,38,26,12,22,16,30
5804,5986,5992,22,11,19,7,5,7,24,21,3,19,19,26
5805,5986,5992,24,16,19,3,6,10,18,31,-13,12,26,15
5806,5986,5992,27,15,19,4,5,10,15,27,-12,13,25,17
5807,5986,5992,52,2,19,11,5,3,30,16,14,27,11,38
5808,5986,5992,1,1,19,12,4,3,39,20,19,28,10,40
5809,6056,6062,27,15,27,7,8,12,23,34,-11,22,32,29
5810,5681,5684,24,14,29,8,8,13,35,45,-10,24,34,32
5811,5681,5684,40,15,28,5,12,11,31,47,-16,22,34,27
5812,5681,5684,12,2,29,17,3,9,52,29,23,37,21,54
5813,5681,5684,53,8,28,12,8,8,48,44,4,32,24,44
5814,5681,5684,21,10,29,10,11,8,30,36,-6,31,27,41
5815,5681,5684,41,11,28,10,9,9,48,46,2,29,27,39
5816,5681,5684,20,7,28,11,10,7,46,31,15,32,24,43
5817,5681,5684,37,3,29,12,12,5,31,15,16,36,22,48
5818,5681,5684,49,9,28,12,7,9,42,36,6,31,25,43
5819,5681,5684,5,13,28,8,9,11,33,44,-11,25,31,33
5820,5681,5684,17,6,28,13,7,8,51,34,17,33,23,46
5821,5681,5684,8,16,29,6,8,15,21,45,-24,20,38,26
5822,5681,5684,52,4,28,13,9,6,44,23,21,35,21,48
5823,5681,5684,48,18,29,3,10,16,19,50,-31,16,42,19
5824,5681,5684,54,19,28,4,5,19,16,54,-38,13,43,17
5825,5706,5719,12,3,33,19,5,9,57,31,26,43,23,62
5826,5706,5719,53,6,33,16,8,9,56,48,8,40,26,56
5827,5706,5719,37,7,33,13,13,7,34,21,13,39,27,52
5828,5706,5719,49,9,33,14,8,11,50,43,7,36,30,50
5829,5706,5719,5,14,33,9,9,15,37,58,-21,27,39,36
5830,5706,5719,17,8,33,14,9,10,56,40,16,37,29,51
5831,5706,5719,8,17,33,7,10,16,25,48,-23,24,42,31
5832,5706,5719,21,10,33,10,13,10,34,44,-10,33,33,43
5833,5706,5719,1,1,34,21,8,5,74,31,43,50,18,71
5834,5706,5719,20,5,33,15,11,7,54,34,20,41,25,56
5835,5706,5719,41,12,33,10,10,13,50,58,-8,30,36,40
5836,5706,5719,43,2,33,17,9,7,60,34,26,43,23,60
5837,5706,5719,57,11,33,9,13,11,40,44,-4,31,35,40
5838,5706,5719,24,13,34,9,9,16,41,58,-17,27,41,36
5839,5706,5719,40,15,33,6,14,13,38,56,-18,26,40,32
5840,5706,5719,27,16,33,8,8,17,45,60,-15,24,42,32
5841,5706,5719,52,4,33,16,10,7,54,27,27,42,24,58
5842,5706,5719,48,18,34,4,11,19,21,54,-33,19,49,23
5843,5706,5719,54,19,33,6,6,21,23,60,-37,18,48,24
5844,5489,5495,27,19,6,0,1,5,2,10,-8,1,11,1
5845,5489,5495,43,11,6,1,3,2,8,8,0,5,7,6
5846,5489,5495,57,14,6,0,3,3,6,10,-4,3,9,3
5847,5489,5495,40,15,6,0,3,3,3,8,-5,3,9,3
5848,5489,5495,24,16,5,0,3,2,1,6,-5,3,7,3
5849,5489,5495,12,1,6,5,0,1,17,7,10,10,2,15
5850,5489,5495,53,12,6,2,1,3,9,11,-2,5,7,7
5851,5489,5495,20,5,5,3,2,0,12,3,9,8,2,11
5852,5489,5495,41,10,6,2,2,2,9,11,-2,6,6,8
5853,5489,5495,37,6,6,2,4,0,4,2,2,8,4,10
5854,5489,5495,49,7,6,3,1,2,5,5,0,7,5,10
5855,5489,5495,5,9,6,1,4,1,7,7,0,6,6,7
5856,5489,5495,17,2,6,4,1,1,13,3,10,9,3,13
5857,5489,5495,8,18,5,1,1,3,3,12,-9,3,7,4
5858,5489,5495,1,8,5,2,2,1,9,6,3,6,4,8
5859,5489,5495,21,4,6,4,1,1,11,7,4,9,3,13
5860,5489,5495,52,3,6,4,1,1,13,5,8,9,3,13
5861,5489,5495,48,13,5,1,2,2,5,8,-3,4,6,5
5862,5489,5495,54,17,5,1,1,3,3,11,-8,3,7,4
5863,5510,5512,52,6,7,4,1,2,14,7,7,9,5,13
5864,5510,5512,48,14,7,1,4,2,6,9,-3,6,8,7
5865,5510,5512,54,16,7,2,1,4,5,13,-8,5,9,7
5866,5510,5512,21,5,8,4,2,2,13,14,-1,10,6,14
5867,5510,5512,1,8,7,3,3,1,15,9,6,9,5,12
5868,5510,5512,20,2,7,4,3,0,14,4,10,11,3,15
5869,5510,5512,41,4,8,4,2,2,15,13,2,10,6,14
5870,5510,5512,37,3,8,3,4,1,9,3,6,10,6,13
5871,5510,5512,49,10,8,3,2,3,5,6,-1,8,8,11
5872,5510,5512,5,12,8,1,5,2,8,9,-1,7,9,8
5873,5510,5512,12,1,8,7,0,1,20,8,12,14,2,21
5874,5510,5512,53,9,8,4,1,3,13,13,0,9,7,13
5875,5510,5512,43,11,7,2,3,2,10,9,1,7,7,9
5876,5510,5512,57,13,8,1,4,3,11,12,-1,6,10,7
5877,5510,5512,40,15,8,1,4,3,6,10,-4,6,10,7
5878,5510,5512,24,17,7,0,3,4,3,10,-7,3,11,3
5879,5510,5512,17,7,8,4,1,3,16,10,6,9,7,13
5880,5510,5512,8,18,7,1,1,5,5,18,-13,3,11,4
5881,5510,5512,27,19,8,0,2,6,3,14,-11,2,14,2
5882,6035,6041,27,15,25,6,8,11,21,32,-11,20,30,26
5883,6035,6041,17,8,25,10,5,10,32,32,0,25,25,35
5884,6035,6041,8,14,25,7,7,11,32,37,-5,21,29,28
5885,6035,6041,43,3,25,13,6,6,54,31,23,32,18,45
5886,6035,6041,57,9,25,9,8,8,46,38,8,26,24,35
5887,6035,6041,22,13,25,7,7,11,28,32,-4,21,29,28
5888,6035,6041,24,16,25,5,7,13,26,42,-16,17,33,22
5889,6035,6041,12,4,25,12,6,7,37,25,12,30,20,42
5890,3718,3731,39,11,10,3,3,4,12,16,-4,9,11,12
5891,3718,3731,27,14,10,2,3,5,11,18,-7,7,13,9
5892,3718,3731,1,2,10,6,3,1,23,9,14,15,5,21
5893,3788,3794,39,12,17,5,4,8,20,27,-7,14,20,19
5894,3788,3794,27,16,17,2,4,11,16,35,-19,8,26,10
5895,3788,3794,49,1,17,12,4,1,37,11,26,28,6,40
5896,3788,3794,37,6,17,6,6,5,14,15,-1,18,16,24
5897,3788,3794,41,13,17,4,5,8,10,22,-12,13,21,17
5898,3788,3794,28,7,17,6,5,6,23,26,-3,17,17,23
5899,3788,3794,52,10,17,5,6,6,20,24,-4,16,18,21
5900,3788,3794,36,14,17,2,8,7,13,23,-10,12,22,14
5901,3788,3794,43,2,17,12,1,4,33,15,18,25,9,37
5902,3788,3794,26,11,17,5,5,7,17,22,-5,15,19,20
5903,3788,3794,21,9,17,6,4,7,20,22,-2,16,18,22
5904,3788,3794,20,8,17,5,8,4,20,13,7,18,16,23
5905,3788,3794,53,5,17,6,6,5,19,20,-1,18,16,24
5906,3788,3794,4,15,17,2,4,11,14,32,-18,8,26,10
5907,3788,3794,17,4,17,10,0,7,29,19,10,20,14,30
5908,3788,3794,1,3,17,11,4,2,38,17,21,26,8,37
5909,3823,3829,21,8,20,7,5,8,22,29,-7,19,21,26
5910,3823,3829,4,16,20,4,4,12,16,33,-17,12,28,16
5911,3823,3829,53,10,20,6,7,7,20,25,-5,19,21,25
5912,3823,3829,52,5,20,7,7,6,22,24,-2,21,19,28
5913,3823,3829,28,7,20,7,5,8,24,28,-4,19,21,26
5914,3823,3829,36,14,20,3,8,9,15,28,-13,14,26,17
5915,3823,3829,17,4,20,11,0,9,30,22,8,22,18,33
5916,3823,3829,43,3,20,12,4,4,35,17,18,28,12,40
5917,3823,3829,26,11,20,6,5,9,21,28,-7,17,23,23
5918,3823,3829,20,6,20,6,9,5,25,17,8,21,19,27
5919,3823,3829,41,13,20,4,8,8,13,25,-12,16,24,20
5920,3823,3829,49,1,20,15,4,1,45,12,33,34,6,49
5921,3823,3829,37,9,20,6,7,7,16,19,-3,19,21,25
5922,3823,3829,39,12,20,5,5,10,22,34,-12,15,25,20
5923,3823,3829,27,15,20,4,4,12,25,41,-16,12,28,16
5924,3823,3829,1,2,20,14,4,2,50,19,31,32,8,46
5925,3837,3843,1,2,22,15,4,3,55,23,32,34,10,49
5926,3837,3843,39,13,22,5,6,11,24,38,-14,16,28,21
5927,3837,3843,27,15,22,5,4,13,30,43,-13,14,30,19
5928,3837,3843,49,1,22,16,5,1,49,14,35,37,7,53
5929,3837,3843,37,7,22,7,8,7,19,20,-1,22,22,29
5930,3837,3843,20,10,22,6,9,7,25,20,5,21,23,27
5931,3837,3843,41,12,22,5,8,9,15,28,-13,18,26,23
5932,3837,3843,43,3,22,12,5,5,38,22,16,29,15,41
5933,3837,3843,26,11,22,7,5,10,23,29,-6,19,25,26
5934,3837,3843,17,4,22,13,0,9,35,24,11,26,18,39
5935,3837,3843,28,5,22,8,6,8,27,30,-3,22,22,30
5936,3837,3843,52,8,22,7,8,7,22,25,-3,22,22,29
5937,3837,3843,36,14,22,4,8,10,18,31,-13,16,28,20
5938,3837,3843,53,9,22,7,7,8,21,26,-5,21,23,28
5939,3837,3843,21,6,22,8,6,8,24,30,-6,22,22,30
5940,3837,3843,4,16,22,4,5,13,16,38,-22,13,31,17
5941,3879,3885,1,2,27,18,4,5,65,32,33,40,14,58
5942,3879,3885,53,6,27,10,9,8,28,28,0,29,25,39
5943,3879,3885,17,4,27,15,1,11,39,27,12,31,23,46
5944,3879,3885,43,3,27,15,5,7,46,26,20,35,19,50
5945,3879,3885,26,11,27,8,6,13,25,35,-10,22,32,30
5946,3879,3885,21,9,27,9,6,12,27,42,-15,24,30,33
5947,3879,3885,4,16,27,4,6,17,18,53,-35,14,40,18
5948,3879,3885,52,5,27,10,9,8,33,27,6,29,25,39
5949,3879,3885,28,8,27,9,7,11,32,37,-5,25,29,34
5950,3879,3885,36,14,27,6,10,11,25,33,-8,22,32,28
5951,3879,3885,20,10,27,7,11,9,30,27,3,25,29,32
5952,3879,3885,41,12,27,6,12,9,17,29,-12,24,30,30
5953,3879,3885,49,1,27,20,5,2,61,19,42,45,9,65
5954,3879,3885,37,7,27,10,8,9,30,28,2,28,26,38
5955,3879,3885,39,13,27,7,7,13,29,42,-13,21,33,28
5956,3879,3885,27,15,27,6,6,15,32,52,-20,18,36,24
5957,3704,3710,39,13,8,2,2,4,9,15,-6,6,10,8
5958,3704,3710,27,16,8,1,3,4,9,15,-6,5,11,6
5959,3704,3710,1,2,8,5,2,1,20,8,12,12,4,17
5960,3704,3710,49,3,8,4,3,1,18,9,9,11,5,15
5961,3704,3710,37,10,8,2,3,3,5,9,-4,7,9,9
5962,3704,3710,20,4,8,3,4,1,11,5,6,10,6,13
5963,3704,3710,41,14,8,2,1,5,6,16,-10,5,11,7
5964,3704,3710,21,7,8,3,2,3,10,9,1,8,8,11
5965,3704,3710,43,1,8,6,1,1,18,8,10,13,3,19
5966,3704,3710,26,8,8,3,2,3,10,14,-4,8,8,11
5967,3704,3710,17,5,8,4,0,4,12,8,4,8,8,12
5968,3704,3710,53,6,8,3,3,2,11,11,0,9,7,12
5969,5328,5334,48,16,32,6,14,12,25,40,-15,26,38,32
5970,5328,5334,36,17,32,8,7,17,27,56,-29,23,41,31
5971,5601,5607,43,3,18,10,4,4,37,24,13,24,12,34
5972,5601,5607,57,11,18,5,9,4,27,23,4,19,17,24
5973,5601,5607,24,13,18,3,7,8,22,30,-8,13,23,16
5974,5601,5607,40,15,18,2,9,7,16,26,-10,13,23,15
5975,5601,5607,20,5,18,8,6,4,29,17,12,22,14,30
5976,5601,5607,41,12,18,6,5,7,29,33,-4,17,19,23
5977,5601,5607,52,2,18,10,4,4,34,18,16,24,12,34
5978,5601,5607,48,18,18,2,7,9,12,30,-18,11,25,13
5979,5601,5607,54,19,18,4,2,12,10,33,-23,10,26,14
5980,5601,5607,12,4,18,10,2,6,34,22,12,22,14,32
5981,5601,5607,53,9,18,8,5,5,32,31,1,21,15,29
5982,5601,5607,37,7,18,7,7,4,21,10,11,21,15,28
5983,5601,5607,49,8,18,8,5,5,24,21,3,21,15,29
5984,5601,5607,5,14,18,3,7,8,18,27,-9,13,23,16
5985,5601,5607,1,1,18,11,4,3,36,16,20,26,10,37
5986,5601,5607,21,10,18,8,5,5,23,25,-2,21,15,29
5987,5601,5607,17,6,18,9,3,6,35,24,11,21,15,30
5988,5601,5607,8,16,18,5,2,11,14,33,-19,12,24,17
5989,5601,5607,27,17,18,3,5,10,19,29,-10,11,25,14
5990,5464,5467,27,18,2,0,0,2,0,5,-5,0,4,0
5991,5464,5467,21,7,2,1,1,0,1,0,1,3,1,4
5992,5464,5467,1,11,1,0,1,0,1,1,0,1,1,1
5993,5464,5467,12,3,2,2,0,0,6,1,5,4,0,6
5994,5464,5467,53,4,2,1,1,0,3,1,2,3,1,4
5995,5464,5467,52,2,2,2,0,0,6,0,6,4,0,6
5996,5464,5467,48,5,2,1,1,0,2,0,2,3,1,4
5997,5464,5467,54,17,2,0,0,2,1,6,-5,0,4,0
5998,5464,5467,20,5,2,1,1,0,2,0,2,3,1,4
5999,5464,5467,41,9,2,1,0,1,3,3,0,2,2,3
6000,5464,5467,24,12,1,0,1,0,0,0,0,1,1,1
6001,5464,5467,57,13,2,0,1,1,1,2,-1,1,3,1
6002,5464,5467,40,13,2,0,1,1,1,2,-1,1,3,1
6003,5464,5467,43,15,2,0,1,1,1,3,-2,1,3,1
6004,5464,5467,37,7,2,1,1,0,1,0,1,3,1,4
6005,5464,5467,5,9,2,1,0,1,3,3,0,2,2,3
6006,5464,5467,49,16,2,0,0,2,0,3,-3,0,4,0
6007,5464,5467,17,1,2,2,0,0,7,1,6,4,0,6
6008,5464,5467,8,19,2,0,0,2,0,8,-8,0,4,0
6009,5664,5670,20,5,26,11,9,6,45,29,16,31,21,42
6010,5664,5670,41,10,25,9,8,8,44,43,1,26,24,35
6011,5664,5670,43,3,25,13,6,6,48,30,18,32,18,45
6012,5664,5670,57,12,26,7,11,8,35,38,-3,25,27,32
6013,5664,5670,24,14,26,6,8,12,30,42,-12,20,32,26
6014,5664,5670,40,16,25,4,10,11,26,44,-18,18,32,22
6015,5664,5670,12,2,26,15,3,8,49,28,21,33,19,48
6016,5664,5670,53,11,25,9,8,8,41,42,-1,26,24,35
6017,5664,5670,37,7,26,10,11,5,27,13,14,31,21,41
6018,5664,5670,49,8,25,11,7,7,36,31,5,29,21,40
6019,5664,5670,5,13,25,7,9,9,31,36,-5,23,27,30
6020,5664,5670,1,1,26,16,6,4,54,25,29,38,14,54
6021,5664,5670,21,9,26,10,9,7,29,31,-2,29,23,39
6022,5664,5670,17,4,26,13,5,8,50,33,17,31,21,44
6023,5664,5670,8,17,26,5,7,14,19,44,-25,17,35,22
6024,5664,5670,27,15,26,6,6,14,33,47,-14,18,34,24
6025,5664,5670,52,6,25,12,7,6,39,23,16,31,19,43
6026,5664,5670,48,18,26,3,10,13,19,42,-23,16,36,19
6027,5664,5670,54,19,25,4,4,17,14,48,-34,12,38,16
6028,5720,5726,52,2,34,17,10,7,55,27,28,44,24,61
6029,5720,5726,48,18,35,4,11,20,21,57,-36,19,51,23
6030,5720,5726,54,19,34,6,7,21,25,62,-37,19,49,25
6031,5720,5726,27,17,34,8,8,18,45,61,-16,24,44,32
6032,5720,5726,17,8,34,14,10,10,58,42,16,38,30,52
6033,5720,5726,8,16,34,7,11,16,25,48,-23,25,43,32
6034,5720,5726,21,10,34,10,14,10,36,46,-10,34,34,44
6035,5720,5726,1,1,34,21,8,5,74,31,43,50,18,71
6036,5720,5726,37,6,34,14,13,7,37,21,16,41,27,55
6037,5720,5726,49,9,34,15,8,11,51,43,8,38,30,53
6038,5720,5726,5,14,34,9,10,15,39,60,-21,28,40,37
6039,5720,5726,12,4,34,19,6,9,57,31,26,44,24,63
6040,5720,5726,53,7,34,16,8,10,56,49,7,40,28,56
6041,5720,5726,20,5,34,16,11,7,58,35,23,43,25,59
6042,5720,5726,41,12,34,10,11,13,52,60,-8,31,37,41
6043,5720,5726,43,3,34,17,10,7,61,35,26,44,24,61
6044,5720,5726,57,11,34,9,13,12,41,48,-7,31,37,40
6045,5720,5726,24,13,35,9,10,16,43,60,-17,28,42,37
6046,5720,5726,40,15,34,6,15,13,39,57,-18,27,41,33
6047,5965,5971,56,6,16,8,4,4,24,21,3,20,12,28
6048,6035,6041,53,7,25,9,10,6,46,37,9,28,22,37
6049,6035,6041,49,5,25,11,8,6,32,20,12,30,20,41
6050,6035,6041,37,12,25,8,8,9,24,30,-6,24,26,32
6051,6035,6041,5,18,25,4,6,15,29,52,-23,14,36,18
6052,6035,6041,56,10,25,8,9,8,32,35,-3,25,25,33
6053,6035,6041,20,11,25,9,5,11,36,34,2,23,27,32
6054,6035,6041,41,17,25,5,4,16,19,59,-40,14,36,19
6055,6035,6041,1,1,25,16,5,4,50,22,28,37,13,53
6056,6035,6041,21,6,25,10,8,7,32,32,0,28,22,38
6057,6035,6041,52,2,25,14,7,4,41,27,14,35,15,49
6058,6070,6076,52,2,29,16,7,6,51,32,19,39,19,55
6059,6070,6076,37,11,29,10,8,11,29,36,-7,28,30,38
6060,6070,6076,5,16,29,6,6,17,36,57,-21,18,40,24
6061,6070,6076,21,10,29,11,8,10,35,41,-6,30,28,41
6062,6070,6076,17,6,29,13,5,11,38,35,3,31,27,44
6063,6070,6076,8,13,29,8,8,13,37,42,-5,24,34,32
6064,6070,6076,49,4,29,14,8,7,39,24,15,36,22,50
6065,6070,6076,12,5,29,13,6,10,39,32,7,32,26,45
6066,6070,6076,53,7,29,11,10,8,54,43,11,32,26,43
6067,6070,6076,20,8,29,12,6,11,42,36,6,30,28,42
6068,6070,6076,56,12,29,9,9,11,37,41,-4,27,31,36
6069,6070,6076,41,17,29,6,5,18,26,66,-40,17,41,23
6070,6070,6076,43,3,29,16,6,7,60,33,27,38,20,54
6071,6070,6076,57,9,29,11,8,10,50,45,5,30,28,41
6072,6070,6076,22,14,29,8,8,13,31,40,-9,24,34,32
6073,6070,6076,24,18,29,5,7,17,29,53,-24,17,41,22
6074,6070,6076,27,15,29,8,8,13,25,36,-11,24,34,32
6075,6070,6076,1,1,29,20,5,4,58,24,34,45,13,65
6076,6301,6307,1,1,16,11,2,3,38,25,13,24,8,35
6077,6301,6307,27,10,16,6,4,6,23,27,-4,16,16,22
6078,6301,6307,43,4,16,8,4,4,28,14,14,20,12,28
6079,6301,6307,22,5,16,7,6,3,25,16,9,20,12,27
6080,6301,6307,40,15,16,5,1,10,17,32,-15,11,21,16
6081,6301,6307,57,18,16,2,5,9,11,28,-17,9,23,11
6082,6301,6307,20,7,16,7,3,6,24,21,3,17,15,24
6083,6301,6307,56,14,16,4,5,7,15,22,-7,13,19,17
6084,6301,6307,41,16,16,3,5,8,18,27,-9,11,21,14
6085,6301,6307,21,9,16,6,4,6,24,19,5,16,16,22
6086,6301,6307,17,6,16,7,4,5,20,17,3,18,14,25
6087,6301,6307,8,13,16,5,2,9,13,22,-9,12,20,17
6088,6301,6307,52,11,16,5,5,6,27,26,1,15,17,20
6089,6301,6307,53,8,16,5,9,2,28,22,6,19,13,24
6090,6301,6307,12,12,16,5,3,8,20,19,1,13,19,18
6091,6301,6307,49,2,16,10,3,3,33,20,13,23,9,33
6092,6301,6307,37,3,16,9,3,4,24,13,11,21,11,30
6093,6301,6307,14,17,16,3,4,9,20,38,-18,10,22,13
6094,6308,6314,49,2,17,10,4,3,34,21,13,24,10,34
6095,6308,6314,37,3,17,10,3,4,28,14,14,23,11,33
6096,6308,6314,14,17,17,3,4,10,22,42,-20,10,24,13
6097,6308,6314,53,7,17,6,9,2,30,23,7,21,13,27
6098,6308,6314,12,13,17,5,4,8,22,21,1,14,20,19
6099,6308,6314,52,11,17,6,5,6,32,29,3,17,17,23
6100,6308,6314,17,5,17,8,4,5,24,19,5,20,14,28
6101,6308,6314,8,12,17,6,2,9,16,22,-6,14,20,20
6102,6308,6314,21,10,17,6,5,6,25,20,5,17,17,23
6103,6308,6314,20,9,17,7,3,7,25,24,1,17,17,24
6104,6308,6314,56,14,17,4,5,8,18,27,-9,13,21,17
6105,6308,6314,41,16,17,3,5,9,19,29,-10,11,23,14
6106,6308,6314,43,4,17,9,4,4,31,15,16,22,12,31
6107,6308,6314,22,6,17,7,6,4,25,18,7,20,14,27
6108,6308,6314,40,15,17,5,1,11,17,35,-18,11,23,16
6109,6308,6314,57,18,17,2,5,10,12,32,-20,9,25,11
6110,6308,6314,27,8,17,7,4,6,25,27,-2,18,16,25
6111,6308,6314,1,1,17,11,3,3,40,27,13,25,9,36
6112,6350,6356,27,9,21,8,4,9,28,36,-8,20,22,28
6113,6350,6356,52,11,21,7,6,8,39,35,4,20,22,27
6114,6350,6356,20,8,21,8,5,8,31,29,2,21,21,29
6115,6350,6356,56,15,21,4,8,9,24,34,-10,16,26,20
6116,6350,6356,41,16,21,4,6,11,26,37,-11,14,28,18
6117,6350,6356,17,5,21,11,4,6,36,25,11,26,16,37
6118,6350,6356,8,13,21,6,5,10,19,27,-8,17,25,23
6119,6350,6356,21,10,21,7,7,7,28,24,4,21,21,28
6120,6350,6356,1,1,21,14,4,3,50,32,18,32,10,46
6121,6350,6356,53,7,21,8,10,3,38,26,12,26,16,34
6122,6350,6356,12,12,21,6,6,9,28,26,2,18,24,24
6123,6350,6356,43,3,21,11,5,5,36,20,16,27,15,38
6124,6350,6356,22,6,21,9,8,4,33,24,9,26,16,35
6125,6350,6356,40,14,21,5,5,11,18,36,-18,15,27,20
6126,3151,3157,1,3,27,13,8,6,53,28,25,34,20,47
6127,3151,3157,43,5,27,11,10,6,53,31,22,32,22,43
6128,3151,3157,24,16,27,4,8,15,26,49,-23,16,38,20
6129,3151,3157,28,7,27,9,10,8,37,40,-3,28,26,37
6130,3151,3157,52,14,27,7,8,12,28,38,-10,22,32,29
6131,3151,3157,49,1,27,17,7,3,57,16,41,41,13,58
6132,3151,3157,37,6,27,11,7,9,40,40,0,29,25,40
6133,3151,3157,17,4,27,12,9,6,44,32,12,33,21,45
6134,3151,3157,8,9,27,9,8,10,29,37,-8,26,28,35
6135,3151,3157,20,8,27,10,5,12,44,46,-2,25,29,35
6136,3151,3157,41,10,27,10,4,13,30,42,-12,24,30,34
6137,3151,3157,4,11,27,7,12,8,28,34,-6,26,28,33
6138,3151,3157,7,15,27,5,5,17,24,55,-31,15,39,20
6139,3151,3157,53,13,27,8,5,14,35,45,-10,21,33,29
6140,3151,3157,27,2,27,17,3,7,42,26,16,37,17,54
6141,3151,3157,39,12,27,7,9,11,27,38,-11,23,31,30
6142,3662,3668,39,6,2,1,0,1,5,2,3,2,2,3
6143,3662,3668,27,14,2,0,1,1,1,4,-3,1,3,1
6144,3662,3668,53,5,2,1,1,0,1,0,1,3,1,4
6145,3662,3668,41,8,2,1,0,1,2,3,-1,2,2,3
6146,3662,3668,20,10,2,0,2,0,1,1,0,2,2,2
6147,3662,3668,17,16,2,0,0,2,0,3,-3,0,4,0
6148,3662,3668,49,2,2,1,1,0,4,1,3,3,1,4
6149,3662,3668,37,11,2,0,2,0,0,0,0,2,2,2
6150,3662,3668,43,1,2,2,0,0,4,0,4,4,0,6
6151,3662,3668,26,15,2,0,1,1,0,4,-4,1,3,1
6152,3662,3668,1,2,2,1,1,0,4,1,3,3,1,4
6153,3662,3668,4,7,2,1,0,1,4,3,1,2,2,3
6154,3662,3668,21,9,2,1,0,1,2,4,-2,2,2,3
6155,3662,3668,28,4,2,1,1,0,3,2,1,3,1,4
6156,3662,3668,36,12,2,0,1,1,0,1,-1,1,3,1
6157,3662,3668,52,13,2,0,1,1,1,3,-2,1,3,1
6158,3676,3682,28,4,4,2,2,0,7,5,2,6,2,8
6159,3676,3682,36,13,4,0,3,1,1,2,-1,3,5,3
6160,3676,3682,21,5,4,2,1,1,3,4,-1,5,3,7
6161,3676,3682,4,11,4,1,1,2,7,7,0,3,5,4
6162,3676,3682,1,3,4,2,2,0,7,2,5,6,2,8
6163,3676,3682,43,1,4,4,0,0,10,1,9,8,0,12
6164,3676,3682,26,9,4,1,2,1,2,5,-3,4,4,5
6165,3676,3682,52,15,4,0,1,3,3,7,-4,1,7,1
6166,3676,3682,49,2,4,2,2,0,11,2,9,6,2,8
6167,3676,3682,37,8,4,1,2,1,1,3,-2,4,4,5
6168,3676,3682,17,6,4,2,0,2,5,3,2,4,4,6
6169,3676,3682,41,7,4,2,0,2,5,4,1,4,4,6
6170,3676,3682,20,14,4,0,3,1,2,4,-2,3,5,3
6171,3676,3682,53,10,4,1,2,1,1,4,-3,4,4,5
6172,3676,3682,39,12,4,1,0,3,5,11,-6,2,6,3
6173,3676,3682,27,16,4,0,1,3,1,7,-6,1,7,1
6174,4264,4382,39,10,30,10,8,12,26,40,-14,28,32,38
6175,4264,4382,1,2,30,18,9,3,57,22,35,45,15,63
6176,4264,4382,53,9,30,11,5,14,33,39,-6,27,33,38
6177,4264,4382,41,8,30,12,4,14,41,47,-6,28,32,40
6178,4264,4382,20,15,30,7,7,16,30,44,-14,21,39,28
6179,4264,4382,43,1,30,19,7,4,67,25,42,45,15,64
6180,4264,4382,57,5,30,12,8,10,30,24,6,32,28,44
6181,4264,4382,24,7,30,10,11,9,35,31,4,31,29,41
6182,4264,4382,26,14,30,6,12,12,17,35,-18,24,36,30
6183,4264,4382,17,6,30,11,8,11,36,42,-6,30,30,41
6184,4264,4382,49,3,30,15,11,4,48,19,29,41,19,56
6185,4264,4382,37,16,30,5,6,19,21,52,-31,16,44,21
6186,4264,4382,21,12,30,8,9,13,32,33,-1,25,35,33
6187,4264,4382,52,4,30,13,10,7,42,28,14,36,24,49
6188,4264,4382,28,11,30,9,8,13,31,42,-11,26,34,35
6189,4264,4382,36,13,30,8,9,13,27,50,-23,25,35,33
6190,4047,4053,52,3,5,3,2,0,5,2,3,8,2,11
6191,4047,4053,28,7,5,2,1,2,5,5,0,5,5,7
6192,4047,4053,36,16,5,0,2,3,5,12,-7,2,8,2
6193,4047,4053,21,12,5,1,1,3,7,9,-2,3,7,4
6194,4047,4053,1,1,5,4,1,0,14,4,10,9,1,13
6195,4047,4053,17,14,5,1,1,3,5,7,-2,3,7,4
6196,4047,4053,49,2,5,4,0,1,11,4,7,8,2,12
6197,4047,4053,37,9,5,2,0,3,6,7,-1,4,6,6
6198,4047,4053,43,5,5,2,2,1,7,7,0,6,4,8
6199,4047,4053,57,6,5,2,1,2,3,2,1,5,5,7
6200,4047,4053,26,10,5,1,3,1,3,3,0,5,5,6
6201,4047,4053,24,11,5,1,2,2,4,6,-2,4,6,5
6202,4047,4053,41,8,5,2,1,2,7,10,-3,5,5,7
6203,4047,4053,20,12,5,1,1,3,7,9,-2,3,7,4
6204,4047,4053,53,15,5,1,1,3,6,9,-3,3,7,4
6205,4047,4053,39,4,5,3,1,1,4,3,1,7,3,10
6206,4061,4067,39,4,7,4,1,2,6,10,-4,9,5,13
6207,5877,5880,27,11,6,2,0,4,5,8,-3,4,8,6
6208,5877,5880,12,5,6,3,2,1,7,4,3,8,4,11
6209,5877,5880,53,8,6,3,1,2,14,12,2,7,5,10
6210,5877,5880,17,9,6,3,1,2,9,10,-1,7,5,10
6211,5877,5880,8,17,6,1,0,5,5,9,-4,2,10,3
6212,5877,5880,49,6,6,3,2,1,9,7,2,8,4,11
6213,5877,5880,37,15,6,0,4,2,5,9,-4,4,8,4
6214,5877,5880,5,18,6,1,0,5,8,13,-5,2,10,3
6215,5877,5880,52,4,6,3,2,1,7,3,4,8,4,11
6216,5877,5880,56,7,6,3,2,1,8,6,2,8,4,11
6217,5877,5880,41,13,6,1,2,3,5,10,-5,4,8,5
6218,5877,5880,20,14,6,1,1,4,5,11,-6,3,9,4
6219,5877,5880,43,3,6,3,3,0,15,5,10,9,3,12
6220,5877,5880,57,10,6,2,2,2,7,10,-3,6,6,8
6221,5877,5880,24,12,6,1,2,3,6,11,-5,4,8,5
6222,5877,5880,22,16,6,1,0,5,5,8,-3,2,10,3
6223,5877,5880,21,2,6,5,1,0,11,5,6,11,1,16
6224,5888,5894,43,4,8,4,4,0,20,7,13,12,4,16
6225,5888,5894,57,9,8,3,3,2,12,14,-2,9,7,12
6226,5888,5894,22,15,8,2,0,6,7,10,-3,4,12,6
6227,5888,5894,24,16,8,1,3,4,8,14,-6,5,11,6
6228,5888,5894,56,8,8,3,3,2,10,9,1,9,7,12
6229,5888,5894,20,13,8,2,1,5,11,15,-4,5,11,7
6230,5888,5894,41,17,8,1,2,5,5,13,-8,4,12,5
6231,5888,5894,21,2,8,5,2,1,12,9,3,12,4,17
6232,5888,5894,49,5,8,4,3,1,10,7,3,11,5,15
6233,5888,5894,37,14,8,1,4,3,7,13,-6,6,10,7
6234,5888,5894,5,18,8,1,1,6,10,20,-10,3,13,4
6235,5888,5894,17,3,8,5,1,2,13,11,2,11,5,16
6236,5888,5894,8,12,8,2,1,5,9,12,-3,5,11,7
6237,5888,5894,53,7,8,4,1,3,16,14,2,9,7,13
6238,5888,5894,12,10,8,3,2,3,10,9,1,8,8,11
6239,5888,5894,52,6,8,4,2,2,11,5,6,10,6,14
6240,5888,5894,27,11,8,3,1,4,7,9,-2,7,9,10
6241,5888,5894,1,1,8,6,2,0,19,6,13,14,2,20
6242,6189,6195,1,7,1,0,1,0,2,2,0,1,1,1
6243,6189,6195,52,7,1,0,1,0,2,2,0,1,1,1
6244,6189,6195,27,5,1,1,0,0,1,0,1,2,0,3
6245,6189,6195,12,3,1,1,0,0,4,2,2,2,0,3
6246,6189,6195,53,11,1,0,1,0,1,1,0,1,1,1
6247,6189,6195,8,13,1,0,0,1,0,1,-1,0,2,0
6248,6189,6195,17,17,1,0,0,1,0,3,-3,0,2,0
6249,6189,6195,49,4,1,1,0,0,3,1,2,2,0,3
6250,6189,6195,14,7,1,0,1,0,2,2,0,1,1,1
6251,6189,6195,37,17,1,0,0,1,0,3,-3,0,2,0
6252,6189,6195,21,7,1,0,1,0,2,2,0,1,1,1
6253,6189,6195,56,5,1,1,0,0,1,0,1,2,0,3
6254,6189,6195,20,13,1,0,0,1,0,1,-1,0,2,0
6255,6189,6195,41,16,1,0,0,1,1,3,-2,0,2,0
6256,6189,6195,43,1,1,1,0,0,3,0,3,2,0,3
6257,6189,6195,22,1,1,1,0,0,3,0,3,2,0,3
6258,6189,6195,57,11,1,0,1,0,1,1,0,1,1,1
6259,6189,6195,40,15,1,0,0,1,2,4,-2,0,2,0
6260,6245,6251,43,2,11,6,3,2,22,8,14,15,7,21
6261,6245,6251,22,4,11,6,3,2,20,11,9,15,7,21
6262,6245,6251,40,13,11,4,1,6,14,21,-7,9,13,13
6263,6245,6251,57,16,11,2,3,6,9,20,-11,7,15,9
6264,6245,6251,56,9,11,4,3,4,12,14,-2,11,11,15
6265,6245,6251,20,12,11,4,1,6,14,17,-3,9,13,13
6266,6245,6251,41,17,11,2,2,7,12,21,-9,6,16,8
6267,6245,6251,21,8,11,4,4,3,15,11,4,12,10,16
6268,6245,6251,49,3,11,6,3,2,24,15,9,15,7,21
6269,6245,6251,37,5,11,6,2,3,18,10,8,14,8,20
6270,6245,6251,14,18,11,2,1,8,14,31,-17,5,17,7
6271,6245,6251,17,6,11,5,4,2,14,8,6,14,8,19
6272,6245,6251,8,14,11,4,1,6,7,14,-7,9,13,13
6273,6245,6251,27,7,11,5,1,5,14,18,-4,11,11,16
6274,6245,6251,1,1,11,7,1,3,27,21,6,15,7,22
6275,6245,6251,52,15,11,3,4,4,18,18,0,10,12,13
6276,6245,6251,53,10,11,3,6,2,20,18,2,12,10,15
6277,6245,6251,12,11,11,4,1,6,14,12,2,9,13,13
6278,6196,6202,27,10,2,1,0,1,1,3,-2,2,2,3
6279,6196,6202,52,6,2,1,1,0,5,3,2,3,1,4
6280,6196,6202,17,10,2,1,0,1,1,3,-2,2,2,3
6281,6196,6202,8,16,2,0,0,2,0,2,-2,0,4,0
6282,6196,6202,49,1,2,2,0,0,6,2,4,4,0,6
6283,6196,6202,37,8,2,1,0,1,3,3,0,2,2,3
6284,6196,6202,14,13,2,0,1,1,3,5,-2,1,3,1
6285,6196,6202,21,13,2,0,1,1,3,5,-2,1,3,1
6286,6196,6202,20,7,2,1,0,1,5,1,4,2,2,3
6287,6196,6202,56,9,2,1,0,1,2,4,-2,2,2,3
6288,6196,6202,41,18,2,0,0,2,1,4,-3,0,4,0
6289,3704,3710,28,9,8,2,4,2,11,14,-3,8,8,10
6290,3704,3710,52,12,8,2,2,4,10,13,-3,6,10,8
6291,3704,3710,36,15,8,1,4,3,6,10,-4,6,10,7
6292,3704,3710,4,11,8,2,2,4,11,13,-2,6,10,8
6293,4110,4116,21,7,12,5,3,4,18,13,5,13,11,18
6294,4110,4116,1,1,12,8,4,0,26,8,18,20,4,28
6295,4110,4116,53,16,12,2,2,8,9,21,-12,6,18,8
6296,4110,4116,17,14,12,2,4,6,12,19,-7,8,16,10
6297,4110,4116,43,3,12,6,3,3,26,15,11,15,9,21
6298,4110,4116,57,4,12,6,3,3,11,9,2,15,9,21
6299,4110,4116,24,8,12,4,4,4,11,8,3,12,12,16
6300,4110,4116,26,15,12,1,6,5,6,15,-9,8,16,9
6301,4110,4116,41,10,12,4,2,6,13,24,-11,10,14,14
6302,4110,4116,20,12,12,3,3,6,15,16,-1,9,15,12
6303,4110,4116,49,2,12,8,3,1,24,6,18,19,5,27
6304,4110,4116,37,13,12,3,2,7,12,18,-6,8,16,11
6305,4110,4116,52,5,12,6,2,4,15,11,4,14,10,20
6306,4110,4116,36,9,12,4,3,5,13,22,-9,11,13,15
6307,4110,4116,28,11,12,3,4,5,11,14,-3,10,14,13
6308,4110,4116,39,6,12,6,2,4,12,15,-3,14,10,20
6309,4194,4200,1,1,22,16,4,2,48,16,32,36,8,52
6310,4194,4200,39,12,22,6,6,10,17,34,-17,18,26,24
6311,4194,4200,43,3,22,12,6,4,44,21,23,30,14,42
6312,4194,4200,57,5,22,9,6,7,20,18,2,24,20,33
6313,4194,4200,24,6,22,8,8,6,26,16,10,24,20,32
6314,4194,4200,26,14,22,4,10,8,14,23,-9,18,26,22
6315,4194,4200,49,2,22,13,7,2,40,13,27,33,11,46
6316,4194,4200,37,16,22,4,4,14,14,36,-22,12,32,16
6317,4194,4200,41,9,22,8,3,11,26,36,-10,19,25,27
6318,4194,4200,20,15,22,5,5,12,24,34,-10,15,29,20
6319,4194,4200,17,10,22,7,5,10,25,35,-10,19,25,26
6320,4194,4200,21,11,22,6,7,9,24,24,0,19,25,25
6321,4194,4200,53,13,22,6,5,11,19,29,-10,17,27,23
6322,4194,4200,52,4,22,10,5,7,27,20,7,25,19,35
6323,4194,4200,28,7,22,8,5,9,23,27,-4,21,23,29
6324,4194,4200,36,8,22,7,8,7,23,32,-9,22,22,29
6325,4201,4207,52,4,23,10,6,7,27,20,7,26,20,36
6326,4201,4207,28,7,23,8,6,9,23,27,-4,22,24,30
6327,4201,4207,36,9,23,7,8,8,23,34,-11,22,24,29
6328,4201,4207,53,11,23,7,5,11,20,29,-9,19,27,26
6329,4201,4207,21,12,23,6,7,10,24,25,-1,19,27,25
6330,4201,4207,17,8,23,8,5,10,28,36,-8,21,25,29
6331,4201,4207,24,6,23,8,9,6,26,16,10,25,21,33
6332,4201,4207,26,14,23,4,10,9,14,28,-14,18,28,22
6333,4201,4207,41,10,23,8,3,12,27,39,-12,19,27,27
6334,4201,4207,20,15,23,5,6,12,24,34,-10,16,30,21
6335,4201,4207,49,2,23,13,8,2,40,13,27,34,12,47
6336,4201,4207,37,16,23,4,5,14,14,36,-22,13,33,17
6337,4201,4207,43,3,23,13,6,4,49,21,28,32,14,45
6338,4201,4207,57,5,23,10,6,7,22,18,4,26,20,36
6339,4201,4207,39,13,23,6,7,10,17,34,-17,19,27,25
6340,4201,4207,1,1,23,16,5,2,48,16,32,37,9,53
6341,4054,4060,39,4,6,4,1,1,6,4,2,9,3,13
6342,4054,4060,24,14,6,1,2,3,4,7,-3,4,8,5
6343,4054,4060,52,3,6,4,2,0,7,3,4,10,2,14
6344,4054,4060,28,6,6,2,2,2,7,7,0,6,6,8
6345,4054,4060,36,15,6,1,2,3,6,12,-6,4,8,5
6346,4054,4060,49,1,6,5,0,1,15,4,11,10,2,15
6347,4054,4060,37,11,6,2,0,4,7,10,-3,4,8,6
6348,4054,4060,41,9,6,2,1,3,8,12,-4,5,7,7
6349,4054,4060,20,8,6,2,1,3,10,10,0,5,7,7
6350,4054,4060,57,5,6,2,2,2,4,3,1,6,6,8
6351,4054,4060,43,7,6,2,2,2,7,11,-4,6,6,8
6352,4054,4060,26,10,6,1,4,1,3,3,0,6,6,7
6353,4054,4060,17,12,6,1,2,3,7,9,-2,4,8,5
6354,4054,4060,53,13,6,1,2,3,6,9,-3,4,8,5
6355,4054,4060,1,2,6,4,2,0,15,5,10,10,2,14
6356,4054,4060,21,16,6,1,1,4,8,11,-3,3,9,4
6357,4453,4466,21,6,10,5,1,4,14,9,5,11,9,16
6358,4453,4466,53,7,10,5,1,4,17,14,3,11,9,16
6359,4453,4466,52,8,10,3,6,1,9,4,5,12,8,15
6360,4453,4466,48,11,10,3,3,4,7,9,-2,9,11,12
6361,4453,4466,28,15,10,1,4,5,4,9,-5,6,14,7
6362,4453,4466,36,16,10,0,2,8,8,25,-17,2,18,2
6363,4453,4466,17,3,10,5,3,2,16,14,2,13,7,18
6364,4453,4466,8,10,10,3,4,3,9,13,-4,10,10,13
6365,4453,4466,43,4,10,5,2,3,15,9,6,12,8,17
6366,4453,4466,57,5,10,5,2,3,12,12,0,12,8,17
6367,4453,4466,24,9,10,3,5,2,15,12,3,11,9,14
6368,4453,4466,26,14,10,1,4,5,5,10,-5,6,14,7
6369,6350,6356,57,18,21,2,6,13,13,42,-29,10,32,12
6370,6350,6356,49,2,21,12,5,4,40,23,17,29,13,41
6371,6350,6356,37,4,21,11,5,5,31,17,14,27,15,38
6372,6350,6356,14,17,21,4,5,12,26,51,-25,13,29,17
6373,6357,6363,49,2,22,13,5,4,42,24,18,31,13,44
6374,6357,6363,37,5,22,11,5,6,32,19,13,27,17,38
6375,6357,6363,14,17,22,4,5,13,27,54,-27,13,31,17
6376,6357,6363,43,4,22,11,5,6,36,22,14,27,17,38
6377,6357,6363,22,7,22,9,8,5,33,27,6,26,18,35
6378,6357,6363,40,14,22,6,5,11,21,37,-16,17,27,23
6379,6357,6363,57,18,22,2,6,14,13,43,-30,10,34,12
6380,6357,6363,1,1,22,15,4,3,52,32,20,34,10,49
6381,6357,6363,21,11,22,7,7,8,28,26,2,21,23,28
6382,6357,6363,17,3,22,12,4,6,38,26,12,28,16,40
6383,6357,6363,8,13,22,7,5,10,21,28,-7,19,25,26
6384,6357,6363,20,9,22,8,5,9,31,33,-2,21,23,29
6385,6357,6363,56,15,22,5,8,9,27,34,-7,18,26,23
6386,6357,6363,41,16,22,4,6,12,27,39,-12,14,30,18
6387,6357,6363,52,8,22,8,6,8,40,35,5,22,22,30
6388,6357,6363,53,6,22,9,10,3,42,26,16,28,16,37
6389,6357,6363,12,12,22,7,6,9,30,26,4,20,24,27
6390,6357,6363,27,10,22,8,4,10,29,38,-9,20,24,28
6391,6399,6405,27,13,27,8,5,14,31,47,-16,21,33,29
6392,6399,6405,12,11,27,9,8,10,39,31,8,26,28,35
6393,6399,6405,21,8,27,11,7,9,36,29,7,29,25,40
6394,6399,6405,20,12,27,8,7,12,33,42,-9,23,31,31
6395,6399,6405,56,15,27,6,9,12,31,42,-11,21,33,27
6396,6399,6405,41,16,27,6,8,13,38,43,-5,20,34,26
6397,6399,6405,17,4,27,15,4,8,49,34,15,34,20,49
6398,6399,6405,8,10,27,10,5,12,28,34,-6,25,29,35
6399,6399,6405,1,1,27,18,6,3,62,37,25,42,12,60
6400,6399,6405,43,3,27,16,5,6,49,23,26,37,17,53
6401,6399,6405,22,7,27,11,8,8,41,41,0,30,24,41
6402,6399,6405,40,14,27,7,6,14,25,50,-25,20,34,27
6403,6399,6405,57,18,27,3,8,16,19,51,-32,14,40,17
6404,6399,6405,53,9,27,9,11,7,45,34,11,29,25,38
6405,6399,6405,52,6,27,12,6,9,47,39,8,30,24,42
6406,6399,6405,49,2,27,16,7,4,55,27,28,39,15,55
6407,6399,6405,37,5,27,13,6,8,37,24,13,32,22,45
6408,6399,6405,14,17,27,4,6,17,28,65,-37,14,40,18
6409,6224,6226,14,18,6,0,1,5,8,18,-10,1,11,1
6410,6224,6226,49,1,6,4,1,1,16,8,8,9,3,13
6411,6224,6226,37,6,6,3,1,2,8,7,1,7,5,10
6412,6224,6226,52,10,6,2,3,1,12,7,5,7,5,9
6413,6224,6226,8,7,6,3,1,2,3,2,1,7,5,10
6414,6224,6226,17,9,6,3,1,2,4,5,-1,7,5,10
6415,6224,6226,21,15,6,1,2,3,5,8,-3,4,8,5
6416,6224,6226,41,17,6,0,2,4,5,10,-5,2,10,2
6417,6224,6226,56,8,6,3,1,2,7,7,0,7,5,10
6418,6224,6226,20,14,6,2,0,4,9,10,-1,4,8,6
6419,6224,6226,57,16,6,1,2,3,5,13,-8,4,8,5
6420,6224,6226,22,2,6,4,1,1,12,6,6,9,3,13
6421,6224,6226,43,4,6,3,2,1,15,6,9,8,4,11
6422,6224,6226,40,11,6,2,1,3,10,13,-3,5,7,7
6423,6224,6226,12,5,6,3,1,2,11,7,4,7,5,10
6424,6224,6226,53,13,6,1,4,1,9,9,0,6,6,7
6425,6224,6226,27,12,6,2,1,3,6,13,-7,5,7,7
6426,6224,6226,1,3,6,4,1,1,16,12,4,9,3,13
6427,6766,6769,1,3,23,10,10,3,36,24,12,30,16,40
6428,6766,6769,27,11,23,8,4,11,24,31,-7,20,26,28
6429,6766,6769,12,6,23,9,8,6,28,23,5,26,20,35
6430,6766,6769,53,10,23,8,6,9,30,29,1,22,24,30
6431,6766,6769,52,4,23,11,6,6,33,24,9,28,18,39
6432,6766,6769,48,16,23,3,11,9,13,27,-14,17,29,20
6433,6766,6769,40,17,23,4,6,13,31,53,-22,14,32,18
6434,6766,6769,43,2,23,15,1,7,53,26,27,31,15,46
6435,6766,6769,22,12,23,6,9,8,29,31,-2,21,25,27
6436,6766,6769,56,18,23,3,9,11,17,41,-24,15,31,18
6437,6766,6769,20,14,23,4,11,8,17,30,-13,19,27,23
6438,6766,6769,41,15,23,5,6,12,25,35,-10,16,30,21
6439,6766,6769,37,1,23,15,6,2,44,15,29,36,10,51
6440,6766,6769,49,5,23,10,7,6,29,21,8,27,19,37
6441,6766,6769,21,7,23,8,10,5,28,24,4,26,20,34
6442,6766,6769,19,8,23,8,9,6,29,24,5,25,21,33
6443,6766,6769,17,9,23,9,3,11,28,32,-4,21,25,30
6444,6766,6769,8,13,23,6,8,9,23,27,-4,20,26,26
6445,6819,6825,17,8,31,11,6,14,36,43,-7,28,34,39
6446,6819,6825,19,9,31,9,12,10,38,38,0,30,32,39
6447,6819,6825,8,13,31,8,11,12,31,41,-10,27,35,35
6448,6056,6062,43,3,27,15,6,6,57,31,26,36,18,51
6449,6056,6062,57,9,27,10,8,9,49,41,8,28,26,38
6450,6056,6062,22,13,27,7,8,12,29,34,-5,22,32,29
6451,6056,6062,24,16,27,5,7,15,29,50,-21,17,37,22
6452,6056,6062,12,4,27,13,6,8,39,27,12,32,22,45
6453,6056,6062,20,10,27,10,6,11,39,36,3,26,28,36
6454,6056,6062,56,12,27,8,9,10,34,39,-5,25,29,33
6455,6056,6062,41,18,27,5,5,17,21,63,-42,15,39,20
6456,6056,6062,49,5,27,12,8,7,34,22,12,32,22,44
6457,6056,6062,37,11,27,9,8,10,26,32,-6,26,28,35
6458,6056,6062,5,17,27,5,6,16,32,54,-22,16,38,21
6459,6056,6062,21,7,27,11,8,8,34,35,-1,30,24,41
6460,6056,6062,17,8,27,11,5,11,34,34,0,27,27,38
6461,6056,6062,8,14,27,7,8,12,32,39,-7,22,32,29
6462,6056,6062,1,1,27,18,5,4,55,24,31,41,13,59
6463,6056,6062,53,6,27,11,10,6,53,39,14,32,22,43
6464,6056,6062,52,2,27,15,7,5,45,31,14,37,17,52
6465,6063,6069,52,3,28,15,7,6,45,32,13,37,19,52
6466,6063,6069,1,1,28,19,5,4,56,24,32,43,13,62
6467,6063,6069,17,7,28,12,5,11,36,34,2,29,27,41
6468,6063,6069,8,14,28,7,8,13,34,42,-8,22,34,29
6469,6063,6069,21,9,28,11,8,9,34,37,-3,30,26,41
6470,6063,6069,49,4,28,13,8,7,37,24,13,34,22,47
6471,6063,6069,37,11,28,10,8,10,29,33,-4,28,28,38
6472,6063,6069,5,17,28,5,6,17,32,56,-24,16,40,21
6473,6063,6069,20,10,28,11,6,11,41,36,5,28,28,39
6474,6063,6069,56,12,28,9,9,10,36,39,-3,27,29,36
6475,6063,6069,41,18,28,5,5,18,22,66,-44,15,41,20
6476,6063,6069,43,2,28,16,6,6,60,31,29,38,18,54
6477,6063,6069,57,8,28,11,8,9,50,41,9,30,26,41
6478,6063,6069,22,13,28,8,8,12,31,34,-3,24,32,32
6479,6063,6069,24,16,28,5,7,16,29,52,-23,17,39,22
6480,6063,6069,27,15,28,7,8,13,23,35,-12,22,34,29
6481,6063,6069,12,5,28,13,6,9,39,30,9,32,24,45
6482,6063,6069,53,6,28,11,10,7,53,41,12,32,24,43
6483,6287,6293,27,10,14,5,3,6,19,24,-5,13,15,18
6484,6287,6293,1,1,14,9,2,3,34,23,11,20,8,29
6485,6287,6293,43,2,14,8,4,2,27,11,16,20,8,28
6486,6287,6293,22,5,14,6,5,3,23,15,8,17,11,23
6487,6287,6293,40,14,14,5,1,8,16,28,-12,11,17,16
6488,6287,6293,57,18,14,2,3,9,9,26,-17,7,21,9
6489,6287,6293,53,8,14,4,8,2,23,19,4,16,12,20
6490,6287,6293,12,11,14,5,2,7,19,17,2,12,16,17
6491,6287,6293,21,6,14,6,4,4,21,13,8,16,12,22
6492,6287,6293,17,9,14,5,4,5,16,16,0,14,14,19
6493,6287,6293,8,12,14,5,2,7,11,18,-7,12,16,17
6494,6287,6293,52,15,14,4,4,6,24,25,-1,12,16,16
6495,6287,6293,20,7,14,6,2,6,19,18,1,14,14,20
6496,6287,6293,56,13,14,4,5,5,15,19,-4,13,15,17
6497,6287,6293,41,16,14,3,4,7,16,23,-7,10,18,13
6498,6287,6293,49,3,14,8,3,3,31,20,11,19,9,27
6499,6287,6293,37,4,14,7,3,4,21,13,8,17,11,24
6500,6287,6293,14,17,14,3,3,8,18,34,-16,9,19,12
6501,6378,6391,52,9,25,10,6,9,44,38,6,26,24,36
6502,6378,6391,57,18,25,3,6,16,17,49,-32,12,38,15
6503,6378,6391,20,12,25,8,6,11,32,38,-6,22,28,30
6504,6378,6391,56,14,25,6,8,11,30,38,-8,20,30,26
6505,6378,6391,41,15,25,6,7,12,38,42,-4,19,31,25
6506,6378,6391,17,2,25,15,4,6,46,29,17,34,16,49
6507,6378,6391,8,10,25,9,5,11,25,33,-8,23,27,32
6508,6378,6391,1,1,25,17,5,3,59,35,24,39,11,56
6509,6378,6391,49,3,25,14,7,4,45,25,20,35,15,49
6510,6378,6391,37,5,25,12,6,7,36,23,13,30,20,42
6511,6378,6391,14,17,25,4,5,16,27,61,-34,13,37,17
6512,6378,6391,21,8,25,10,7,8,34,27,7,27,23,37
6513,6378,6391,53,7,25,9,11,5,44,31,13,29,21,38
6514,6378,6391,12,11,25,8,7,10,36,30,6,23,27,31
6515,6378,6391,43,4,25,14,5,6,44,22,22,33,17,47
6516,6378,6391,22,6,25,10,8,7,37,33,4,28,22,38
6517,6378,6391,40,16,25,6,5,14,23,49,-26,17,33,23
6518,6378,6391,27,13,25,8,4,13,30,44,-14,20,30,28
6519,6413,6419,27,13,29,9,5,15,33,50,-17,23,35,32
6520,6413,6419,52,7,29,13,6,10,51,42,9,32,26,45
6521,6413,6419,53,9,29,10,12,7,51,36,15,32,26,42
6522,6413,6419,12,12,29,9,9,11,40,35,5,27,31,36
6523,6413,6419,20,10,29,10,7,12,39,42,-3,27,31,37
6524,6413,6419,56,14,29,6,10,13,31,43,-12,22,36,28
6525,6413,6419,41,16,29,6,9,14,38,44,-6,21,37,27
6526,5965,5971,20,13,16,5,2,9,20,27,-7,12,20,17
6527,5965,5971,41,17,16,3,3,10,12,42,-30,9,23,12
6528,5965,5971,17,7,16,8,3,5,23,20,3,19,13,27
6529,5965,5971,8,12,16,5,3,8,22,24,-2,13,19,18
6530,5965,5971,49,9,16,6,6,4,17,13,4,18,14,24
6531,5965,5971,37,14,16,2,8,6,11,21,-10,12,20,14
6532,5965,5971,5,18,16,2,3,11,20,35,-15,7,25,9
6533,5965,5971,43,3,16,8,5,3,37,21,16,21,11,29
6534,5965,5971,57,8,16,7,5,4,33,21,12,19,13,26
6535,5965,5971,22,11,16,5,5,6,20,16,4,15,17,20
6536,5965,5971,24,15,16,3,4,9,14,26,-12,10,22,13
6537,5965,5971,53,4,16,8,4,4,34,24,10,20,12,28
6538,5965,5971,12,10,16,5,6,5,20,18,2,16,16,21
6539,5965,5971,52,2,16,9,5,2,26,13,13,23,9,32
6540,5965,5971,1,1,16,10,4,2,32,14,18,24,8,34
6541,5965,5971,21,5,16,8,4,4,23,18,5,20,12,28
6542,5965,5971,27,16,16,3,4,9,11,25,-14,10,22,13
6543,6014,6027,27,16,23,5,7,11,19,32,-13,17,29,22
6544,6014,6027,52,2,23,12,7,4,36,24,12,31,15,43
6545,6014,6027,1,1,23,15,4,4,49,22,27,34,12,49
6546,6014,6027,21,7,23,9,7,7,30,32,-2,25,21,34
6547,6014,6027,12,4,23,11,6,6,34,22,12,28,18,39
6548,6014,6027,53,6,23,9,8,6,44,35,9,26,20,35
6549,6014,6027,49,5,23,10,7,6,27,19,8,27,19,37
6550,6014,6027,37,12,23,7,8,8,23,28,-5,22,24,29
6551,6014,6027,5,17,23,4,6,13,27,44,-17,14,32,18
6552,6014,6027,17,8,23,9,5,9,29,28,1,23,23,32
6553,6014,6027,8,14,23,7,6,10,31,35,-4,20,26,27
6554,6014,6027,56,9,23,8,8,7,31,32,-1,24,22,32
6555,6014,6027,20,11,23,8,5,10,33,33,0,21,25,29
6556,6014,6027,24,15,23,5,7,11,25,35,-10,17,29,22
6557,6014,6027,43,3,23,12,6,5,52,29,23,30,16,42
6558,6014,6027,57,10,23,8,7,8,41,36,5,23,23,31
6559,6014,6027,22,13,23,7,6,10,27,30,-3,20,26,27
6560,6014,6027,41,18,23,4,4,15,14,56,-42,12,34,16
6561,6028,6034,56,9,24,8,9,7,32,33,-1,25,23,33
6562,6028,6034,20,12,24,8,5,11,33,34,-1,21,27,29
6563,6028,6034,41,17,24,5,4,15,19,56,-37,14,34,19
6564,6028,6034,43,3,24,12,6,6,52,31,21,30,18,42
6565,6028,6034,57,8,24,9,7,8,45,37,8,25,23,34
6566,6028,6034,22,13,24,7,7,10,28,31,-3,21,27,28
6567,6028,6034,24,16,24,5,7,12,26,38,-12,17,31,22
6568,6028,6034,17,10,24,9,5,10,30,32,-2,23,25,32
6569,6028,6034,8,14,24,7,6,11,32,37,-5,20,28,27
6570,6028,6034,49,5,24,10,8,6,28,20,8,28,20,38
6571,6028,6034,37,11,24,8,8,8,24,28,-4,24,24,32
6572,6028,6034,5,18,24,4,6,14,27,49,-22,14,34,18
6573,6028,6034,12,4,24,12,6,6,37,23,14,30,18,42
6574,6028,6034,53,6,24,9,9,6,45,36,9,27,21,36
6575,6028,6034,52,2,24,13,7,4,38,25,13,33,15,46
6576,6028,6034,1,1,24,15,5,4,49,22,27,35,13,50
6577,6028,6034,21,7,24,9,8,7,30,32,-2,26,22,35
6578,6028,6034,27,15,24,6,7,11,21,32,-11,19,29,25
6579,5881,5887,27,11,7,3,0,4,7,9,-2,6,8,9
6580,5881,5887,52,7,7,3,2,2,8,5,3,8,6,11
6581,5881,5887,17,6,7,4,1,2,11,11,0,9,5,13
6582,5881,5887,8,13,7,2,0,5,8,11,-3,4,10,6
6583,5881,5887,1,1,7,6,1,0,17,4,13,13,1,19
6584,5881,5887,49,4,7,4,2,1,10,7,3,10,4,14
6585,5881,5887,37,16,7,0,4,3,5,12,-7,4,10,4
6586,5881,5887,5,18,7,1,0,6,9,19,-10,2,12,3
6587,5881,5887,53,5,7,4,1,2,15,12,3,9,5,13
6588,5881,5887,12,8,7,3,2,2,9,7,2,8,6,11
6589,5881,5887,43,3,7,4,3,0,19,6,13,11,3,15
6590,5881,5887,56,9,7,3,2,2,10,9,1,8,6,11
6591,5881,5887,20,12,7,2,1,4,11,12,-1,5,9,7
6592,5881,5887,41,15,7,1,2,4,5,11,-6,4,10,5
6593,5881,5887,21,2,7,5,1,1,12,9,3,11,3,16
6594,5881,5887,57,10,7,3,2,2,10,12,-2,8,6,11
6595,5881,5887,24,14,7,1,2,4,7,13,-6,4,10,5
6596,5881,5887,22,17,7,1,0,6,5,9,-4,2,12,3
6597,6406,6412,43,3,28,16,6,6,49,23,26,38,18,54
6598,6406,6412,22,8,28,11,8,9,41,44,-3,30,26,41
6599,6406,6412,40,15,28,7,6,15,25,54,-29,20,36,27
6600,6406,6412,57,17,28,4,8,16,21,51,-30,16,40,20
6601,6406,6412,20,12,28,9,7,12,36,42,-6,25,31,34
6602,6406,6412,56,14,28,6,10,12,31,42,-11,22,34,28
6603,6406,6412,41,16,28,6,9,13,38,43,-5,21,35,27
6604,6406,6412,21,7,28,12,7,9,39,30,9,31,25,43
6605,6196,6202,22,2,2,2,0,0,5,1,4,4,0,6
6606,6196,6202,43,5,2,1,1,0,4,1,3,3,1,4
6607,6196,6202,57,15,2,0,1,1,1,6,-5,1,3,1
6608,6196,6202,40,17,2,0,0,2,3,6,-3,0,4,0
6609,6196,6202,12,3,2,2,0,0,5,2,3,4,0,6
6610,6196,6202,53,12,2,0,2,0,2,2,0,2,2,2
6611,6196,6202,1,4,2,1,1,0,6,3,3,3,1,4
6612,6203,6212,1,2,3,2,1,0,8,3,5,5,1,7
6613,6203,6212,22,1,3,3,0,0,7,1,6,6,0,9
6614,6203,6212,43,3,3,2,1,0,7,2,5,5,1,7
6615,6203,6212,57,17,3,0,1,2,1,7,-6,1,5,1
6616,6203,6212,40,18,3,0,0,3,3,8,-5,0,6,0
6617,6203,6212,56,7,3,2,0,1,4,4,0,4,2,6
6618,6203,6212,20,11,3,1,0,2,5,4,1,2,4,3
6619,6203,6212,41,15,3,0,1,2,1,4,-3,1,5,1
6620,6203,6212,21,12,3,0,2,1,3,5,-2,2,4,2
6621,6203,6212,37,4,3,2,0,1,6,3,3,4,2,6
6622,6203,6212,49,5,3,2,0,1,7,5,2,4,2,6
6623,6203,6212,14,16,3,0,1,2,3,7,-4,1,5,1
6624,6203,6212,17,9,3,2,0,1,2,3,-1,4,2,6
6625,6203,6212,8,14,3,0,1,2,0,2,-2,1,5,1
6626,6203,6212,52,10,3,1,2,0,5,3,2,4,2,5
6627,6203,6212,27,8,3,2,0,1,3,3,0,4,2,6
6628,6203,6212,12,6,3,2,0,1,5,4,1,4,2,6
6629,6203,6212,53,13,3,0,2,1,2,4,-2,2,4,2
6630,6441,6447,53,6,33,12,14,7,58,40,18,38,28,50
6631,6441,6447,12,13,33,9,9,15,45,45,0,27,39,36
6632,6441,6447,52,7,33,14,6,13,52,46,6,34,32,48
6633,6441,6447,27,12,33,11,5,17,38,55,-17,27,39,38
6634,6441,6447,17,4,33,20,5,8,64,39,25,45,21,65
6635,6441,6447,8,10,33,13,7,13,38,43,-5,33,33,46
6636,6441,6447,49,3,33,20,8,5,70,33,37,48,18,68
6637,6441,6447,37,5,33,14,10,9,43,28,15,38,28,52
6638,6441,6447,14,18,33,4,7,22,29,82,-53,15,51,19
6639,6441,6447,21,8,33,13,9,11,44,35,9,35,31,48
6640,6441,6447,20,11,33,12,8,13,43,45,-2,32,34,44
6641,6441,6447,41,14,33,9,9,15,42,47,-5,27,39,36
6642,6441,6447,56,16,33,6,12,15,35,50,-15,24,42,30
6643,6441,6447,43,2,33,21,6,6,66,24,42,48,18,69
6644,6441,6447,22,9,33,13,8,12,49,54,-5,34,32,47
6645,6441,6447,40,15,33,8,7,18,28,63,-35,23,43,31
6646,6441,6447,57,17,33,4,8,21,23,63,-40,16,50,20
6647,6441,6447,1,1,33,22,6,5,72,47,25,50,16,72
6648,6784,6786,1,3,25,11,10,4,39,29,10,32,18,43
6649,6784,6786,43,2,25,17,1,7,58,27,31,35,15,52
6650,6784,6786,22,12,25,7,9,9,31,34,-3,23,27,30
6651,6784,6786,40,16,25,5,7,13,35,56,-21,17,33,22
6652,6784,6786,20,14,25,5,11,9,19,32,-13,21,29,26
6653,6784,6786,41,15,25,6,6,13,30,40,-10,18,32,24
6654,6784,6786,56,18,25,3,9,13,17,44,-27,15,35,18
6655,6784,6786,21,9,25,8,10,7,31,31,0,26,24,34
6656,6784,6786,37,1,25,16,6,3,48,18,30,38,12,54
6657,6784,6786,49,4,25,11,8,6,33,23,10,30,20,41
6658,6784,6786,19,7,25,9,9,7,34,27,7,27,23,36
6659,6784,6786,17,10,25,9,5,11,29,33,-4,23,27,32
6660,6784,6786,8,13,25,6,10,9,24,28,-4,22,28,28
6661,6784,6786,52,6,25,11,6,8,34,29,5,28,22,39
6662,6784,6786,48,17,25,3,11,11,13,31,-18,17,33,20
6663,6784,6786,27,11,25,9,5,11,27,32,-5,23,27,32
6664,6784,6786,12,5,25,11,8,6,32,24,8,30,20,41
6665,6784,6786,53,8,25,9,7,9,34,30,4,25,25,34
6666,6623,6629,53,2,9,5,1,3,15,6,9,11,7,16
6667,6623,6629,12,7,9,4,2,3,10,10,0,10,8,14
6668,6623,6629,52,10,9,4,1,4,13,15,-2,9,9,13
6669,6623,6629,48,17,9,0,4,5,4,15,-11,4,14,4
6670,6623,6629,27,12,9,4,0,5,11,17,-6,8,10,12
6671,6623,6629,17,3,9,5,1,3,14,11,3,11,7,16
6672,6623,6629,8,6,9,4,3,2,12,12,0,11,7,15
6673,6623,6629,19,8,9,3,5,1,7,5,2,11,7,14
6674,6623,6629,37,4,9,4,3,2,15,7,8,11,7,15
6675,6623,6629,49,5,9,4,3,2,17,12,5,11,7,15
6676,6623,6629,20,9,9,3,5,1,11,10,1,11,7,14
6677,6623,6629,41,14,9,3,0,6,9,16,-7,6,12,9
6678,6623,6629,56,18,9,0,2,7,3,16,-13,2,16,2
6679,6623,6629,21,11,9,3,4,2,10,7,3,10,8,13
6680,6623,6629,43,1,9,7,0,2,25,11,14,14,4,21
6681,6623,6629,40,15,9,2,3,4,15,16,-1,7,11,9
6682,6623,6629,22,16,9,2,2,5,7,12,-5,6,12,8
6683,6623,6629,1,13,9,2,5,2,10,10,0,9,9,11
6684,7022,7028,1,2,15,10,2,3,32,10,22,22,8,32
6685,7022,7028,43,5,15,8,2,5,31,17,14,18,12,26
6686,4061,4067,52,3,7,5,2,0,12,3,9,12,2,17
6687,4061,4067,28,6,7,3,2,2,9,7,2,8,6,11
6688,4061,4067,36,15,7,1,3,3,6,12,-6,5,9,6
6689,4061,4067,53,16,7,1,2,4,7,12,-5,4,10,5
6690,4061,4067,20,7,7,2,2,3,10,10,0,6,8,8
6691,4061,4067,41,10,7,2,1,4,8,17,-9,5,9,7
6692,4061,4067,43,5,7,3,2,2,13,11,2,8,6,11
6693,4061,4067,57,8,7,2,2,3,5,7,-2,6,8,8
6694,4061,4067,26,11,7,1,4,2,3,5,-2,6,8,7
6695,4061,4067,24,14,7,1,3,3,4,7,-3,5,9,6
6696,4061,4067,17,13,7,1,3,3,7,9,-2,5,9,6
6697,4061,4067,49,1,7,6,0,1,18,5,13,12,2,18
6698,4061,4067,37,12,7,2,0,5,8,13,-5,4,10,6
6699,4061,4067,1,2,7,5,2,0,18,6,12,12,2,17
6700,4061,4067,21,9,7,2,1,4,12,12,0,5,9,7
6701,4516,4522,1,1,16,11,3,2,32,13,19,25,7,36
6702,4516,4522,17,7,16,6,6,4,24,26,-2,18,14,24
6703,4516,4522,8,12,16,4,6,6,15,22,-7,14,18,18
6704,4516,4522,49,2,16,9,4,3,21,10,11,22,10,31
6705,4516,4522,52,5,16,6,9,1,22,7,15,21,11,27
6706,4516,4522,48,10,16,5,5,6,13,13,0,15,17,20
6707,4516,4522,28,13,16,2,7,7,9,18,-9,11,21,13
6708,4516,4522,36,15,16,3,2,11,14,31,-17,8,24,11
6709,4516,4522,43,3,16,8,4,4,28,19,9,20,12,28
6710,4516,4522,24,6,16,6,6,4,21,18,3,18,14,24
6711,4516,4522,57,8,16,6,4,6,18,20,-2,16,16,22
6712,4516,4522,26,16,16,2,5,9,9,19,-10,9,23,11
6713,4516,4522,41,11,16,5,4,7,13,17,-4,14,18,19
6714,4516,4522,53,4,16,8,3,5,23,18,5,19,13,27
6715,4516,4522,21,9,16,6,3,7,19,19,0,15,17,21
6716,4516,4522,39,14,16,2,7,7,8,19,-11,11,21,13
6717,4390,4396,39,12,2,0,1,1,0,1,-1,1,3,1
6718,4390,4396,53,7,2,1,0,1,4,3,1,2,2,3
6719,4390,4396,41,15,2,0,0,2,1,3,-2,0,4,0
6720,4390,4396,43,4,2,1,1,0,1,0,1,3,1,4
6721,4390,4396,26,4,2,1,1,0,1,0,1,3,1,4
6722,4390,4396,57,8,2,1,0,1,2,2,0,2,2,3
6723,4390,4396,24,8,2,1,0,1,2,2,0,2,2,3
6724,4390,4396,49,1,2,2,0,0,3,0,3,4,0,6
6725,4390,4396,17,3,2,1,1,0,2,1,1,3,1,4
6726,4390,4396,8,14,2,0,1,1,0,2,-2,1,3,1
6727,4390,4396,1,2,2,1,1,0,4,2,2,3,1,4
6728,4390,4396,21,10,2,1,0,1,1,1,0,2,2,3
6729,4390,4396,52,4,2,1,1,0,1,0,1,3,1,4
6730,4390,4396,48,11,2,0,2,0,2,2,0,2,2,2
6731,4390,4396,28,12,2,0,1,1,0,1,-1,1,3,1
6732,4390,4396,36,16,2,0,0,2,2,6,-4,0,4,0
6733,4551,4564,52,6,21,7,12,2,28,12,16,26,16,33
6734,4551,4564,48,9,21,7,8,6,19,17,2,22,20,29
6735,4551,4564,28,14,21,2,9,10,15,29,-14,13,29,15
6736,4551,4564,36,15,21,4,2,15,20,41,-21,10,32,14
6737,4551,4564,1,1,21,13,6,2,38,17,21,32,10,45
6738,4551,4564,21,8,21,9,3,9,29,25,4,21,21,30
6739,4551,4564,17,7,21,8,7,6,29,32,-3,23,19,31
6740,4551,4564,8,12,21,6,7,8,21,27,-6,19,23,25
6741,4551,4564,49,2,21,10,8,3,27,14,13,28,14,38
6742,4551,4564,41,11,21,7,7,7,20,22,-2,21,21,28
6743,4551,4564,43,3,21,10,6,5,38,22,16,26,16,36
6744,4551,4564,24,5,21,8,9,4,28,21,7,25,17,33
6745,4551,4564,57,10,21,7,7,7,23,24,-1,21,21,28
6746,4551,4564,26,16,21,2,6,13,11,34,-23,10,32,12
6747,4551,4564,53,4,21,10,4,7,28,24,4,24,18,34
6748,4551,4564,39,13,21,4,7,10,13,26,-13,15,27,19
6749,4397,4403,39,13,3,0,2,1,1,2,-1,2,4,2
6750,4397,4403,53,10,3,1,0,2,5,5,0,2,4,3
6751,4397,4403,41,11,3,1,0,2,3,4,-1,2,4,3
6752,4397,4403,49,1,3,3,0,0,4,0,4,6,0,9
6753,4397,4403,17,3,3,2,1,0,4,2,2,5,1,7
6754,4397,4403,8,14,3,0,2,1,1,3,-2,2,4,2
6755,4397,4403,26,5,3,1,2,0,2,1,1,4,2,5
6756,4397,4403,57,7,3,1,1,1,3,3,0,3,3,4
6757,4397,4403,24,7,3,1,1,1,3,3,0,3,3,4
6758,4397,4403,43,9,3,1,1,1,2,2,0,3,3,4
6759,4397,4403,1,2,3,2,1,0,6,3,3,5,1,7
6760,4397,4403,21,12,3,1,0,2,2,3,-1,2,4,3
6761,4397,4403,48,4,3,1,2,0,3,2,1,4,2,5
6762,4397,4403,52,5,3,1,2,0,2,1,1,4,2,5
6763,4397,4403,28,15,3,0,1,2,0,2,-2,1,5,1
6764,4397,4403,36,16,3,0,0,3,2,7,-5,0,6,0
6765,4418,4424,48,9,5,1,3,1,3,3,0,5,5,6
6766,4418,4424,52,11,5,1,3,1,2,2,0,5,5,6
6767,4418,4424,28,14,5,1,1,3,2,4,-2,3,7,4
6768,4453,4466,41,12,10,3,3,4,7,10,-3,9,11,12
6769,4453,4466,49,2,10,5,3,2,13,7,6,13,7,18
6770,4453,4466,1,1,10,7,2,1,23,9,14,16,4,23
6771,4453,4466,39,13,10,1,5,4,5,13,-8,7,13,8
6772,4544,4550,39,13,20,4,7,9,13,24,-11,15,25,19
6773,4544,4550,49,2,20,10,7,3,26,13,13,27,13,37
6774,4544,4550,52,5,20,7,11,2,27,11,16,25,15,32
6775,4544,4550,48,10,20,6,8,6,17,16,1,20,20,26
6776,4544,4550,28,14,20,2,9,9,14,26,-12,13,27,15
6777,4544,4550,36,15,20,4,2,14,18,38,-20,10,30,14
6778,4544,4550,43,3,20,10,6,4,37,20,17,26,14,36
6779,4544,4550,24,4,20,8,8,4,28,21,7,24,16,32
6780,4544,4550,57,7,20,7,7,6,23,22,1,21,19,28
6781,4544,4550,26,16,20,2,6,12,10,31,-21,10,30,12
6782,4544,4550,21,9,20,8,3,9,27,25,2,19,21,27
6783,4544,4550,41,11,20,6,7,7,17,20,-3,19,21,25
6784,4544,4550,53,6,20,9,4,7,25,23,2,22,18,31
6785,4544,4550,17,8,20,7,7,6,27,32,-5,21,19,28
6786,4544,4550,8,12,20,5,7,8,18,26,-8,17,23,22
6787,4544,4550,1,1,20,13,5,2,38,17,21,31,9,44
6788,4901,4907,1,8,19,7,5,7,34,28,6,19,19,26
6789,4901,4907,21,2,19,9,5,5,30,21,9,23,15,32
6790,4901,4907,53,12,19,5,6,8,26,32,-6,16,22,21
6791,4901,4907,52,3,19,8,8,3,30,16,14,24,14,32
6792,4901,4907,48,11,19,5,7,7,23,30,-7,17,21,22
6793,4901,4907,36,14,19,4,6,9,29,35,-6,14,24,18
6794,4901,4907,28,16,19,1,10,8,16,31,-15,12,26,13
6795,4901,4907,17,13,19,4,9,6,24,29,-5,17,21,21
6796,4901,4907,8,15,19,4,6,9,15,34,-19,14,24,18
6797,4901,4907,49,7,19,7,6,6,23,23,0,20,18,27
6798,4901,4907,37,9,19,5,9,5,19,18,1,19,19,24
6799,4901,4907,20,5,19,7,7,5,30,35,-5,21,17,28
6800,4901,4907,41,6,19,7,6,6,32,26,6,20,18,27
6801,4901,4907,43,1,19,12,5,2,44,19,25,29,9,41
6802,4901,4907,24,4,19,7,8,4,22,18,4,22,16,29
6803,4901,4907,57,10,19,6,5,8,29,31,-2,17,21,23
6804,4908,4914,43,1,20,13,5,2,47,20,27,31,9,44
6805,4908,4914,24,4,20,8,8,4,24,18,6,24,16,32
6806,4908,4914,57,10,20,6,6,8,29,31,-2,18,22,24
6807,4908,4914,49,8,20,7,6,7,24,26,-2,20,20,27
6808,4908,4914,37,11,20,5,9,6,19,20,-1,19,21,24
6809,4908,4914,17,14,20,4,9,7,24,31,-7,17,23,21
6810,4908,4914,8,15,20,4,6,10,17,37,-20,14,26,18
6811,4908,4914,41,5,20,8,6,6,35,28,7,22,18,30
6812,4908,4914,20,7,20,7,7,6,30,37,-7,21,19,28
6813,4908,4914,52,2,20,9,8,3,32,16,16,26,14,35
6814,4908,4914,48,9,20,6,7,7,25,30,-5,19,21,25
6815,4908,4914,36,12,20,5,6,9,31,35,-4,16,24,21
6816,4908,4914,28,16,20,1,10,9,17,38,-21,12,28,13
6817,4908,4914,53,13,20,5,6,9,26,34,-8,16,24,21
6818,4908,4914,21,3,20,9,6,5,30,21,9,24,16,33
6819,4908,4914,1,6,20,8,5,7,41,29,12,21,19,29
6820,4985,4991,8,11,29,8,8,13,28,48,-20,24,34,32
6821,4985,4991,17,15,29,6,12,11,34,50,-16,24,34,30
6822,4985,4991,53,14,29,7,10,12,34,47,-13,24,34,31
6823,4985,4991,52,3,29,13,12,4,49,24,25,38,20,51
6824,4985,4991,36,9,29,8,10,11,43,48,-5,26,32,34
6825,4985,4991,48,12,29,7,11,11,33,45,-12,25,33,32
6826,4985,4991,28,16,29,6,11,12,30,49,-19,23,35,29
6827,4985,4991,49,5,29,11,10,8,40,29,11,32,26,43
6828,4985,4991,21,2,29,15,8,6,46,31,15,38,20,53
6829,4985,4991,43,1,29,16,7,6,68,37,31,39,19,55
6830,4985,4991,24,7,29,10,11,8,34,33,1,31,27,41
6831,4985,4991,57,8,29,8,11,10,46,46,0,27,31,35
6832,4985,4991,41,6,29,11,8,10,42,42,0,30,28,41
6833,4985,4991,20,13,29,7,11,11,36,49,-13,25,33,32
6834,4985,4991,37,10,29,7,13,9,23,26,-3,27,31,34
6835,4985,4991,1,4,29,13,5,11,59,41,18,31,27,44
6836,5174,5180,1,5,12,5,4,3,22,14,8,14,10,19
6837,5174,5180,18,14,12,3,5,4,13,21,-8,11,13,14
6838,5174,5180,27,13,12,3,5,4,13,19,-6,11,13,14
6839,5174,5180,5,10,12,4,5,3,22,21,1,13,11,17
6840,5174,5180,49,11,12,4,4,4,19,16,3,12,12,16
6841,5174,5180,37,12,12,3,6,3,12,10,2,12,12,15
6842,5174,5180,41,15,12,3,4,5,10,12,-2,10,14,13
6843,5174,5180,20,18,12,1,7,4,10,14,-4,9,15,10
6844,5174,5180,43,1,12,7,5,0,28,6,22,19,5,26
6845,5174,5180,57,7,12,4,6,2,14,13,1,14,10,18
6846,4964,4977,48,11,27,7,10,10,31,42,-11,24,30,31
6847,4964,4977,28,14,27,6,10,11,27,44,-17,22,32,28
6848,4964,4977,43,1,27,16,6,5,65,33,32,38,16,54
6849,4964,4977,24,6,27,10,9,8,32,31,1,29,25,39
6850,4964,4977,57,8,27,8,9,10,44,44,0,25,29,33
6851,5104,5106,43,3,2,1,1,0,5,0,5,3,1,4
6852,5104,5106,24,11,2,1,0,1,1,2,-1,2,2,3
6853,5104,5106,57,12,2,0,2,0,1,1,0,2,2,2
6854,5104,5106,22,19,2,0,0,2,2,5,-3,0,4,0
6855,5104,5106,52,6,2,1,1,0,1,0,1,3,1,4
6856,5104,5106,48,15,2,0,1,1,1,2,-1,1,3,1
6857,5104,5106,36,20,2,0,0,2,0,5,-5,0,4,0
6858,5104,5106,17,2,2,2,0,0,3,0,3,4,0,6
6859,5104,5106,8,7,2,1,0,1,2,1,1,2,2,3
6860,5104,5106,53,10,2,1,0,1,1,1,0,2,2,3
6861,5104,5106,12,18,2,0,1,1,1,6,-5,1,3,1
6862,5104,5106,20,12,2,0,2,0,1,1,0,2,2,2
6863,5104,5106,41,17,2,0,1,1,0,2,-2,1,3,1
6864,5104,5106,21,1,2,2,0,0,5,0,5,4,0,6
6865,5104,5106,5,7,2,1,0,1,2,1,1,2,2,3
6866,5104,5106,49,9,2,1,0,1,4,4,0,2,2,3
6867,5104,5106,37,12,2,0,2,0,1,1,0,2,2,2
6868,5104,5106,27,5,2,1,1,0,2,1,1,3,1,4
6869,5104,5106,1,4,2,1,1,0,3,2,1,3,1,4
6870,5104,5106,18,15,2,0,1,1,1,2,-1,1,3,1
6871,5265,5271,27,16,23,6,7,10,23,39,-16,19,27,25
6872,5265,5271,53,6,23,11,6,6,35,22,13,28,18,39
6873,5265,5271,12,8,23,9,7,7,33,33,0,25,21,34
6874,5265,5271,52,1,23,15,8,0,63,22,41,38,8,53
6875,5265,5271,48,12,23,5,12,6,19,21,-2,22,24,27
6876,5265,5271,36,19,23,4,7,12,16,41,-25,15,31,19
6877,5265,5271,1,4,23,11,7,5,45,22,23,29,17,40
6878,5265,5271,18,18,23,5,9,9,21,40,-19,19,27,24
6879,5265,5271,17,7,23,10,4,9,32,34,-2,24,22,34
6880,5265,5271,8,10,23,7,6,10,27,34,-7,20,26,27
6881,5265,5271,49,3,23,12,6,5,38,20,18,30,16,42
6882,5265,5271,37,11,23,6,9,8,18,21,-3,21,25,27
6883,5265,5271,5,13,23,6,8,9,38,41,-3,20,26,26
6884,5265,5271,20,15,23,6,7,10,21,31,-10,19,27,25
6885,5265,5271,41,17,23,6,6,11,24,32,-8,18,28,24
6886,5265,5271,21,5,23,11,7,5,36,21,15,29,17,40
6887,5265,5271,24,14,23,6,8,9,14,22,-8,20,26,26
6888,5265,5271,22,20,23,1,8,14,19,49,-30,10,36,11
6889,5265,5271,43,2,23,11,10,2,43,15,28,32,14,43
6890,5265,5271,57,9,23,7,8,8,23,28,-5,22,24,29
6891,5272,5278,43,2,24,12,10,2,45,15,30,34,14,46
6892,5272,5278,57,10,24,7,9,8,23,28,-5,23,25,30
6893,5272,5278,24,15,24,6,8,10,14,24,-10,20,28,26
6894,5272,5278,22,20,24,1,8,15,19,54,-35,10,38,11
6895,5272,5278,21,6,24,11,7,6,36,23,13,29,19,40
6896,5272,5278,20,11,24,7,7,10,26,31,-5,21,27,28
6897,5272,5278,41,18,24,6,6,12,25,35,-10,18,30,24
6898,5272,5278,49,3,24,13,6,5,41,21,20,32,16,45
6899,5272,5278,37,9,24,7,9,8,20,22,-2,23,25,30
6900,5272,5278,5,14,24,6,8,10,38,43,-5,20,28,26
6901,5272,5278,17,7,24,11,4,9,34,34,0,26,22,37
6902,5272,5278,8,12,24,7,7,10,29,36,-7,21,27,28
6903,5272,5278,1,4,24,12,7,5,47,22,25,31,17,43
6904,5272,5278,18,17,24,5,10,9,21,40,-19,20,28,25
6905,5272,5278,52,1,24,15,9,0,64,23,41,39,9,54
6906,5272,5278,48,13,24,5,12,7,20,23,-3,22,26,27
6907,5272,5278,36,19,24,4,7,13,17,43,-26,15,33,19
6908,5272,5278,53,5,24,12,6,6,37,23,14,30,18,42
6909,5272,5278,12,8,24,9,8,7,35,35,0,26,22,35
6910,5272,5278,27,16,24,6,8,10,24,40,-16,20,28,26
6911,5324,5327,27,11,31,9,11,11,31,46,-15,29,33,38
6912,5324,5327,53,7,31,15,7,9,44,29,15,37,25,52
6913,5324,5327,12,8,31,12,10,9,44,42,2,34,28,46
6914,5324,5327,1,3,31,16,9,6,61,27,34,41,21,57
6915,5324,5327,18,17,31,6,11,14,26,60,-34,23,39,29
6916,5324,5327,17,6,31,16,5,10,44,39,5,37,25,53
6917,5324,5327,8,14,31,9,9,13,39,47,-8,27,35,36
6918,5324,5327,49,5,31,16,6,9,52,32,20,38,24,54
6919,5324,5327,37,10,31,9,11,11,24,29,-5,29,33,38
6920,5324,5327,5,19,31,6,10,15,46,66,-20,22,40,28
6921,5324,5327,41,12,31,10,7,14,35,41,-6,27,35,37
6922,5324,5327,20,13,31,9,10,12,31,38,-7,28,34,37
6923,5324,5327,21,4,31,16,7,8,56,28,28,39,23,55
6924,5324,5327,43,2,31,16,11,4,59,17,42,43,19,59
6925,6406,6412,52,6,28,13,6,9,50,39,11,32,24,45
6926,6406,6412,49,2,28,16,7,5,55,28,27,39,17,55
6927,6406,6412,37,5,28,13,7,8,37,24,13,33,23,46
6928,6406,6412,14,18,28,4,6,18,28,67,-39,14,42,18
6929,6406,6412,1,1,28,19,6,3,63,37,26,44,12,63
6930,6406,6412,17,4,28,15,5,8,50,35,15,35,21,50
6931,6406,6412,8,10,28,10,6,12,29,35,-6,26,30,36
6932,6406,6412,27,13,28,8,5,15,32,50,-18,21,35,29
6933,6406,6412,53,9,28,10,11,7,49,34,15,31,25,41
6934,6406,6412,12,11,28,9,8,11,39,34,5,26,30,35
6935,6427,6433,53,7,31,11,13,7,55,39,16,35,27,46
6936,6427,6433,12,12,31,9,9,13,44,41,3,27,35,36
6937,6427,6433,27,13,31,10,5,16,34,51,-17,25,37,35
6938,6427,6433,52,8,31,13,6,12,51,45,6,32,30,45
6939,6427,6433,17,4,31,18,5,8,60,39,21,41,21,59
6940,6427,6433,8,11,31,11,7,13,32,42,-10,29,33,40
6941,6427,6433,1,1,31,21,6,4,70,43,27,48,14,69
6942,6427,6433,49,3,31,18,8,5,64,30,34,44,18,62
6943,6427,6433,37,5,31,13,10,8,39,26,13,36,26,49
6944,6427,6433,14,18,31,4,7,20,28,77,-49,15,47,19
6945,6427,6433,21,6,31,13,8,10,44,33,11,34,28,47
6946,6427,6433,43,2,31,19,6,6,61,23,38,44,18,63
6947,6427,6433,22,9,31,12,8,11,45,50,-5,32,30,44
6948,6427,6433,40,16,31,7,7,17,26,61,-35,21,41,28
6949,6427,6433,57,17,31,4,8,19,21,56,-35,16,46,20
6950,6427,6433,20,10,31,11,8,12,41,43,-2,30,32,41
6951,6427,6433,41,14,31,8,9,14,40,44,-4,25,37,33
6952,6427,6433,56,15,31,6,12,13,33,45,-12,24,38,30
6953,6227,6230,22,2,7,4,2,1,13,7,6,10,4,14
6954,6227,6230,43,5,7,3,2,2,15,7,8,8,6,11
6955,6227,6230,40,10,7,3,1,3,11,13,-2,7,7,10
6956,6227,6230,57,13,7,2,2,3,7,13,-6,6,8,8
6957,6227,6230,56,8,7,3,1,3,8,9,-1,7,7,10
6958,6227,6230,20,11,7,3,0,4,12,10,2,6,8,9
6959,6227,6230,41,17,7,1,2,4,7,11,-4,4,10,5
6960,6227,6230,49,3,7,4,1,2,16,11,5,9,5,13
6961,6227,6230,37,4,7,4,1,2,10,7,3,9,5,13
6962,6227,6230,14,18,7,1,1,5,10,19,-9,3,11,4
6963,6227,6230,12,7,7,3,1,3,12,9,3,7,7,10
6964,6227,6230,53,14,7,1,5,1,10,10,0,7,7,8
6965,6227,6230,1,1,7,5,1,1,19,14,5,11,3,16
6966,6227,6230,21,16,7,1,3,3,6,9,-3,5,9,6
6967,6227,6230,17,6,7,3,2,2,5,6,-1,8,6,11
6968,6227,6230,8,9,7,3,1,3,3,4,-1,7,7,10
6969,6227,6230,52,12,7,2,3,2,12,9,3,7,7,9
6970,6227,6230,27,15,7,2,1,4,8,16,-8,5,9,7
6971,6231,6237,27,12,8,3,1,4,10,16,-6,7,9,10
6972,6231,6237,52,13,8,2,4,2,13,10,3,8,8,10
6973,6231,6237,17,8,8,3,3,2,6,7,-1,9,7,12
6974,6231,6237,8,11,8,3,1,4,3,6,-3,7,9,10
6975,6231,6237,21,14,8,2,3,3,10,10,0,7,9,9
6976,6231,6237,1,1,8,6,1,1,21,15,6,13,3,19
6977,6231,6237,12,10,8,3,1,4,12,10,2,7,9,10
6978,6231,6237,53,15,8,1,6,1,12,12,0,8,8,9
6979,6231,6237,49,4,8,4,2,2,18,13,5,10,6,14
6980,6231,6237,37,5,8,4,1,3,11,9,2,9,7,13
6981,6231,6237,14,18,8,1,1,6,11,23,-12,3,13,4
6982,6231,6237,56,7,8,4,1,3,10,10,0,9,7,13
6983,6231,6237,20,9,8,3,1,4,13,11,2,7,9,10
6984,6231,6237,41,17,8,1,2,5,8,13,-5,4,12,5
6985,6231,6237,22,2,8,4,3,1,14,8,6,11,5,15
6986,6231,6237,43,3,8,4,2,2,16,7,9,10,6,14
6987,6231,6237,40,6,8,4,1,3,13,13,0,9,7,13
6988,6231,6237,57,16,8,2,2,4,7,15,-8,6,10,8
6989,6651,6657,20,12,13,3,6,4,12,15,-3,12,14,15
6990,6651,6657,41,16,13,3,2,8,14,25,-11,8,18,11
6991,6651,6657,56,17,13,2,4,7,7,18,-11,8,18,10
6992,6651,6657,43,1,13,8,1,4,34,17,17,17,9,25
6993,6651,6657,22,14,13,3,5,5,13,17,-4,11,15,14
6994,6651,6657,40,15,13,3,4,6,20,28,-8,10,16,13
6995,6651,6657,37,2,13,6,5,2,22,10,12,17,9,23
6996,6651,6657,49,8,13,5,4,4,21,16,5,14,12,19
6997,6651,6657,19,6,13,5,6,2,13,8,5,16,10,21
6998,6651,6657,17,7,13,6,2,5,19,18,1,14,12,20
6999,6651,6657,52,3,13,6,3,4,20,17,3,15,11,21
7000,6651,6657,48,18,13,1,7,5,10,20,-10,9,17,10
7001,6651,6657,8,11,13,4,6,3,16,17,-1,14,12,18
7002,6651,6657,21,5,13,5,6,2,15,9,6,16,10,21
7003,6651,6657,27,13,13,4,2,7,13,21,-8,10,16,14
7004,6651,6657,12,9,13,5,4,4,12,14,-2,14,12,19
7005,4418,4424,36,16,5,0,1,4,6,12,-6,1,9,1
7006,4418,4424,21,7,5,2,1,2,4,4,0,5,5,7
7007,4418,4424,1,1,5,3,2,0,8,4,4,8,2,11
7008,4418,4424,8,12,5,1,3,1,6,7,-1,5,5,6
7009,4418,4424,43,3,5,3,1,1,7,5,2,7,3,10
7010,4418,4424,17,4,5,2,2,1,5,4,1,6,4,8
7011,4418,4424,49,2,5,3,1,1,5,2,3,7,3,10
7012,4418,4424,24,4,5,2,2,1,5,4,1,6,4,8
7013,4418,4424,57,6,5,2,2,1,4,3,1,6,4,8
7014,4418,4424,26,9,5,1,3,1,3,3,0,5,5,6
7015,4418,4424,41,13,5,1,2,2,4,5,-1,4,6,5
7016,4418,4424,53,8,5,2,0,3,8,8,0,4,6,6
7017,4418,4424,39,15,5,0,3,2,2,4,-2,3,7,3
7018,4880,4886,53,12,16,4,6,6,21,27,-6,14,18,18
7019,4880,4886,52,2,16,8,7,1,26,9,17,23,9,31
7020,4880,4886,48,13,16,4,5,7,20,29,-9,13,19,17
7021,4880,4886,43,1,16,10,4,2,38,16,22,24,8,34
7022,4880,4886,24,8,16,5,7,4,16,14,2,17,15,22
7023,4880,4886,57,10,16,5,4,7,26,28,-2,14,18,19
7024,4880,4886,49,5,16,6,5,5,20,20,0,17,15,23
7025,4880,4886,37,6,16,5,8,3,19,15,4,18,14,23
7026,4880,4886,17,11,16,4,7,5,21,24,-3,15,17,19
7027,4880,4886,8,14,16,4,3,9,14,33,-19,11,21,15
7028,4880,4886,1,7,16,6,4,6,27,21,6,16,16,22
7029,4880,4886,21,4,16,7,4,5,22,17,5,18,14,25
7030,4880,4886,36,15,16,3,5,8,22,29,-7,11,21,14
7031,4880,4886,28,16,16,1,8,7,12,23,-11,10,22,11
7032,4880,4886,20,3,16,7,6,3,25,25,0,20,12,27
7033,4880,4886,41,9,16,5,5,6,25,24,1,15,17,20
7034,4768,4774,52,1,4,3,1,0,9,0,9,7,1,10
7035,4768,4774,48,8,4,2,0,2,5,8,-3,4,4,6
7036,4768,4774,36,14,4,0,2,2,6,8,-2,2,6,2
7037,4768,4774,28,15,4,0,2,2,3,7,-4,2,6,2
7038,4768,4774,21,10,4,1,1,2,2,5,-3,3,5,4
7039,4768,4774,17,9,4,1,2,1,5,6,-1,4,4,5
7040,4768,4774,8,16,4,0,1,3,2,10,-8,1,7,1
7041,4768,4774,1,4,4,2,1,1,9,3,6,5,3,7
7042,4768,4774,49,5,4,2,1,1,6,4,2,5,3,7
7043,4768,4774,37,12,4,0,3,1,4,5,-1,3,5,3
7044,4768,4774,43,2,4,3,0,1,10,6,4,6,2,9
7045,4768,4774,57,5,4,2,1,1,6,4,2,5,3,7
7046,4768,4774,24,7,4,2,1,1,5,3,2,5,3,7
7047,4768,4774,41,3,4,2,2,0,9,4,5,6,2,8
7048,4768,4774,20,11,4,1,1,2,5,11,-6,3,5,4
7049,4768,4774,53,13,4,0,3,1,3,5,-2,3,5,3
7050,5097,5103,53,4,1,1,0,0,1,0,1,2,0,3
7051,5097,5103,12,8,1,0,1,0,1,1,0,1,1,1
7052,5097,5103,20,12,1,0,1,0,0,0,0,1,1,1
7053,5097,5103,41,19,1,0,0,1,0,2,-2,0,2,0
7054,5097,5103,24,4,1,1,0,0,1,0,1,2,0,3
7055,5097,5103,57,8,1,0,1,0,1,1,0,1,1,1
7056,5097,5103,43,12,1,0,1,0,0,0,0,1,1,1
7057,5097,5103,22,14,1,0,0,1,2,3,-1,0,2,0
7058,5097,5103,49,3,1,1,0,0,3,2,1,2,0,3
7059,5097,5103,37,8,1,0,1,0,1,1,0,1,1,1
7060,5097,5103,21,1,1,1,0,0,2,0,2,2,0,3
7061,5097,5103,17,1,1,1,0,0,2,0,2,2,0,3
7062,5097,5103,8,15,1,0,0,1,0,1,-1,0,2,0
7063,5097,5103,52,4,1,1,0,0,1,0,1,2,0,3
7064,5097,5103,48,15,1,0,0,1,0,1,-1,0,2,0
7065,5097,5103,36,19,1,0,0,1,0,2,-2,0,2,0
7066,5097,5103,5,15,1,0,0,1,0,1,-1,0,2,0
7067,5097,5103,27,4,1,1,0,0,1,0,1,2,0,3
7068,5097,5103,1,8,1,0,1,0,1,1,0,1,1,1
7069,5097,5103,18,15,1,0,0,1,0,1,-1,0,2,0
7070,5160,5166,18,17,10,2,4,4,9,18,-9,8,12,10
7071,5160,5166,27,13,10,3,3,4,11,17,-6,9,11,12
7072,5160,5166,1,5,10,4,4,2,19,12,7,12,8,16
7073,5160,5166,49,7,10,4,3,3,19,15,4,11,9,15
7074,5160,5166,52,2,10,5,5,0,21,9,12,15,5,20
7075,5160,5166,48,15,10,2,6,2,9,9,0,10,10,12
7076,5160,5166,36,19,10,0,5,5,5,17,-12,5,15,5
7077,5160,5166,17,3,10,5,2,3,16,10,6,12,8,17
7078,5160,5166,8,16,10,3,2,5,10,17,-7,8,12,11
7079,5160,5166,21,4,10,5,2,3,13,9,4,12,8,17
7080,5160,5166,5,10,10,4,3,3,18,17,1,11,9,15
7081,5160,5166,37,14,10,2,6,2,9,7,2,10,10,12
7082,5160,5166,43,1,10,5,5,0,25,6,19,15,5,20
7083,5160,5166,57,6,10,4,4,2,14,13,1,12,8,16
7084,5160,5166,24,9,10,4,3,3,10,8,2,11,9,15
7085,5160,5166,22,20,10,0,2,8,5,24,-19,2,18,2
7086,5160,5166,41,12,10,3,3,4,10,11,-1,9,11,12
7087,6413,6419,21,6,29,13,7,9,42,30,12,33,25,46
7088,6413,6419,49,2,29,17,7,5,58,29,29,41,17,58
7089,6413,6419,37,5,29,13,8,8,38,25,13,34,24,47
7090,6413,6419,14,18,29,4,6,19,28,76,-48,14,44,18
7091,6413,6419,1,1,29,19,6,4,64,40,24,44,14,63
7092,6413,6419,17,4,29,16,5,8,53,36,17,37,21,53
7093,6413,6419,8,11,29,10,7,12,31,37,-6,27,31,37
7094,6413,6419,43,3,29,17,6,6,58,23,35,40,18,57
7095,6413,6419,22,8,29,12,8,9,42,44,-2,32,26,44
7096,6413,6419,40,15,29,7,6,16,25,57,-32,20,38,27
7097,6413,6419,57,17,29,4,8,17,21,54,-33,16,42,20
7098,6637,6643,20,12,11,3,5,3,11,12,-1,11,11,14
7099,6637,6643,41,15,11,3,1,7,13,21,-8,7,15,10
7100,6637,6643,56,18,11,0,4,7,4,17,-13,4,18,4
7101,6637,6643,21,4,11,5,4,2,13,7,6,14,8,19
7102,6637,6643,17,2,11,6,1,4,17,15,2,13,9,19
7103,6637,6643,19,7,11,4,6,1,9,6,3,14,8,18
7104,6637,6643,8,9,11,4,4,3,14,15,-1,12,10,16
7105,6637,6643,37,3,11,5,4,2,17,8,9,14,8,19
7106,6637,6643,49,6,11,5,3,3,20,14,6,13,9,18
7107,6637,6643,53,5,11,5,3,3,17,8,9,13,9,18
7108,6637,6643,12,8,11,4,4,3,10,10,0,12,10,16
7109,6637,6643,43,1,11,7,1,3,27,14,13,15,7,22
7110,6637,6643,22,14,11,3,3,5,10,14,-4,9,13,12
7111,6637,6643,40,16,11,2,4,5,18,21,-3,8,14,10
7112,6637,6643,1,11,11,3,6,2,12,11,1,12,10,15
7113,6637,6643,27,13,11,4,1,6,12,19,-7,9,13,13
7114,6637,6643,52,10,11,4,3,4,15,17,-2,11,11,15
7115,6637,6643,48,17,11,1,5,5,8,18,-10,7,15,8
7116,6787,6790,27,11,26,9,6,11,28,33,-5,24,28,33
7117,6787,6790,12,3,26,12,8,6,38,25,13,32,20,44
7118,6787,6790,53,9,26,9,7,10,34,35,-1,25,27,34
7119,6787,6790,1,4,26,11,10,5,40,35,5,32,20,43
7120,6787,6790,43,2,26,17,2,7,58,27,31,36,16,53
7121,6787,6790,22,12,26,7,9,10,33,38,-5,23,29,30
7122,6787,6790,40,15,26,6,7,13,37,56,-19,19,33,25
7123,6787,6790,21,8,26,8,11,7,32,32,0,27,25,35
7124,6787,6790,37,1,26,17,6,3,53,18,35,40,12,57
7125,6787,6790,49,6,26,11,9,6,35,25,10,31,21,42
7126,6787,6790,19,7,26,9,10,7,34,27,7,28,24,37
7127,6787,6790,17,10,26,9,6,11,31,35,-4,24,28,33
7128,6787,6790,8,13,26,6,10,10,24,31,-7,22,30,28
7129,6787,6790,20,14,26,5,12,9,20,33,-13,22,30,27
7130,6787,6790,41,16,26,6,6,14,30,42,-12,18,34,24
7131,6787,6790,56,17,26,4,9,13,20,44,-24,17,35,21
7132,6787,6790,52,5,26,12,6,8,38,31,7,30,22,42
7133,6787,6790,48,18,26,3,12,11,14,32,-18,18,34,21
7134,6577,6580,43,3,3,2,0,1,10,5,5,4,2,6
7135,6577,6580,40,7,3,1,1,1,5,3,2,3,3,4
7136,6577,6580,22,16,3,0,2,1,1,3,-2,2,4,2
7137,6577,6580,20,1,3,2,1,0,5,3,2,5,1,7
7138,6577,6580,41,13,3,1,0,2,2,5,-3,2,4,3
7139,6577,6580,56,15,3,0,2,1,2,3,-1,2,4,2
7140,6577,6580,48,17,3,0,2,1,1,6,-5,2,4,2
7141,6577,6580,52,18,3,0,0,3,0,6,-6,0,6,0
7142,6577,6580,1,10,3,1,1,1,4,4,0,3,3,4
7143,6577,6580,21,5,3,2,0,1,5,2,3,4,2,6
7144,6577,6580,37,8,3,1,1,1,4,2,2,3,3,4
7145,6577,6580,49,11,3,1,1,1,2,2,0,3,3,4
7146,6577,6580,8,2,3,2,1,0,2,0,2,5,1,7
7147,6577,6580,17,4,3,2,0,1,6,3,3,4,2,6
7148,6577,6580,19,6,3,1,2,0,2,0,2,4,2,5
7149,6577,6580,27,14,3,1,0,2,4,9,-5,2,4,3
7150,6577,6580,53,9,3,1,1,1,3,2,1,3,3,4
7151,6577,6580,12,11,3,1,1,1,2,2,0,3,3,4
7152,6840,6933,12,5,34,16,10,8,54,33,21,42,26,58
7153,6840,6933,53,10,34,12,7,15,46,51,-5,31,37,43
7154,6840,6933,1,6,34,14,10,10,51,49,2,38,30,52
7155,6840,6933,27,8,34,13,7,14,44,49,-5,33,35,46
7156,6840,6933,40,17,34,8,8,18,45,79,-34,24,44,32
7157,6840,6933,43,2,34,21,3,10,76,41,35,45,23,66
7158,6840,6933,22,11,34,10,13,11,45,47,-2,33,35,43
7159,6840,6933,21,9,34,11,13,10,44,41,3,35,33,46
7160,6840,6933,37,1,34,19,11,4,62,24,38,49,19,68
7161,6840,6933,49,3,34,17,10,7,46,30,16,44,24,61
7162,6840,6933,17,7,34,13,7,14,44,48,-4,33,35,46
7163,6840,6933,19,12,34,10,12,12,42,44,-2,32,36,42
7164,6840,6933,8,15,34,8,12,14,35,47,-12,28,40,36
7165,6840,6933,52,4,34,17,7,10,57,41,16,41,27,58
7166,6840,6933,48,13,34,8,13,13,30,43,-13,29,39,37
7167,1674,1680,1,9,27,8,8,11,45,33,12,24,30,32
7168,1961,1967,1,11,17,4,7,6,27,23,4,15,19,19
7169,1961,1967,53,3,17,10,5,2,25,15,10,25,9,35
7170,1961,1967,49,4,17,9,4,4,26,12,14,22,12,31
7171,1961,1967,4,7,17,7,4,6,29,35,-6,18,16,25
7172,1961,1967,21,9,17,6,4,7,25,26,-1,16,18,22
7173,1961,1967,7,10,17,5,4,8,16,14,2,14,20,19
7174,1961,1967,41,6,17,7,4,6,34,28,6,18,16,25
7175,1961,1967,30,8,17,6,5,6,17,25,-8,17,17,23
7176,1961,1967,17,14,17,3,6,8,12,26,-14,12,22,15
7177,1961,1967,8,15,17,4,2,11,16,33,-17,10,24,14
7178,1961,1967,28,2,17,13,1,3,28,13,15,27,7,40
7179,1961,1967,48,12,17,4,4,9,15,29,-14,12,22,16
7180,1961,1967,52,13,17,4,3,10,19,27,-8,11,23,15
7181,1961,1967,43,1,17,14,1,2,46,10,36,29,5,43
7182,1961,1967,24,5,17,8,2,7,20,23,-3,18,16,26
7183,1961,1967,57,16,17,2,4,11,10,26,-16,8,26,10
7184,1842,1855,28,2,3,3,0,0,7,2,5,6,0,9
7185,1842,1855,52,7,3,1,1,1,3,3,0,3,3,4
7186,1842,1855,48,16,3,0,0,3,2,8,-6,0,6,0
7187,1842,1855,43,1,3,3,0,0,8,1,7,6,0,9
7188,1842,1855,24,7,3,1,1,1,3,3,0,3,3,4
7189,1842,1855,57,15,3,0,0,3,0,5,-5,0,6,0
7190,1842,1855,8,5,3,2,0,1,4,5,-1,4,2,6
7191,1842,1855,17,7,3,1,1,1,3,3,0,3,3,4
7192,1842,1855,41,4,3,2,1,0,8,1,7,5,1,7
7193,1842,1855,30,13,3,0,1,2,3,6,-3,1,5,1
7194,1842,1855,49,11,3,0,2,1,3,4,-1,2,4,2
7195,1842,1855,4,5,3,2,0,1,4,5,-1,4,2,6
7196,1842,1855,21,7,3,1,1,1,3,3,0,3,3,4
7197,1842,1855,7,12,3,0,1,2,1,3,-2,1,5,1
7198,1842,1855,53,3,3,3,0,0,5,2,3,6,0,9
7199,1842,1855,1,14,3,0,1,2,2,5,-3,1,5,1
7200,2276,2282,1,1,11,8,1,2,26,14,12,17,5,25
7201,2276,2282,27,14,11,1,6,4,8,17,-9,8,14,9
7202,2276,2282,53,15,11,2,2,7,14,25,-11,6,16,8
7203,2276,2282,21,3,11,6,4,1,17,8,9,16,6,22
7204,2276,2282,7,9,11,3,4,4,17,16,1,10,12,13
7205,2276,2282,4,11,11,2,5,4,11,16,-5,9,13,11
7206,2276,2282,30,12,11,3,0,8,13,26,-13,6,16,9
7207,2276,2282,41,4,11,6,3,2,13,7,6,15,7,21
7208,2276,2282,20,6,11,4,5,2,11,8,3,13,9,17
7209,2276,2282,49,5,11,5,3,3,18,15,3,13,9,18
7210,2276,2282,8,7,11,4,4,3,22,14,8,12,10,16
7211,2276,2282,17,8,11,4,3,4,13,11,2,11,11,15
7212,2276,2282,24,13,11,1,6,4,9,16,-7,8,14,9
7213,2276,2282,43,2,11,6,4,1,20,6,14,16,6,22
7214,2276,2282,52,16,11,1,4,6,9,22,-13,6,16,7
7215,2276,2282,28,10,11,3,4,4,19,19,0,10,12,13
7216,2227,2233,28,12,6,1,2,3,8,11,-3,4,8,5
7217,2227,2233,52,14,6,1,1,4,4,9,-5,3,9,4
7218,2227,2233,8,5,6,3,1,2,14,8,6,7,5,10
7219,2227,2233,17,16,6,0,2,4,2,9,-7,2,10,2
7220,2227,2233,43,6,6,2,4,0,7,4,3,8,4,10
7221,2227,2233,24,11,6,1,3,2,6,9,-3,5,7,6
7222,2227,2233,21,1,6,4,1,1,11,6,5,9,3,13
7223,2227,2233,7,8,6,2,3,1,10,8,2,7,5,9
7224,2227,2233,4,15,6,0,4,2,5,8,-3,4,8,4
7225,2227,2233,49,9,6,2,2,2,9,8,1,6,6,8
7226,2227,2233,20,3,6,3,2,1,8,5,3,8,4,11
7227,2227,2233,41,4,6,3,2,1,6,5,1,8,4,11
7228,2227,2233,30,7,6,3,0,3,10,14,-4,6,6,9
7229,2227,2233,53,9,6,2,2,2,9,8,1,6,6,8
7230,2227,2233,1,2,6,4,0,2,13,8,5,8,4,12
7231,2227,2233,27,13,6,0,5,1,4,6,-2,5,7,5
7232,2619,2625,27,10,8,3,1,4,11,12,-1,7,9,10
7233,2619,2625,1,3,8,5,1,2,14,6,8,11,5,16
7234,2619,2625,18,16,8,0,2,6,2,15,-13,2,14,2
7235,2619,2625,53,14,8,1,4,3,5,9,-4,6,10,7
7236,2619,2625,7,7,8,4,0,4,12,13,-1,8,8,12
7237,2619,2625,21,13,8,2,2,4,9,13,-4,6,10,8
7238,2619,2625,20,9,8,3,2,3,8,14,-6,8,8,11
7239,2619,2625,41,15,8,1,2,5,7,14,-7,4,12,5
7240,2619,2625,37,2,8,5,2,1,14,7,7,12,4,17
7241,2619,2625,49,5,8,4,3,1,12,9,3,11,5,15
7242,2619,2625,8,4,8,4,3,1,15,12,3,11,5,15
7243,2619,2625,17,6,8,4,1,3,18,15,3,9,7,13
7244,2619,2625,43,1,8,6,1,1,21,6,15,13,3,19
7245,2619,2625,24,11,8,2,2,4,8,8,0,6,10,8
7246,2619,2625,52,8,8,3,2,3,14,13,1,8,8,11
7247,2619,2625,28,12,8,2,2,4,11,15,-4,6,10,8
7248,3011,3024,28,6,12,4,6,2,18,17,1,14,10,18
7249,5324,5327,57,9,31,10,11,10,34,37,-3,31,31,41
7250,5324,5327,24,15,31,8,9,14,20,30,-10,25,37,33
7251,5324,5327,22,20,31,1,11,19,22,64,-42,13,49,14
7252,5324,5327,52,1,31,20,10,1,77,30,47,50,12,70
7253,5324,5327,48,16,31,6,14,11,25,36,-11,26,36,32
7254,5324,5327,36,18,31,7,7,17,23,55,-32,21,41,28
7255,5139,5145,43,1,8,4,4,0,18,3,15,12,4,16
7256,5139,5145,57,6,8,3,4,1,8,7,1,10,6,13
7257,5139,5145,24,9,8,3,2,3,9,8,1,8,8,11
7258,5139,5145,22,20,8,0,1,7,5,23,-18,1,15,1
7259,5139,5145,17,4,8,4,2,2,13,7,6,10,6,14
7260,5139,5145,8,14,8,3,1,4,9,12,-3,7,9,10
7261,5139,5145,21,5,8,4,1,3,10,8,2,9,7,13
7262,5139,5145,41,15,8,2,3,3,8,9,-1,7,9,9
7263,5139,5145,20,18,8,0,5,3,6,9,-3,5,11,5
7264,5139,5145,49,7,8,3,3,2,16,12,4,9,7,12
7265,5139,5145,5,8,8,3,3,2,12,9,3,9,7,12
7266,5139,5145,53,10,8,3,2,3,9,9,0,8,8,11
7267,5139,5145,12,12,8,3,2,3,14,19,-5,8,8,11
7268,5139,5145,52,2,8,4,4,0,16,8,8,12,4,16
7269,5139,5145,48,13,8,2,5,1,7,4,3,9,7,11
7270,5139,5145,36,19,8,0,3,5,4,16,-12,3,13,3
7271,5139,5145,37,17,8,1,5,2,7,7,0,7,9,8
7272,5139,5145,27,11,8,3,2,3,8,10,-2,8,8,11
7273,5139,5145,1,3,8,4,3,1,17,9,8,11,5,15
7274,5139,5145,18,16,8,2,3,3,6,13,-7,7,9,9
7275,5566,5572,1,1,14,9,3,2,30,13,17,21,7,30
7276,5566,5572,27,19,14,2,3,9,15,23,-8,7,21,9
7277,5566,5572,54,17,14,4,1,9,8,24,-16,9,19,13
7278,5566,5572,48,18,14,1,6,7,8,22,-14,8,20,9
7279,5566,5572,37,3,15,7,5,3,19,6,13,19,11,26
7280,5566,5572,49,8,14,6,5,3,20,15,5,17,11,23
7281,5566,5572,5,14,14,2,7,5,13,18,-5,11,17,13
7282,5566,5572,21,9,15,6,4,5,19,23,-4,16,14,22
7283,5566,5572,20,6,14,6,6,2,20,11,9,18,10,24
7284,5566,5572,41,12,14,4,4,6,22,29,-7,12,16,16
7285,5566,5572,12,2,15,9,2,4,28,18,10,20,10,29
7286,5566,5572,53,10,14,5,5,4,21,23,-2,15,13,20
7287,5566,5572,17,7,15,7,3,5,29,20,9,17,13,24
7288,5566,5572,8,16,14,4,2,8,11,28,-17,10,18,14
7289,5566,5572,43,4,14,7,4,3,26,17,9,18,10,25
7290,5566,5572,57,11,14,3,7,4,19,17,2,13,15,16
7291,5566,5572,40,13,14,2,7,5,15,20,-5,11,17,13
7292,5566,5572,24,15,14,2,6,6,16,21,-5,10,18,12
7293,5566,5572,52,5,14,7,4,3,23,14,9,18,10,25
7294,5587,5600,43,2,17,10,4,3,34,20,14,24,10,34
7295,5587,5600,57,11,17,5,8,4,25,21,4,18,16,23
7296,5587,5600,40,14,17,2,9,6,16,25,-9,13,21,15
7297,5587,5600,24,16,17,2,7,8,21,30,-9,11,23,13
7298,5587,5600,21,10,17,7,5,5,22,25,-3,19,15,26
7299,5587,5600,20,4,17,8,6,3,28,15,13,22,12,30
7300,5587,5600,41,12,17,5,5,7,26,33,-7,15,19,20
7301,5587,5600,17,8,17,8,3,6,33,23,10,19,15,27
7302,5587,5600,8,15,17,5,2,10,14,31,-17,12,22,17
7303,5587,5600,49,6,17,8,5,4,24,20,4,21,13,29
7304,5587,5600,37,7,17,7,6,4,19,8,11,20,14,27
7305,5587,5600,5,13,17,3,7,7,18,24,-6,13,21,16
7306,5587,5600,52,3,17,9,4,4,31,18,13,22,12,31
7307,5587,5600,54,17,17,4,2,11,10,30,-20,10,24,14
7308,5587,5600,48,19,17,1,7,9,11,30,-19,9,25,10
7309,5587,5600,12,5,18,10,2,6,34,22,12,22,14,32
7310,5587,5600,53,9,17,7,5,5,28,28,0,19,15,26
7311,5587,5600,27,18,17,2,5,10,17,29,-12,9,25,11
7312,5587,5600,1,1,17,11,4,2,36,15,21,26,8,37
7313,5636,5642,1,1,23,14,5,4,49,23,26,33,13,47
7314,5636,5642,27,15,23,6,5,12,29,41,-12,17,29,23
7315,5636,5642,12,5,23,13,2,8,43,27,16,28,18,41
7316,5636,5642,53,11,22,8,7,7,34,37,-3,23,21,31
7317,5636,5642,52,3,22,12,5,5,39,22,17,29,15,41
7318,5636,5642,48,18,23,2,9,12,16,40,-24,13,33,15
7319,5636,5642,54,19,22,4,4,14,11,40,-29,12,32,16
7320,5636,5642,37,6,23,9,10,4,26,12,14,28,18,37
7321,5636,5642,49,9,23,9,7,7,30,28,2,25,21,34
7322,5636,5642,5,13,22,5,9,8,26,31,-5,19,25,24
7323,5636,5642,17,7,23,12,3,8,45,30,15,27,19,39
7324,5636,5642,8,17,23,5,6,12,17,38,-21,16,30,21
7325,5636,5642,21,8,23,9,8,6,27,29,-2,26,20,35
7326,5636,5642,20,4,23,10,8,5,42,24,18,28,18,38
7327,5636,5642,41,10,23,8,7,8,39,39,0,23,23,31
7328,6651,6657,53,10,13,5,3,5,17,14,3,13,13,18
7329,6651,6657,1,4,13,5,6,2,17,11,6,16,10,21
7330,6658,6664,1,7,14,5,7,2,19,13,6,17,11,22
7331,6658,6664,12,6,14,6,4,4,17,15,2,16,12,22
7332,6658,6664,53,11,14,5,3,6,17,19,-2,13,15,18
7333,6658,6664,27,14,14,4,2,8,14,23,-9,10,18,14
7334,6658,6664,21,5,14,6,6,2,16,9,7,18,10,24
7335,6658,6664,19,4,14,6,6,2,18,8,10,18,10,24
7336,6658,6664,17,8,14,6,2,6,20,20,0,14,14,20
7337,6658,6664,8,10,14,4,7,3,16,17,-1,15,13,19
7338,6658,6664,52,3,14,7,3,4,22,18,4,17,11,24
7339,6658,6664,48,16,14,2,7,5,11,20,-9,11,17,13
7340,6658,6664,37,1,14,7,5,2,24,11,13,19,9,26
7341,6658,6664,49,9,14,5,5,4,21,16,5,15,13,20
7342,6658,6664,43,2,14,8,1,5,34,18,16,17,11,25
7343,6658,6664,22,13,14,3,6,5,15,19,-4,12,16,15
7344,6658,6664,40,15,14,3,4,7,21,33,-12,10,18,13
7345,6658,6664,20,12,14,3,7,4,13,16,-3,13,15,16
7346,6658,6664,41,17,14,3,3,8,15,26,-11,9,19,12
7347,6658,6664,56,18,14,2,4,8,7,19,-12,8,20,10
7348,6665,6671,20,14,15,3,7,5,13,21,-8,13,17,16
7349,6665,6671,41,17,15,3,3,9,15,28,-13,9,21,12
7350,6665,6671,56,18,15,2,5,8,8,20,-12,9,21,11
7351,6665,6671,43,2,15,9,1,5,39,18,21,19,11,28
7352,6665,6671,22,12,15,4,6,5,20,20,0,14,16,18
7353,6665,6671,40,15,15,3,4,8,21,36,-15,10,20,13
7354,6665,6671,37,1,15,8,5,2,25,11,14,21,9,29
7355,6665,6671,52,3,15,7,4,4,23,19,4,18,12,25
7356,6665,6671,48,16,15,2,7,6,11,21,-10,11,19,13
7357,6665,6671,49,6,15,6,5,4,22,16,6,17,13,23
7358,6665,6671,19,5,15,6,6,3,19,13,6,18,12,24
7359,6665,6671,8,9,15,5,7,3,18,17,1,17,13,22
7360,6665,6671,17,11,15,6,2,7,20,21,-1,14,16,20
7361,6665,6671,21,4,15,6,7,2,18,11,7,19,11,25
7362,6665,6671,27,13,15,5,2,8,16,24,-8,12,18,17
7363,6665,6671,12,7,15,6,5,4,19,17,2,17,13,23
7364,6665,6671,53,10,15,6,3,6,20,19,1,15,15,21
7365,6665,6671,1,8,15,5,7,3,20,15,5,17,13,22
7366,6728,6734,1,6,18,6,9,3,23,17,6,21,15,27
7367,6728,6734,12,3,18,8,6,4,24,19,5,22,14,30
7368,6728,6734,53,11,18,6,5,7,23,23,0,17,19,23
7369,6728,6734,27,10,18,7,3,8,21,25,-4,17,19,24
7370,6728,6734,48,17,18,2,9,7,11,22,-11,13,23,15
7371,6728,6734,49,8,18,6,7,5,22,17,5,19,17,25
7372,6728,6734,21,5,18,6,10,2,22,15,7,22,14,28
7373,6728,6734,19,7,18,6,8,4,19,14,5,20,16,26
7374,6728,6734,17,9,18,7,3,8,22,23,-1,17,19,24
7375,6728,6734,8,12,18,5,8,5,19,20,-1,18,18,23
7376,6728,6734,37,1,18,11,5,2,32,11,21,27,9,38
7377,6728,6734,52,4,18,8,5,5,24,20,4,21,15,29
7378,6728,6734,43,2,18,11,1,6,42,23,19,23,13,34
7379,6728,6734,22,13,18,4,8,6,22,24,-2,16,20,20
7380,6728,6734,40,15,18,4,5,9,24,40,-16,13,23,17
7381,6728,6734,20,14,18,3,9,6,14,23,-9,15,21,18
7382,6728,6734,41,16,18,4,4,10,20,31,-11,12,24,16
7383,6728,6734,56,18,18,2,7,9,10,27,-17,11,25,13
7384,6770,6783,43,2,24,16,1,7,55,26,29,33,15,49
7385,6770,6783,22,11,24,7,9,8,30,31,-1,23,25,30
7386,6770,6783,40,17,24,4,7,13,32,54,-22,15,33,19
7387,6770,6783,20,14,24,4,11,9,17,31,-14,19,29,23
7388,6770,6783,41,15,24,5,6,13,25,38,-13,16,32,21
7389,6770,6783,56,18,24,3,9,12,17,42,-25,15,33,18
7390,6770,6783,37,1,24,16,6,2,47,15,32,38,10,54
7391,6770,6783,49,5,24,10,8,6,30,22,8,28,20,38
7392,6770,6783,52,4,24,11,6,7,33,26,7,28,20,39
7393,6770,6783,19,7,24,9,9,6,33,25,8,27,21,36
7394,6770,6783,17,9,24,9,4,11,29,33,-4,22,26,31
7395,6770,6783,8,13,24,6,9,9,24,28,-4,21,27,27
7396,6770,6783,48,16,24,3,11,10,13,28,-15,17,31,20
7397,6770,6783,21,8,24,8,10,6,29,28,1,26,22,34
7398,6770,6783,27,12,24,8,5,11,25,32,-7,21,27,29
7399,6770,6783,12,6,24,10,8,6,29,23,6,28,20,38
7400,6770,6783,53,10,24,8,7,9,31,30,1,23,25,31
7401,6770,6783,1,3,24,11,10,3,37,24,13,32,16,43
7402,6812,6818,1,6,30,12,10,8,43,43,0,34,26,46
7403,6812,6818,12,4,30,14,9,7,48,29,19,37,23,51
7404,6812,6818,53,7,30,11,7,12,43,43,0,29,31,40
7405,6812,6818,27,11,30,10,7,13,35,40,-5,27,33,37
7406,6819,6825,21,10,31,9,12,10,37,39,-2,30,32,39
7407,6819,6825,37,1,31,19,9,3,60,21,39,47,15,66
7408,6819,6825,49,5,31,14,10,7,40,28,12,38,24,52
7409,6819,6825,52,3,31,15,7,9,50,37,13,37,25,52
7410,6819,6825,48,14,31,7,13,11,26,37,-11,27,35,34
7411,6819,6825,41,15,31,9,6,16,44,49,-5,24,38,33
7412,6819,6825,20,16,31,6,15,10,27,39,-12,27,35,33
7413,6819,6825,56,18,31,5,10,16,23,52,-29,20,42,25
7414,6819,6825,43,2,31,19,3,9,68,36,32,41,21,60
7415,6819,6825,22,11,31,9,11,11,41,44,-3,29,33,38
7416,6819,6825,40,17,31,8,7,16,42,72,-30,23,39,31
7417,6819,6825,12,4,31,14,10,7,49,30,19,38,24,52
7418,6819,6825,53,7,31,11,7,13,43,44,-1,29,33,40
7419,6819,6825,1,6,31,13,10,8,48,44,4,36,26,49
7420,6819,6825,27,12,31,10,7,14,36,45,-9,27,35,37
7421,6826,6832,27,12,32,11,7,14,38,46,-8,29,35,40
7422,6826,6832,1,6,32,13,10,9,49,47,2,36,28,49
7423,6826,6832,12,4,32,15,10,7,53,30,23,40,24,55
7424,6826,6832,53,10,32,11,7,14,43,48,-5,29,35,40
7425,6826,6832,43,2,32,19,3,10,69,38,31,41,23,60
7426,6826,6832,22,9,32,10,11,11,43,45,-2,31,33,41
7427,6826,6832,40,17,32,8,7,17,42,74,-32,23,41,31
7428,6826,6832,20,15,32,6,16,10,30,42,-12,28,36,34
7429,6826,6832,41,16,32,9,6,17,45,51,-6,24,40,33
7430,6826,6832,56,18,32,5,10,17,24,55,-31,20,44,25
7431,6826,6832,52,3,32,16,7,9,53,38,15,39,25,55
7432,6826,6832,48,14,32,7,13,12,26,38,-12,27,37,34
7433,6826,6832,37,1,32,19,10,3,60,21,39,48,16,67
7434,6826,6832,49,5,32,15,10,7,42,28,14,40,24,55
7435,6826,6832,21,8,32,10,12,10,40,40,0,32,32,42
7436,6826,6832,19,7,32,10,12,10,39,38,1,32,32,42
7437,6826,6832,17,11,32,11,7,14,39,46,-7,29,35,40
7438,6826,6832,8,13,32,8,12,12,31,41,-10,28,36,36
7439,7099,7105,17,7,23,11,3,9,43,32,11,25,21,36
7440,7099,7105,19,11,23,7,7,9,27,32,-5,21,25,28
7441,7099,7105,21,14,23,6,7,10,27,29,-2,19,27,25
7442,7099,7105,1,1,23,15,3,5,49,19,30,33,13,48
7443,7099,7105,49,4,23,13,6,4,54,22,32,32,14,45
7444,7099,7105,37,8,23,7,10,6,25,28,-3,24,22,31
7445,7099,7105,48,17,23,3,10,10,25,38,-13,16,30,19
7446,7099,7105,52,5,23,12,7,4,35,20,15,31,15,43
7447,7099,7105,43,3,23,14,3,6,50,20,30,31,15,45
7448,7099,7105,57,6,23,12,4,7,40,35,5,28,18,40
7449,7099,7105,22,13,23,6,8,9,21,46,-25,20,26,26
7450,7099,7105,41,10,23,8,5,10,30,32,-2,21,25,29
7451,7099,7105,20,12,23,6,9,8,23,30,-7,21,25,27
7452,7099,7105,8,15,23,5,6,12,22,35,-13,16,30,21
7453,7099,7105,12,2,23,15,2,6,48,19,29,32,14,47
7454,7099,7105,53,9,23,7,9,7,27,27,0,23,23,30
7455,7099,7105,27,16,23,5,4,14,14,48,-34,14,32,19
7456,7099,7105,59,18,23,2,3,18,13,61,-48,7,39,9
7457,7379,7385,53,16,12,3,1,8,13,22,-9,7,17,10
7458,7379,7385,12,2,12,8,1,3,21,9,12,17,7,25
7459,7379,7385,52,5,12,6,2,4,16,16,0,14,10,20
7460,7379,7385,1,9,12,5,2,5,20,17,3,12,12,17
7461,7379,7385,57,15,12,3,3,6,19,28,-9,9,15,12
7462,7379,7385,41,18,12,2,1,9,13,22,-9,5,19,7
7463,7379,7385,56,6,12,6,1,5,19,16,3,13,11,19
7464,7379,7385,20,10,12,5,2,5,17,17,0,12,12,17
7465,7379,7385,48,11,12,4,4,4,15,19,-4,12,12,16
7466,7379,7385,43,1,12,10,1,1,31,9,22,21,3,31
7467,7379,7385,22,8,12,6,0,6,18,18,0,12,12,18
7468,7379,7385,17,7,12,5,4,3,23,18,5,14,10,19
7469,7379,7385,37,3,12,7,3,2,22,10,12,17,7,24
7470,7379,7385,49,4,12,6,3,3,27,17,10,15,9,21
7471,7379,7385,21,12,12,3,5,4,13,23,-10,11,13,14
7472,7379,7385,4,14,12,3,3,6,12,18,-6,9,15,12
7473,7379,7385,19,13,12,4,1,7,20,27,-7,9,15,13
7474,7379,7385,8,17,12,2,3,7,13,26,-13,7,17,9
7475,7393,7399,17,10,14,5,4,5,23,22,1,14,14,19
7476,7393,7399,19,14,14,5,1,8,25,31,-6,11,17,16
7477,7393,7399,8,18,14,2,3,9,15,34,-19,7,21,9
7478,7393,7399,21,13,14,4,5,5,18,26,-8,13,15,17
7479,7393,7399,4,15,14,4,3,7,18,19,-1,11,17,15
7480,7393,7399,52,6,14,7,2,5,19,19,0,16,12,23
7481,7393,7399,48,12,14,4,5,5,15,20,-5,13,15,17
7482,7393,7399,43,1,14,12,1,1,33,9,24,25,3,37
7483,7393,7399,22,9,14,6,1,7,19,20,-1,13,15,19
7484,5160,5166,20,18,10,1,5,4,8,12,-4,7,13,8
7485,5160,5166,12,11,10,4,2,4,19,22,-3,10,10,14
7486,5160,5166,53,8,10,4,3,3,13,10,3,11,9,15
7487,5307,5313,21,5,28,14,7,7,53,26,27,35,21,49
7488,5307,5313,43,2,28,14,11,3,52,16,36,39,17,53
7489,5307,5313,57,11,28,8,11,9,27,32,-5,27,29,35
7490,5307,5313,24,16,28,6,9,13,15,28,-13,21,35,27
7491,5307,5313,22,20,28,1,10,17,21,60,-39,12,44,13
7492,5307,5313,1,4,28,14,8,6,56,25,31,36,20,50
7493,5307,5313,18,18,28,5,11,12,23,54,-31,21,35,26
7494,5307,5313,17,6,28,14,4,10,41,39,2,32,24,46
7495,5307,5313,8,9,28,9,8,11,37,42,-5,26,30,35
7496,5307,5313,52,1,28,18,9,1,71,27,44,45,11,63
7497,5307,5313,48,15,28,6,13,9,25,30,-5,25,31,31
7498,5307,5313,53,7,28,13,7,8,40,28,12,33,23,46
7499,5307,5313,12,8,28,11,9,8,40,38,2,31,25,42
7500,5307,5313,41,13,28,9,6,13,33,39,-6,24,32,33
7501,5307,5313,20,14,28,8,9,11,28,34,-6,25,31,33
7502,5307,5313,49,3,28,15,6,7,45,25,20,36,20,51
7503,5307,5313,37,12,28,8,10,10,21,25,-4,26,30,34
7504,5307,5313,5,17,28,6,9,13,42,57,-15,21,35,27
7505,5307,5313,27,10,28,9,8,11,29,44,-15,26,30,35
7506,5307,5313,36,19,28,6,7,15,20,50,-30,19,37,25
7507,5107,5110,1,6,3,1,2,0,4,3,1,4,2,5
7508,5107,5110,18,17,3,0,2,1,1,2,-1,2,4,2
7509,5107,5110,27,9,3,1,1,1,3,3,0,3,3,4
7510,5107,5110,5,7,3,1,1,1,3,2,1,3,3,4
7511,5107,5110,49,8,3,1,1,1,5,5,0,3,3,4
7512,5107,5110,37,14,3,0,3,0,2,2,0,3,3,3
7513,5107,5110,52,2,3,2,1,0,4,0,4,5,1,7
7514,5107,5110,48,16,3,0,2,1,2,3,-1,2,4,2
7515,5107,5110,36,19,3,0,1,2,1,6,-5,1,5,1
7516,5107,5110,21,1,3,3,0,0,7,1,6,6,0,9
7517,5107,5110,17,3,3,2,1,0,4,1,3,5,1,7
7518,5107,5110,8,12,3,1,0,2,2,4,-2,2,4,3
7519,5107,5110,43,4,3,1,2,0,6,1,5,4,2,5
7520,5107,5110,57,5,3,1,2,0,4,2,2,4,2,5
7521,5107,5110,24,11,3,1,1,1,2,3,-1,3,3,4
7522,5107,5110,22,18,3,0,1,2,2,5,-3,1,5,1
7523,5107,5110,41,9,3,1,1,1,3,3,0,3,3,4
7524,5107,5110,20,14,3,0,3,0,2,2,0,3,3,3
7525,5107,5110,53,12,3,1,0,2,2,4,-2,2,4,3
7526,5107,5110,12,20,3,0,1,2,2,9,-7,1,5,1
7527,5349,5355,52,1,36,23,11,2,88,37,51,57,15,80
7528,5349,5355,48,15,36,8,15,13,31,43,-12,31,41,39
7529,5349,5355,36,18,36,8,7,21,31,66,-35,23,49,31
7530,5349,5355,53,6,36,17,10,9,53,34,19,44,28,61
7531,5349,5355,12,8,36,14,11,11,50,48,2,39,33,53
7532,5349,5355,43,2,36,19,13,4,70,22,48,51,21,70
7533,5349,5355,57,10,36,12,12,12,37,41,-4,36,36,48
7534,5349,5355,24,16,36,9,10,17,23,42,-19,28,44,37
7535,5349,5355,22,20,36,5,11,20,29,68,-39,21,51,26
7536,5349,5355,49,5,36,18,7,11,59,40,19,43,29,61
7537,5349,5355,37,12,36,10,12,14,27,40,-13,32,40,42
7538,5349,5355,5,17,36,8,11,17,55,78,-23,27,45,35
7539,5349,5355,17,7,36,17,6,13,50,49,1,40,32,57
7540,5349,5355,8,13,36,10,10,16,43,54,-11,30,42,40
7541,5349,5355,21,3,36,20,8,8,72,29,43,48,24,68
7542,5349,5355,1,4,36,18,11,7,77,33,44,47,25,65
7543,5349,5355,20,9,36,13,11,12,45,39,6,37,35,50
7544,5349,5355,41,11,36,13,7,16,46,52,-6,33,39,46
7545,5349,5355,27,14,36,9,12,15,36,58,-22,30,42,39
7546,5349,5355,18,19,36,6,11,19,28,77,-49,23,49,29
7547,5356,5362,1,4,37,18,11,8,77,34,43,47,27,65
7548,5356,5362,18,19,37,6,11,20,28,80,-52,23,51,29
7549,5356,5362,36,18,37,8,7,22,32,68,-36,23,51,31
7550,5356,5362,27,14,37,9,13,15,37,59,-22,31,43,40
7551,5356,5362,20,9,37,13,12,12,47,41,6,38,36,51
7552,5356,5362,41,11,37,13,7,17,46,53,-7,33,41,46
7553,5356,5362,21,2,37,21,8,8,73,29,44,50,24,71
7554,5356,5362,17,7,37,18,6,13,52,50,2,42,32,60
7555,5356,5362,8,13,37,11,10,16,44,54,-10,32,42,43
7556,5356,5362,49,6,37,18,8,11,59,40,19,44,30,62
7557,5356,5362,37,12,37,11,12,14,28,40,-12,34,40,45
7558,5356,5362,5,17,37,8,12,17,56,79,-23,28,46,36
7559,5356,5362,43,3,37,19,14,4,72,24,48,52,22,71
7560,5356,5362,57,10,37,12,13,12,37,41,-4,37,37,49
7561,5356,5362,24,16,37,9,10,18,23,43,-20,28,46,37
7562,5356,5362,22,20,37,5,12,20,29,68,-39,22,52,27
7563,6812,6818,52,3,30,15,7,8,48,34,14,37,23,52
7564,6812,6818,48,14,30,7,12,11,25,36,-11,26,34,33
7565,6812,6818,21,10,30,9,11,10,36,38,-2,29,31,38
7566,6812,6818,17,8,30,11,6,13,36,41,-5,28,32,39
7567,6812,6818,19,9,30,9,11,10,38,38,0,29,31,38
7568,6812,6818,8,13,30,8,11,11,30,37,-7,27,33,35
7569,6812,6818,37,1,30,18,9,3,58,21,37,45,15,63
7570,6812,6818,49,5,30,14,9,7,39,27,12,37,23,51
7571,6812,6818,20,15,30,6,14,10,26,38,-12,26,34,32
7572,6812,6818,41,16,30,8,6,16,40,48,-8,22,38,30
7573,6812,6818,56,18,30,4,10,16,20,50,-30,18,42,22
7574,6812,6818,43,2,30,19,2,9,67,35,32,40,20,59
7575,6812,6818,22,12,30,9,10,11,41,44,-3,28,32,37
7576,6812,6818,40,17,30,7,7,16,41,72,-31,21,39,28
7577,7015,7021,57,5,14,7,3,4,26,19,7,17,11,24
7578,7015,7021,43,7,14,7,2,5,26,17,9,16,12,23
7579,7015,7021,22,13,14,3,4,7,11,33,-22,10,18,13
7580,7015,7021,20,10,14,3,8,3,14,14,0,14,14,17
7581,7015,7021,41,11,14,4,4,6,17,22,-5,12,16,16
7582,7015,7021,21,12,14,3,6,5,11,13,-2,12,16,15
7583,7015,7021,49,3,14,8,4,2,38,16,22,20,8,28
7584,7015,7021,37,9,14,4,7,3,15,15,0,15,13,19
7585,7015,7021,52,4,14,7,5,2,19,12,7,19,9,26
7586,7015,7021,48,16,14,1,8,5,16,24,-8,10,18,11
7587,7015,7021,17,8,14,7,1,6,24,20,4,15,13,22
7588,7015,7021,19,15,14,2,5,7,14,25,-11,9,19,11
7589,7015,7021,8,17,14,2,3,9,13,21,-8,7,21,9
7590,7015,7021,1,2,14,10,2,2,31,8,23,22,6,32
7591,7015,7021,27,14,14,3,2,9,8,27,-19,8,20,11
7592,7015,7021,59,18,14,2,2,10,10,37,-27,6,22,8
7593,7015,7021,12,1,14,10,2,2,34,8,26,22,6,32
7594,7015,7021,53,6,14,6,6,2,18,14,4,18,10,24
7595,7176,7182,27,16,32,8,5,19,21,63,-42,21,43,29
7596,7176,7182,59,18,32,2,5,25,18,89,-71,9,55,11
7597,7176,7182,52,3,32,18,9,5,52,26,26,45,19,63
7598,7176,7182,48,17,32,6,11,15,37,60,-23,23,41,29
7599,7176,7182,1,1,32,22,5,5,70,30,40,49,15,71
7600,7176,7182,21,13,32,9,8,15,39,43,-4,26,38,35
7601,7176,7182,8,15,32,9,7,16,32,48,-16,25,39,34
7602,7176,7182,12,4,32,18,5,9,60,27,33,41,23,59
7603,7176,7182,53,14,32,8,11,13,37,47,-10,27,37,35
7604,7176,7182,41,8,32,12,7,13,48,44,4,31,33,43
7605,7176,7182,20,12,32,9,11,12,31,41,-10,29,35,38
7606,7176,7182,43,6,32,16,6,10,62,33,29,38,26,54
7607,7176,7182,57,10,32,12,6,14,47,56,-9,30,34,42
7608,7176,7182,22,11,32,10,11,11,32,61,-29,31,33,41
7609,7176,7182,49,2,32,20,7,5,78,29,49,47,17,67
7610,7176,7182,37,9,32,11,10,11,36,40,-4,32,32,43
7611,7176,7182,17,5,32,17,4,11,69,40,29,38,26,55
7612,7176,7182,19,7,32,13,8,11,47,39,8,34,30,47
7613,7190,7301,49,2,34,20,9,5,80,31,49,49,19,69
7614,7190,7301,41,10,34,12,9,13,51,47,4,33,35,45
7615,7190,7301,20,12,34,10,11,13,33,42,-9,31,37,41
7616,7190,7301,43,6,34,17,7,10,64,34,30,41,27,58
7617,7190,7301,22,8,34,12,11,11,35,62,-27,35,33,47
7618,7190,7301,57,9,34,13,6,15,51,60,-9,32,36,45
7619,7190,7301,12,4,34,18,6,10,60,28,32,42,26,60
7620,7190,7301,48,16,34,7,12,15,40,61,-21,26,42,33
7621,7190,7301,37,11,34,11,10,13,37,45,-8,32,36,43
7622,7190,7301,17,5,34,18,4,12,72,43,29,40,28,58
7623,7190,7301,19,7,34,14,9,11,50,39,11,37,31,51
7624,7190,7301,8,14,34,9,8,17,34,51,-17,26,42,35
7625,7190,7301,21,13,34,10,8,16,42,49,-7,28,40,38
7626,7190,7301,1,1,34,24,5,5,76,31,45,53,15,77
7627,7190,7301,52,3,34,19,10,5,57,28,29,48,20,67
7628,7190,7301,27,17,34,8,6,20,23,66,-43,22,46,30
7629,7190,7301,59,18,34,2,6,26,21,94,-73,10,58,12
7630,7190,7301,53,15,34,8,11,15,37,52,-15,27,41,35
7631,6980,6986,12,1,9,7,1,1,15,4,11,15,3,22
7632,6980,6986,53,6,9,4,5,0,11,7,4,13,5,17
7633,6980,6986,59,12,9,2,2,5,8,17,-9,6,12,8
7634,6980,6986,27,14,9,2,1,6,4,16,-12,5,13,7
7635,6980,6986,52,2,9,6,2,1,12,6,6,14,4,20
7636,6980,6986,48,13,9,1,5,3,11,14,-3,7,11,8
7637,6980,6986,1,3,9,6,1,2,16,5,11,13,5,19
7638,6980,6986,17,8,9,4,0,5,17,14,3,8,10,12
7639,6980,6986,19,17,9,1,3,5,9,18,-9,5,13,6
7640,6980,6986,8,18,9,1,1,7,10,15,-5,3,15,4
7641,6840,6933,20,16,34,6,16,12,30,46,-16,28,40,34
7642,6840,6933,56,18,34,5,11,18,26,58,-32,21,47,26
7643,6840,6933,41,14,34,10,6,18,49,55,-6,26,42,36
7644,7001,7007,20,10,12,3,7,2,13,12,1,13,11,16
7645,7001,7007,41,11,12,3,3,6,15,22,-7,9,15,12
7646,7001,7007,57,4,12,7,2,3,24,15,9,16,8,23
7647,7001,7007,43,7,12,6,2,4,25,14,11,14,10,20
7648,7001,7007,22,12,12,3,3,6,10,30,-20,9,15,12
7649,7001,7007,48,15,12,1,6,5,13,21,-8,8,16,9
7650,7001,7007,8,16,12,2,2,8,11,18,-7,6,18,8
7651,7001,7007,19,18,12,1,4,7,11,23,-12,6,18,7
7652,7001,7007,17,9,12,5,1,6,21,20,1,11,13,16
7653,7001,7007,49,3,12,7,3,2,35,14,21,17,7,24
7654,7001,7007,37,8,12,4,5,3,15,15,0,13,11,17
7655,7001,7007,21,13,12,2,5,5,10,13,-3,9,15,11
7656,7001,7007,1,2,12,9,1,2,27,7,20,19,5,28
7657,7001,7007,12,1,12,9,2,1,23,5,18,20,4,29
7658,7001,7007,53,5,12,6,5,1,17,12,5,17,7,23
7659,7001,7007,27,14,12,3,1,8,8,26,-18,7,17,10
7660,7001,7007,59,17,12,2,2,8,9,25,-16,6,18,8
7661,7001,7007,52,6,12,6,4,2,13,8,5,16,8,22
7662,7162,7168,52,3,30,17,8,5,49,25,24,42,18,59
7663,7162,7168,48,16,30,6,10,14,34,52,-18,22,38,28
7664,7162,7168,27,17,30,7,5,18,19,60,-41,19,41,26
7665,7162,7168,59,18,30,2,5,23,18,79,-61,9,51,11
7666,7162,7168,1,1,30,20,5,5,66,29,37,45,15,65
7667,7162,7168,21,13,30,9,7,14,38,40,-2,25,35,34
7668,7162,7168,17,6,30,15,4,11,60,40,20,34,26,49
7669,7162,7168,19,9,30,11,8,11,41,39,2,30,30,41
7670,7162,7168,8,15,30,8,7,15,30,47,-17,23,37,31
7671,7162,7168,41,7,30,12,6,12,46,41,5,30,30,42
7672,7162,7168,20,12,30,9,11,10,31,37,-6,29,31,38
7673,7162,7168,12,4,30,17,5,8,54,24,30,39,21,56
7674,7162,7168,53,14,30,8,9,13,34,44,-10,25,35,33
7675,7162,7168,43,5,30,16,4,10,59,30,29,36,24,52
7676,7162,7168,57,8,30,12,5,13,46,52,-6,29,31,41
7677,7162,7168,22,11,30,10,10,10,30,56,-26,30,30,40
7678,7162,7168,49,2,30,18,7,5,72,29,43,43,17,61
7679,7162,7168,37,10,30,10,10,10,35,38,-3,30,30,40
7680,6959,6965,57,3,6,4,1,1,12,6,6,9,3,13
7681,6959,6965,43,7,6,3,0,3,12,11,1,6,6,9
7682,6959,6965,22,14,6,1,3,2,3,9,-6,5,7,6
7683,6959,6965,12,1,6,5,1,0,10,2,8,11,1,16
7684,6959,6965,53,6,6,2,4,0,7,5,2,8,4,10
7685,6959,6965,20,13,6,1,3,2,6,9,-3,5,7,6
7686,6959,6965,41,17,6,0,2,4,4,11,-7,2,10,2
7687,6959,6965,52,4,6,4,1,1,6,4,2,9,3,13
7688,6959,6965,48,12,6,1,3,2,8,10,-2,5,7,6
7689,6959,6965,49,5,6,3,3,0,14,8,6,9,3,12
7690,6959,6965,37,8,6,2,3,1,8,6,2,7,5,9
7691,6959,6965,21,16,6,0,3,3,1,5,-4,3,9,3
7692,6959,6965,19,18,6,0,2,4,4,12,-8,2,10,2
7693,6959,6965,17,11,6,2,0,4,11,11,0,4,8,6
7694,6959,6965,8,15,6,1,1,4,9,7,2,3,9,4
7695,6959,6965,1,2,6,4,1,1,11,2,9,9,3,13
7696,6959,6965,59,9,6,2,2,2,7,8,-1,6,6,8
7697,6959,6965,27,10,6,2,1,3,4,11,-7,5,7,7
7698,6973,6979,59,11,8,2,2,4,7,14,-7,6,10,8
7699,6973,6979,27,13,8,2,1,5,4,14,-10,5,11,7
7700,6973,6979,52,2,8,6,1,1,11,5,6,13,3,19
7701,6973,6979,48,14,8,1,4,3,9,12,-3,6,10,7
7702,6973,6979,12,1,8,6,1,1,13,4,9,13,3,19
7703,6973,6979,53,6,8,4,4,0,10,6,4,12,4,16
7704,6973,6979,17,9,8,3,0,5,16,14,2,6,10,9
7705,6973,6979,19,17,8,1,2,5,8,17,-9,4,12,5
7706,6973,6979,8,18,8,1,1,6,10,14,-4,3,13,4
7707,6973,6979,1,4,8,5,1,2,14,4,10,11,5,16
7708,6973,6979,21,15,8,1,3,4,5,8,-3,5,11,6
7709,6973,6979,49,3,8,5,3,0,20,10,10,13,3,18
7710,6973,6979,37,8,8,3,3,2,11,10,1,9,7,12
7711,6973,6979,57,5,8,5,1,2,16,12,4,11,5,16
7712,6973,6979,43,7,8,4,1,3,18,12,6,9,7,13
7713,6973,6979,22,10,8,2,3,3,6,12,-6,7,9,9
7714,6973,6979,20,12,8,1,5,2,7,10,-3,7,9,8
7715,6973,6979,41,16,8,1,2,5,9,16,-7,4,12,5
7716,7470,7483,20,11,22,7,6,9,27,31,-4,20,24,27
7717,7470,7483,41,12,22,7,4,11,32,32,0,18,26,25
7718,7470,7483,56,13,22,7,4,11,24,34,-10,18,26,25
7719,7470,7483,52,6,22,10,3,9,30,31,-1,23,21,33
7720,7470,7483,48,17,22,4,7,11,20,51,-31,15,29,19
7721,3011,3024,52,7,12,4,5,3,18,20,-2,13,11,17
7722,3011,3024,43,3,12,5,6,1,28,13,15,16,8,21
7723,3011,3024,24,15,12,2,4,6,16,29,-13,8,16,10
7724,3011,3024,17,8,12,3,7,2,19,15,4,13,11,16
7725,3011,3024,8,13,12,3,4,5,13,21,-8,10,14,13
7726,3011,3024,20,9,12,4,3,5,20,21,-1,11,13,15
7727,3011,3024,41,10,12,4,2,6,19,25,-6,10,14,14
7728,3011,3024,4,14,12,2,6,4,12,16,-4,10,14,12
7729,3011,3024,7,16,12,2,3,7,11,23,-12,7,17,9
7730,3011,3024,49,2,12,6,4,2,22,9,13,16,8,22
7731,3011,3024,37,11,12,3,5,4,20,19,1,11,13,14
7732,3011,3024,53,5,12,5,3,4,25,21,4,13,11,18
7733,3011,3024,1,4,12,6,2,4,21,13,8,14,10,20
7734,3011,3024,27,1,12,7,2,3,20,14,6,16,8,23
7735,3011,3024,39,12,12,3,4,5,14,20,-6,10,14,13
7736,3025,3031,27,1,13,8,2,3,21,14,7,18,8,26
7737,3025,3031,39,10,13,4,4,5,16,20,-4,12,14,16
7738,3025,3031,1,3,13,7,2,4,24,13,11,16,10,23
7739,3025,3031,53,7,13,5,3,5,26,25,1,13,13,18
7740,3025,3031,49,2,13,7,4,2,25,10,15,18,8,25
7741,3025,3031,37,8,13,4,5,4,21,19,2,13,13,17
7742,3025,3031,4,15,13,2,6,5,12,18,-6,10,16,12
7743,3025,3031,7,16,13,2,3,8,12,27,-15,7,19,9
7744,3025,3031,20,11,13,4,3,6,21,24,-3,11,15,15
7745,3025,3031,41,12,13,4,2,7,19,28,-9,10,16,14
7746,3025,3031,17,6,13,4,7,2,23,16,7,15,11,19
7747,3025,3031,8,13,13,3,4,6,13,22,-9,10,16,13
7748,3025,3031,43,4,13,5,6,2,28,14,14,16,10,21
7749,3025,3031,24,14,13,3,4,6,17,29,-12,10,16,13
7750,3025,3031,28,5,13,5,6,2,22,18,4,16,10,21
7751,3025,3031,52,9,13,4,5,4,18,21,-3,13,13,17
7752,3067,3073,28,6,18,6,8,4,25,24,1,20,16,26
7753,3067,3073,52,9,18,6,5,7,22,25,-3,17,19,23
7754,3067,3073,43,4,18,8,8,2,41,20,21,24,12,32
7755,3067,3073,24,15,18,3,4,11,20,38,-18,10,26,13
7756,3067,3073,17,5,18,7,8,3,33,25,8,22,14,29
7757,3067,3073,8,10,18,6,5,7,18,26,-8,17,19,23
7758,3067,3073,20,7,18,7,3,8,30,30,0,17,19,24
7759,3067,3073,41,13,18,5,3,10,22,33,-11,13,23,18
7760,3067,3073,49,1,18,11,5,2,38,11,27,27,9,38
7761,3067,3073,37,12,18,5,6,7,24,30,-6,16,20,21
7762,3067,3073,53,8,18,7,3,8,31,34,-3,17,19,24
7763,3067,3073,4,11,18,5,7,6,19,24,-5,17,19,22
7764,3067,3073,7,16,18,3,4,11,15,35,-20,10,26,13
7765,3067,3073,27,3,18,10,3,5,30,22,8,23,13,33
7766,3067,3073,39,14,18,4,6,8,18,27,-9,14,22,18
7767,3067,3073,1,2,18,10,4,4,37,19,18,24,12,34
7768,2990,2996,1,3,9,4,2,3,13,10,3,10,8,14
7769,2990,2996,27,1,9,7,1,1,17,7,10,15,3,22
7770,2990,2996,39,14,9,2,3,4,10,16,-6,7,11,9
7771,2990,2996,53,9,9,3,2,4,13,17,-4,8,10,11
7772,2990,2996,49,2,9,6,1,2,22,9,13,13,5,19
7773,2990,2996,37,10,9,2,5,2,19,16,3,9,9,11
7774,2990,2996,20,6,9,3,3,3,15,18,-3,9,9,12
7775,2990,2996,41,15,9,2,1,6,10,22,-12,5,13,7
7776,2990,2996,7,12,9,2,3,4,10,15,-5,7,11,9
7777,2990,2996,4,16,9,1,4,4,9,14,-5,6,12,7
7778,2990,2996,8,5,9,3,3,3,12,14,-2,9,9,12
7779,2990,2996,17,7,9,2,6,1,16,12,4,10,8,12
7780,2990,2996,43,4,9,3,5,1,24,12,12,11,7,14
7781,2990,2996,24,13,9,2,3,4,11,17,-6,7,11,9
7782,2990,2996,52,11,9,2,4,3,13,18,-5,8,10,10
7783,2990,2996,28,8,9,2,6,1,14,11,3,10,8,12
7784,3431,3437,43,5,20,8,6,6,39,19,20,22,18,30
7785,3431,3437,26,15,20,3,5,12,17,42,-25,11,29,14
7786,3431,3437,17,8,20,7,7,6,26,23,3,21,19,28
7787,3431,3437,8,16,20,2,7,11,21,37,-16,11,29,13
7788,3431,3437,20,11,20,6,7,7,23,35,-12,19,21,25
7789,3431,3437,41,14,20,3,5,12,22,35,-13,11,29,14
7790,3431,3437,49,2,20,13,5,2,44,17,27,31,9,44
7791,3431,3437,37,6,20,8,6,6,25,22,3,22,18,30
7792,3431,3437,5,13,20,4,6,10,18,37,-19,14,26,18
7793,3431,3437,52,9,20,7,6,7,25,30,-5,20,20,27
7794,3431,3437,28,10,20,7,5,8,29,32,-3,19,21,26
7795,3431,3437,53,4,20,9,6,5,26,15,11,24,16,33
7796,3431,3437,4,3,20,12,4,4,38,19,19,28,12,40
7797,3431,3437,27,7,20,9,2,9,28,27,1,20,20,29
7798,3431,3437,39,12,20,5,7,8,18,29,-11,17,23,22
7799,3431,3437,1,1,20,14,2,4,46,26,20,30,10,44
7800,5174,5180,24,9,12,4,5,3,11,9,2,13,11,17
7801,5174,5180,22,20,12,0,3,9,8,29,-21,3,21,3
7802,5174,5180,52,2,12,7,5,0,29,10,19,19,5,26
7803,5174,5180,48,16,12,2,7,3,9,10,-1,11,13,13
7804,5174,5180,36,19,12,0,5,7,6,26,-20,5,19,5
7805,5174,5180,53,3,12,6,3,3,19,13,6,15,9,21
7806,5174,5180,12,8,12,5,2,5,21,25,-4,12,12,17
7807,5174,5180,17,6,12,5,3,4,19,14,5,13,11,18
7808,5174,5180,8,17,12,3,3,6,10,19,-9,9,15,12
7809,5174,5180,21,4,12,6,3,3,17,11,6,15,9,21
7810,5216,5222,17,8,17,7,3,7,24,24,0,17,17,24
7811,5216,5222,8,17,17,4,4,9,16,27,-11,12,22,16
7812,5216,5222,1,4,17,8,5,4,32,19,13,21,13,29
7813,5216,5222,18,13,17,5,7,5,19,27,-8,17,17,22
7814,5216,5222,53,2,17,9,4,4,28,16,12,22,12,31
7815,5216,5222,12,9,17,6,5,6,25,29,-4,17,17,23
7816,5216,5222,5,11,17,5,7,5,32,32,0,17,17,22
7817,5216,5222,37,15,17,4,7,6,15,17,-2,15,19,19
7818,5216,5222,43,3,17,8,7,2,32,11,21,23,11,31
7819,5216,5222,57,7,17,6,7,4,18,20,-2,19,15,25
7820,5216,5222,24,12,17,5,7,5,12,12,0,17,17,22
7821,5216,5222,22,19,17,1,7,9,15,33,-18,9,25,10
7822,5216,5222,21,5,17,8,5,4,25,18,7,21,13,29
7823,5216,5222,20,14,17,4,7,6,17,18,-1,15,19,19
7824,5216,5222,41,18,17,3,6,8,14,23,-9,12,22,15
7825,5216,5222,49,6,17,8,4,5,29,19,10,20,14,28
7826,5216,5222,52,1,17,10,7,0,43,16,27,27,7,37
7827,5216,5222,48,16,17,3,8,6,12,16,-4,14,20,17
7828,5216,5222,36,20,17,1,6,10,9,35,-26,8,26,9
7829,5216,5222,27,10,17,6,5,6,18,23,-5,17,17,23
7830,5692,5694,27,17,30,6,7,17,37,59,-22,19,41,25
7831,5692,5694,1,1,31,20,6,5,66,27,39,46,16,66
7832,5692,5694,20,8,30,12,11,7,49,33,16,35,25,47
7833,5692,5694,41,12,30,10,9,11,48,48,0,29,31,39
7834,5692,5694,21,10,30,10,11,9,30,38,-8,31,29,41
7835,5692,5694,43,3,30,15,8,7,53,34,19,38,22,53
7836,5692,5694,57,11,31,9,12,10,39,41,-2,30,32,39
7837,5692,5694,37,5,30,12,13,5,32,16,16,37,23,49
7838,5692,5694,49,9,30,13,7,10,45,39,6,33,27,46
7839,5692,5694,5,14,30,8,9,13,34,49,-15,25,35,33
7840,5692,5694,12,2,31,19,3,9,56,30,26,41,21,60
7841,5692,5694,53,7,30,14,8,8,50,44,6,36,24,50
7842,5692,5694,52,4,30,14,9,7,46,25,21,37,23,51
7843,5692,5694,48,18,31,4,10,17,20,51,-31,18,44,22
7844,5692,5694,54,19,30,4,5,21,16,57,-41,13,47,17
7845,5692,5694,24,13,31,9,9,13,40,48,-8,27,35,36
7846,5692,5694,40,15,30,5,13,12,33,51,-18,23,37,28
7847,5692,5694,17,6,30,14,8,8,54,35,19,36,24,50
7848,5692,5694,8,16,31,7,8,16,25,48,-23,22,40,29
7849,5727,5733,21,10,35,10,14,11,38,52,-14,34,36,44
7850,5727,5733,17,8,35,14,11,10,58,42,16,39,31,53
7851,5727,5733,8,16,35,7,12,16,27,50,-23,26,44,33
7852,5727,5733,12,4,35,19,7,9,58,32,26,45,25,64
7853,5727,5733,53,7,35,16,9,10,57,50,7,41,29,57
7854,5727,5733,37,6,35,14,14,7,38,22,16,42,28,56
7855,5727,5733,49,9,35,15,9,11,51,43,8,39,31,54
7856,5727,5733,5,14,35,9,11,15,40,61,-21,29,41,38
7857,5727,5733,43,3,35,18,10,7,63,35,28,46,24,64
7858,5727,5733,57,12,35,9,13,13,41,50,-9,31,39,40
7859,5727,5733,24,13,36,9,11,16,45,62,-17,29,43,38
7860,5727,5733,40,15,35,6,16,13,39,57,-18,28,42,34
7861,5727,5733,20,5,35,16,12,7,60,37,23,44,26,60
7862,5727,5733,41,11,35,11,11,13,58,62,-4,33,37,44
7863,5727,5733,27,17,35,8,9,18,45,61,-16,25,45,33
7864,5727,5733,52,2,35,18,10,7,60,30,30,46,24,64
7865,5727,5733,54,18,35,6,8,21,27,64,-37,20,50,26
7866,5727,5733,48,19,35,4,11,20,21,57,-36,19,51,23
7867,5727,5733,1,1,35,21,8,6,77,36,41,50,20,71
7868,5734,5852,1,1,36,22,8,6,81,38,43,52,20,74
7869,5734,5852,52,3,36,18,11,7,60,30,30,47,25,65
7870,5734,5852,27,16,36,9,9,18,47,62,-15,27,45,36
7871,5734,5852,20,5,36,16,12,8,61,39,22,44,28,60
7872,5734,5852,41,10,36,12,11,13,59,62,-3,35,37,47
7873,5734,5852,43,2,36,19,10,7,65,36,29,48,24,67
7874,5734,5852,40,14,36,7,16,13,42,59,-17,30,42,37
7875,5734,5852,24,15,36,9,11,16,45,62,-17,29,43,38
7876,5734,5852,37,6,36,15,14,7,41,24,17,44,28,59
7877,5734,5852,49,9,36,15,9,12,53,46,7,39,33,54
7878,7022,7028,57,7,15,7,3,5,28,23,5,17,13,24
7879,7022,7028,22,14,15,3,4,8,11,38,-27,10,20,13
7880,7022,7028,20,10,15,4,8,3,17,14,3,16,14,20
7881,7022,7028,41,12,15,4,4,7,18,24,-6,12,18,16
7882,7022,7028,52,4,15,7,6,2,20,13,7,20,10,27
7883,7022,7028,48,13,15,2,8,5,18,24,-6,12,18,14
7884,7022,7028,21,11,15,4,6,5,16,14,2,14,16,18
7885,7022,7028,49,3,15,8,4,3,39,19,20,20,10,28
7886,7022,7028,37,9,15,5,7,3,17,16,1,17,13,22
7887,7022,7028,17,6,15,8,1,6,27,21,6,17,13,25
7888,7022,7028,8,15,15,3,3,9,15,22,-7,9,21,12
7889,7022,7028,19,16,15,2,6,7,15,26,-11,10,20,12
7890,7022,7028,12,1,15,11,2,2,38,10,28,24,6,35
7891,7022,7028,53,8,15,6,6,3,18,16,2,18,12,24
7892,7022,7028,27,17,15,3,2,10,8,30,-22,8,22,11
7893,7022,7028,59,18,15,2,2,11,11,42,-31,6,24,8
7894,7071,7077,27,17,19,3,3,13,9,42,-33,9,29,12
7895,7071,7077,59,18,19,2,3,14,13,50,-37,7,31,9
7896,7071,7077,12,1,19,14,2,3,46,15,31,30,8,44
7897,7071,7077,53,8,19,7,7,5,24,22,2,21,17,28
7898,7071,7077,52,4,19,9,7,3,25,18,7,25,13,34
7899,7071,7077,48,15,19,3,9,7,23,30,-7,15,23,18
7900,7071,7077,17,7,19,9,2,8,32,26,6,20,18,29
7901,7071,7077,19,13,19,5,6,8,20,29,-9,16,22,21
7902,7071,7077,8,16,19,4,5,10,20,28,-8,13,25,17
7903,7071,7077,49,3,19,10,5,4,47,22,25,25,13,35
7904,7071,7077,37,9,19,6,9,4,20,21,-1,21,17,27
7905,7071,7077,21,10,19,6,6,7,25,19,6,18,20,24
7906,7071,7077,41,11,19,6,5,8,25,29,-4,17,21,23
7907,7071,7077,20,12,19,5,8,6,20,21,-1,18,20,23
7908,7071,7077,43,5,19,10,3,6,38,20,18,23,15,33
7909,7071,7077,57,6,19,9,4,6,33,29,4,22,16,31
7910,7071,7077,22,14,19,4,6,9,16,44,-28,14,24,18
7911,7071,7077,1,2,19,13,2,4,44,15,29,28,10,41
7912,7085,7091,1,2,21,13,3,5,46,18,28,29,13,42
7913,7085,7091,43,4,21,12,3,6,43,20,23,27,15,39
7914,7085,7091,57,6,21,10,4,7,36,33,3,24,18,34
7915,7085,7091,22,14,21,5,7,9,19,45,-26,17,25,22
7916,7085,7091,41,10,21,7,5,9,26,30,-4,19,23,26
7917,7085,7091,20,13,21,5,9,7,21,23,-2,19,23,24
7918,7085,7091,21,11,21,6,7,8,26,21,5,19,23,25
7919,7085,7091,49,5,21,11,6,4,48,22,26,28,14,39
7920,7085,7091,37,9,21,6,10,5,22,26,-4,22,20,28
7921,7085,7091,17,7,21,10,3,8,37,28,9,23,19,33
7922,7085,7091,19,12,21,6,7,8,24,31,-7,19,23,25
7923,7085,7091,8,16,21,4,6,11,20,30,-10,14,28,18
7924,7085,7091,52,3,21,11,7,3,31,19,12,29,13,40
7925,7085,7091,48,15,21,3,10,8,24,34,-10,16,26,19
7926,7085,7091,12,1,21,15,2,4,47,16,31,32,10,47
7927,7085,7091,53,8,21,7,9,5,25,23,2,23,19,30
7928,7085,7091,27,17,21,4,3,14,11,46,-35,11,31,15
7929,7085,7091,59,18,21,2,3,16,13,54,-41,7,35,9
7930,7134,7147,27,16,27,6,5,16,17,55,-38,17,37,23
7931,7134,7147,59,18,27,2,4,21,15,67,-52,8,46,10
7932,7134,7147,12,2,27,16,4,7,51,21,30,36,18,52
7933,7134,7147,53,13,27,8,9,10,32,36,-4,25,29,33
7934,7134,7147,52,4,27,14,8,5,41,25,16,36,18,50
7935,7134,7147,48,17,27,4,10,13,30,49,-19,18,36,22
7936,7134,7147,1,1,27,17,5,5,59,26,33,39,15,56
7937,7134,7147,17,6,27,13,4,10,51,35,16,30,24,43
7938,7134,7147,19,8,27,10,8,9,37,34,3,28,26,38
7939,7134,7147,8,15,27,7,6,14,27,42,-15,20,34,27
7940,7134,7147,49,3,27,15,7,5,62,26,36,37,17,52
7941,7134,7147,37,9,27,9,10,8,30,32,-2,28,26,37
7942,7134,7147,21,14,27,8,7,12,34,36,-2,23,31,31
7943,7134,7147,41,10,27,10,6,11,36,37,-1,26,28,36
7944,7134,7147,20,12,27,8,10,9,27,33,-6,26,28,34
7945,7134,7147,43,5,27,15,4,8,55,27,28,34,20,49
7946,7134,7147,57,7,27,12,4,11,44,45,-1,28,26,40
7947,7134,7147,22,11,27,9,9,9,27,49,-22,27,27,36
7948,7302,7304,57,1,1,1,0,0,4,1,3,2,0,3
7949,7302,7304,43,2,1,1,0,0,4,2,2,2,0,3
7950,7302,7304,22,12,1,0,0,1,0,1,-1,0,2,0
7951,7302,7304,41,12,1,0,0,1,0,1,-1,0,2,0
7952,7302,7304,20,16,1,0,0,1,0,2,-2,0,2,0
7953,7302,7304,56,18,1,0,0,1,1,4,-3,0,2,0
7954,7302,7304,21,10,1,0,1,0,0,0,0,1,1,1
7955,7302,7304,4,12,1,0,0,1,0,1,-1,0,2,0
7956,7302,7304,37,5,1,1,0,0,1,0,1,2,0,3
7957,6980,6986,21,15,9,1,3,5,6,10,-4,5,13,6
7958,6980,6986,49,5,9,5,3,1,21,12,9,13,5,18
7959,6980,6986,37,9,9,3,3,3,12,14,-2,9,9,12
7960,6980,6986,57,4,9,6,1,2,18,13,5,13,5,19
7961,6980,6986,43,7,9,5,1,3,22,13,9,11,7,16
7962,6980,6986,22,10,9,3,3,3,9,13,-4,9,9,12
7963,6980,6986,20,11,9,1,6,2,8,11,-3,8,10,9
7964,6980,6986,41,16,9,1,3,5,11,18,-7,5,13,6
7965,7498,7504,20,11,25,8,7,10,32,34,-2,23,27,31
7966,7498,7504,41,12,25,8,5,12,37,34,3,21,29,29
7967,7498,7504,56,13,25,8,5,12,29,39,-10,21,29,29
7968,7498,7504,43,1,25,20,3,2,52,16,36,43,7,63
7969,7498,7504,22,9,25,10,5,10,31,37,-6,25,25,35
7970,7498,7504,57,14,25,7,5,13,37,55,-18,19,31,26
7971,7498,7504,52,7,25,11,4,10,37,38,-1,26,24,37
7972,7498,7504,48,18,25,4,8,13,21,61,-40,16,34,20
7973,7498,7504,12,3,25,13,5,7,52,30,22,31,19,44
7974,7498,7504,53,17,25,5,6,14,22,36,-14,16,34,21
7975,7498,7504,37,2,25,15,4,6,41,21,20,34,16,49
7976,7498,7504,49,4,25,13,5,7,50,35,15,31,19,44
7977,7498,7504,21,6,25,10,8,7,37,39,-2,28,22,38
7978,7498,7504,4,8,25,10,7,8,40,31,9,27,23,37
7979,7498,7504,17,10,25,9,8,8,43,37,6,26,24,35
7980,7498,7504,19,15,25,7,3,15,41,58,-17,17,33,24
7981,7498,7504,8,16,25,6,6,13,31,51,-20,18,32,24
7982,7498,7504,1,5,25,12,4,9,55,36,19,28,22,40
7983,7519,7525,1,5,28,13,4,11,61,46,15,30,26,43
7984,7519,7525,8,17,28,6,7,15,31,54,-23,19,37,25
7985,7519,7525,17,10,28,9,11,8,47,41,6,29,27,38
7986,7519,7525,19,13,28,9,4,15,45,60,-15,22,34,31
7987,7519,7525,21,8,28,10,10,8,37,40,-3,30,26,40
7988,7519,7525,4,9,28,10,8,10,43,39,4,28,28,38
7989,7519,7525,37,2,28,16,6,6,46,25,21,38,18,54
7990,7519,7525,49,4,28,14,5,9,51,40,11,33,23,47
7991,7519,7525,12,3,28,15,6,7,57,31,26,36,20,51
7992,7519,7525,53,16,28,7,6,15,30,39,-9,20,36,27
7993,7519,7525,52,6,28,12,5,11,39,40,-1,29,27,41
7994,7519,7525,48,18,28,5,9,14,24,64,-40,19,37,24
7995,7519,7525,43,1,28,21,5,2,59,17,42,47,9,68
7996,7519,7525,22,7,28,12,5,11,36,39,-3,29,27,41
7997,7519,7525,57,15,28,8,6,14,41,57,-16,22,34,30
7998,7519,7525,20,11,28,9,8,11,35,38,-3,26,30,35
7999,7519,7525,56,12,28,9,6,13,34,48,-14,24,32,33
8000,7519,7525,41,14,28,8,7,13,41,39,2,23,33,31
8001,7316,7322,20,9,4,2,0,2,6,6,0,4,4,6
8002,7316,7322,56,10,4,2,0,2,7,8,-1,4,4,6
8003,7316,7322,41,16,4,0,1,3,4,9,-5,1,7,1
8004,7316,7322,43,1,4,4,0,0,14,3,11,8,0,12
8005,7316,7322,57,3,4,3,1,0,12,6,6,7,1,10
8006,7316,7322,22,8,4,2,0,2,7,6,1,4,4,6
8007,7316,7322,49,2,4,3,1,0,14,6,8,7,1,10
8008,7316,7322,37,6,4,3,0,1,6,5,1,6,2,9
8009,7316,7322,48,4,4,3,1,0,7,2,5,7,1,10
8010,7316,7322,52,5,4,3,1,0,6,2,4,7,1,10
8011,7316,7322,4,15,4,0,1,3,0,4,-4,1,7,1
8012,7316,7322,21,17,4,0,1,3,1,11,-10,1,7,1
8013,7316,7322,17,11,4,1,2,1,7,8,-1,4,4,5
8014,7316,7322,19,13,4,1,0,3,6,9,-3,2,6,3
8015,7316,7322,8,14,4,0,1,3,4,8,-4,1,7,1
8016,7316,7322,1,12,4,1,1,2,5,10,-5,3,5,4
8017,7316,7322,12,7,4,2,1,1,5,3,2,5,3,7
8018,7316,7322,53,18,4,0,0,4,6,11,-5,0,8,0
8019,7736,7738,12,10,11,4,2,5,11,13,-2,10,12,14
8020,7736,7738,8,9,11,4,3,4,12,15,-3,11,11,15
8021,7736,7738,19,13,11,3,3,5,12,19,-7,9,13,12
8022,7736,7738,17,2,11,7,2,2,18,12,6,16,6,23
8023,7736,7738,21,7,11,4,4,3,14,10,4,12,10,16
8024,7736,7738,4,1,11,8,2,1,19,7,12,18,4,26
8025,7736,7738,1,17,11,2,2,7,13,19,-6,6,16,8
8026,7736,7738,52,6,11,6,1,4,18,16,2,13,9,19
8027,7736,7738,3,15,11,3,2,6,12,17,-5,8,14,11
8028,7736,7738,37,11,11,3,5,3,8,9,-1,11,11,14
8029,7736,7738,49,3,11,6,4,1,19,8,11,16,6,22
8030,7736,7738,57,14,11,3,2,6,19,24,-5,8,14,11
8031,7736,7738,22,16,11,2,3,6,8,19,-11,7,15,9
8032,7736,7738,24,18,11,0,4,7,8,18,-10,4,18,4
8033,7736,7738,43,4,11,6,3,2,21,11,10,15,7,21
8034,7736,7738,56,5,11,6,2,3,16,14,2,14,8,20
8035,7736,7738,41,8,11,4,3,4,14,11,3,11,11,15
8036,7736,7738,20,12,11,3,3,5,9,9,0,9,13,12
8037,7393,7399,57,11,14,5,3,6,22,29,-7,13,15,18
8038,7393,7399,37,2,14,9,3,2,27,11,16,21,7,30
8039,7393,7399,49,3,14,8,3,3,31,19,12,19,9,27
8040,7393,7399,56,7,14,7,1,6,22,23,-1,15,13,22
8041,7393,7399,20,8,14,6,2,6,20,20,0,14,14,20
8042,7393,7399,41,16,14,3,1,10,16,23,-7,7,21,10
8043,7393,7399,1,5,14,7,2,5,26,20,6,16,12,23
8044,7393,7399,12,4,14,8,1,5,24,16,8,17,11,25
8045,7393,7399,53,17,14,3,1,10,13,25,-12,7,21,10
8046,7491,7497,1,5,24,11,4,9,53,36,17,26,22,37
8047,7491,7497,20,11,24,8,6,10,31,33,-2,22,26,30
8048,7491,7497,56,12,24,8,5,11,29,37,-8,21,27,29
8049,7491,7497,41,13,24,8,4,12,36,33,3,20,28,28
8050,7491,7497,43,1,24,19,3,2,46,14,32,41,7,60
8051,7491,7497,37,2,24,15,4,5,40,19,21,34,14,49
8052,7491,7497,49,4,24,12,5,7,43,34,9,29,19,41
8053,7491,7497,22,9,24,10,4,10,30,36,-6,24,24,34
8054,7491,7497,57,14,24,7,5,12,37,53,-16,19,29,26
8055,7491,7497,12,3,24,13,4,7,52,30,22,30,18,43
8056,7491,7497,53,17,24,5,5,14,22,36,-14,15,33,20
8057,7491,7497,52,8,24,10,4,10,35,38,-3,24,24,34
8058,7491,7497,48,18,24,4,8,12,20,54,-34,16,32,20
8059,7491,7497,21,7,24,9,8,7,35,38,-3,26,22,35
8060,7491,7497,4,10,24,9,7,8,38,31,7,25,23,34
8061,7491,7497,17,6,24,9,8,7,41,31,10,26,22,35
8062,7491,7497,19,15,24,7,3,14,41,56,-15,17,31,24
8063,7491,7497,8,16,24,6,5,13,30,50,-20,17,31,23
8064,7547,7553,4,8,32,12,8,12,48,43,5,32,32,44
8065,7547,7553,21,10,32,11,11,10,42,49,-7,33,31,44
8066,7547,7553,17,9,32,11,11,10,56,47,9,33,31,44
8067,7547,7553,19,16,32,9,5,18,50,72,-22,23,41,32
8068,7547,7553,8,17,32,8,7,17,35,59,-24,23,41,31
8069,7547,7553,43,1,32,24,5,3,76,23,53,53,11,77
8070,7547,7553,22,6,32,14,6,12,42,42,0,34,30,48
8071,7547,7553,57,13,32,10,7,15,47,63,-16,27,37,37
8072,7547,7553,49,3,32,17,6,9,62,43,19,40,24,57
8073,7547,7553,37,4,32,16,8,8,48,30,18,40,24,56
8074,7547,7553,20,11,32,10,10,12,37,43,-6,30,34,40
8075,7547,7553,56,12,32,10,8,14,39,53,-14,28,36,38
8076,7547,7553,41,14,32,9,9,14,46,44,2,27,37,36
8077,7547,7553,1,5,32,15,5,12,71,54,17,35,29,50
8078,7547,7553,12,2,32,18,6,8,68,35,33,42,22,60
8079,7547,7553,53,15,32,9,6,17,34,50,-16,24,40,33
8080,7547,7553,52,7,32,13,7,12,46,46,0,33,31,46
8081,7547,7553,48,18,32,5,9,18,27,78,-51,19,45,24
8082,7771,7798,52,9,17,7,2,8,23,25,-2,16,18,23
8083,7771,7798,3,12,17,5,5,7,22,27,-5,15,19,20
8084,7771,7798,1,17,17,3,4,10,20,29,-9,10,24,13
8085,7771,7798,56,2,17,10,2,5,26,21,5,22,12,32
8086,7771,7798,20,11,17,5,5,7,18,17,1,15,19,20
8087,7771,7798,41,14,17,5,4,8,21,24,-3,14,20,19
8088,7771,7798,49,4,17,9,5,3,25,15,10,23,11,32
8089,7771,7798,37,8,17,6,7,4,19,14,5,19,15,25
8090,7771,7798,43,1,17,11,3,3,31,18,13,25,9,36
8091,7771,7798,22,15,17,4,5,8,11,24,-13,13,21,17
8092,7771,7798,57,16,17,4,3,10,23,32,-9,11,23,15
8093,7771,7798,24,18,17,1,4,12,13,26,-13,6,28,7
8094,7771,7798,12,7,17,7,5,5,21,17,4,19,15,26
8095,7771,7798,17,6,17,9,4,4,24,20,4,22,12,31
8096,7771,7798,8,10,17,6,4,7,19,23,-4,16,18,22
8097,7771,7798,19,13,17,5,5,7,20,30,-10,15,19,20
8098,7771,7798,4,3,17,9,5,3,26,13,13,23,11,32
8099,7771,7798,21,5,17,9,4,4,26,13,13,22,12,31
8100,7820,7826,21,2,21,11,5,5,29,14,15,27,15,38
8101,7820,7826,4,4,21,10,8,3,28,14,14,28,14,38
8102,7820,7826,17,3,21,11,5,5,31,25,6,27,15,38
8103,7820,7826,19,11,21,6,6,9,24,37,-13,18,24,24
8104,7820,7826,8,12,21,6,5,10,20,30,-10,17,25,23
8105,7820,7826,12,8,21,9,6,6,34,24,10,24,18,33
8106,7820,7826,43,1,21,13,4,4,38,21,17,30,12,43
8107,7820,7826,22,14,21,5,6,10,14,28,-14,16,26,21
8108,7820,7826,57,15,21,5,5,11,32,41,-9,15,27,20
8109,7820,7826,24,18,21,3,4,14,18,32,-14,10,32,13
8110,7820,7826,49,5,21,10,8,3,31,20,11,28,14,38
8111,7820,7826,37,7,21,9,7,5,26,18,8,25,17,34
8112,7820,7826,41,16,21,5,5,11,21,30,-9,15,27,20
8113,7820,7826,56,6,21,11,4,6,29,25,4,26,16,37
8114,7820,7826,20,10,21,7,7,7,23,20,3,21,21,28
8115,7470,7483,43,1,22,18,2,2,43,12,31,38,6,56
8116,7470,7483,22,7,22,10,2,10,28,34,-6,22,22,32
8117,7470,7483,57,15,22,6,5,11,34,50,-16,17,27,23
8118,7470,7483,37,2,22,14,4,4,38,18,20,32,12,46
8119,7470,7483,49,3,22,12,5,5,42,27,15,29,15,41
8120,7470,7483,21,9,22,8,8,6,30,33,-3,24,20,32
8121,7470,7483,4,10,22,8,6,8,37,31,6,22,22,30
8122,7470,7483,12,4,22,12,4,6,45,23,22,28,16,40
8123,7470,7483,53,18,22,4,4,14,19,34,-15,12,32,16
8124,7470,7483,1,5,22,10,3,9,48,33,15,23,21,33
8125,7470,7483,17,8,22,8,8,6,38,28,10,24,20,32
8126,7470,7483,19,14,22,7,2,13,40,53,-13,16,28,23
8127,7470,7483,8,16,22,6,3,13,27,47,-20,15,29,21
8128,7344,7350,1,11,8,3,2,3,13,14,-1,8,8,11
8129,7344,7350,12,5,8,4,1,3,12,8,4,9,7,13
8130,7344,7350,53,15,8,2,1,5,11,15,-4,5,11,7
8131,7344,7350,52,4,8,5,2,1,12,6,6,12,4,17
8132,7344,7350,48,10,8,3,3,2,11,13,-2,9,7,12
8133,7344,7350,21,14,8,2,2,4,7,19,-12,6,10,8
8134,7344,7350,4,17,8,1,2,5,3,14,-11,4,12,5
8135,7344,7350,19,6,8,4,1,3,15,13,2,9,7,13
8136,7344,7350,17,9,8,3,3,2,15,10,5,9,7,12
8137,7344,7350,8,16,8,1,2,5,9,18,-9,4,12,5
8138,7344,7350,37,2,8,6,0,2,17,7,10,12,4,18
8139,7344,7350,49,3,8,5,2,1,23,11,12,12,4,17
8140,7344,7350,56,7,8,4,1,3,12,10,2,9,7,13
8141,7344,7350,20,12,8,3,1,4,11,11,0,7,9,10
8142,7344,7350,41,18,8,0,1,7,7,18,-11,1,15,1
8143,7344,7350,43,1,8,6,1,1,22,9,13,13,3,19
8144,7344,7350,22,8,8,4,0,4,13,12,1,8,8,12
8145,7344,7350,57,13,8,3,1,4,15,20,-5,7,9,10
8146,7750,7756,56,4,14,8,2,4,21,17,4,18,10,26
8147,7750,7756,41,10,14,4,4,6,16,16,0,12,16,16
8148,7750,7756,20,11,14,4,4,6,12,12,0,12,16,16
8149,7750,7756,52,9,14,6,1,7,20,22,-2,13,15,19
8150,7750,7756,3,12,14,4,4,6,17,21,-4,12,16,16
8151,7750,7756,43,1,14,9,3,2,27,14,13,21,7,30
8152,7750,7756,57,14,14,4,3,7,21,27,-6,11,17,15
8153,7750,7756,22,16,14,3,4,7,9,22,-13,10,18,13
8154,7750,7756,24,18,14,0,4,10,10,23,-13,4,24,4
8155,7750,7756,49,5,14,7,5,2,21,11,10,19,9,26
8156,7750,7756,37,8,14,5,6,3,14,10,4,16,12,21
8157,7750,7756,4,2,14,8,4,2,22,11,11,20,8,28
8158,7750,7756,21,6,14,7,4,3,21,11,10,18,10,25
8159,7750,7756,1,17,14,2,3,9,17,27,-10,7,21,9
8160,7750,7756,17,3,14,8,4,2,21,14,7,20,8,28
8161,7750,7756,8,13,14,4,4,6,13,19,-6,12,16,16
8162,7750,7756,19,15,14,3,5,6,16,25,-9,11,17,14
8163,7750,7756,12,7,14,7,2,5,18,14,4,16,12,23
8164,7841,7854,12,5,24,11,7,6,39,26,13,29,19,40
8165,7841,7854,1,17,24,5,7,12,32,39,-7,17,31,22
8166,7841,7854,17,7,24,11,5,8,31,34,-3,27,21,38
8167,7841,7854,19,11,24,8,7,9,32,39,-7,23,25,31
8168,7841,7854,8,16,24,6,6,12,22,36,-14,18,30,24
8169,7841,7854,4,3,24,11,9,4,30,16,14,31,17,42
8170,7841,7854,21,4,24,12,5,7,31,18,13,29,19,41
8171,7841,7854,49,2,24,12,9,3,37,21,16,33,15,45
8172,7841,7854,37,8,24,9,9,6,26,19,7,27,21,36
8173,7841,7854,43,1,24,14,6,4,41,22,19,34,14,48
8174,7841,7854,57,13,24,6,7,11,38,44,-6,19,29,25
8175,7841,7854,22,14,24,6,7,11,17,30,-13,19,29,25
8176,7841,7854,24,18,24,5,4,15,22,37,-15,14,34,19
8177,7841,7854,52,10,24,9,4,11,30,30,0,22,26,31
8178,7841,7854,3,15,24,6,7,11,26,42,-16,19,29,25
8179,7841,7854,56,6,24,11,6,7,29,26,3,28,20,39
8180,7841,7854,20,9,24,8,8,8,25,22,3,24,24,32
8181,7841,7854,41,12,24,7,5,12,28,35,-7,19,29,26
8182,8026,8032,43,1,3,2,1,0,6,2,4,5,1,7
8183,8026,8032,22,12,3,1,0,2,2,2,0,2,4,3
8184,8026,8032,57,17,3,0,1,2,3,6,-3,1,5,1
8185,8026,8032,52,6,3,2,0,1,5,4,1,4,2,6
8186,8026,8032,3,18,3,0,0,3,1,6,-5,0,6,0
8187,8026,8032,56,10,3,1,1,1,4,5,-1,3,3,4
8188,8026,8032,20,13,3,1,0,2,4,6,-2,2,4,3
8189,8026,8032,13,15,3,0,2,1,1,3,-2,2,4,2
8190,8026,8032,41,16,3,0,2,1,0,4,-4,2,4,2
8191,8026,8032,49,4,3,2,0,1,6,4,2,4,2,6
8192,8026,8032,37,8,3,1,2,0,3,1,2,4,2,5
8193,8026,8032,21,3,3,2,0,1,5,2,3,4,2,6
8194,8026,8032,1,5,3,2,0,1,4,2,2,4,2,6
8195,3452,3465,1,2,23,15,4,4,51,28,23,34,12,49
8196,3452,3465,27,10,23,9,3,11,30,33,-3,21,25,30
8197,3452,3465,39,13,23,5,8,10,20,33,-13,18,28,23
8198,3452,3465,4,3,23,14,4,5,41,21,20,32,14,46
8199,3452,3465,53,5,23,11,6,6,31,18,13,28,18,39
8200,3452,3465,52,8,23,8,8,7,28,31,-3,24,22,32
8201,3452,3465,28,11,23,7,5,11,31,42,-11,19,27,26
8202,3452,3465,49,1,23,16,5,2,52,20,32,37,9,53
8203,3452,3465,37,4,23,11,6,6,36,23,13,28,18,39
8204,3452,3465,5,14,23,4,6,13,20,47,-27,14,32,18
8205,3452,3465,20,9,23,8,7,8,29,37,-8,23,23,31
8206,3452,3465,41,12,23,6,5,12,27,37,-10,17,29,23
8207,3452,3465,17,7,23,8,8,7,29,28,1,24,22,32
8208,3452,3465,8,15,23,3,8,12,23,39,-16,14,32,17
8209,3452,3465,43,6,23,9,6,8,43,23,20,24,22,33
8210,3452,3465,26,16,23,3,5,15,17,48,-31,11,35,14
8211,3739,3745,52,6,12,4,4,4,17,16,1,12,12,16
8212,3739,3745,28,11,12,3,5,4,16,21,-5,11,13,14
8213,3739,3745,36,14,12,2,6,4,11,18,-7,10,14,12
8214,3739,3745,17,5,12,6,0,6,19,15,4,12,12,18
8215,3739,3745,43,1,12,9,1,2,26,11,15,19,5,28
8216,3739,3745,26,8,12,4,3,5,12,17,-5,11,13,15
8217,3739,3745,20,9,12,3,6,3,13,9,4,12,12,15
8218,3739,3745,41,13,12,3,3,6,7,17,-10,9,15,12
8219,3739,3745,21,4,12,6,2,4,16,13,3,14,10,20
8220,3739,3745,4,15,12,2,3,7,11,20,-9,7,17,9
8221,3739,3745,49,2,12,7,4,1,28,10,18,18,6,25
8222,3739,3745,37,10,12,3,5,4,8,11,-3,11,13,14
8223,3739,3745,53,7,12,4,4,4,14,16,-2,12,12,16
8224,3739,3745,1,3,12,7,3,2,26,14,12,17,7,24
8225,3739,3745,39,12,12,3,4,5,14,19,-5,10,14,13
8226,3739,3745,27,16,12,2,3,7,14,25,-11,7,17,9
8227,3844,3850,27,15,23,5,4,14,30,45,-15,14,32,19
8228,3844,3850,39,14,23,5,7,11,24,38,-14,17,29,22
8229,3844,3850,1,2,23,16,4,3,57,24,33,36,10,52
8230,3844,3850,21,7,23,8,6,9,24,36,-12,22,24,30
8231,3844,3850,53,5,23,8,7,8,23,26,-3,23,23,31
8232,3844,3850,28,6,23,8,6,9,28,32,-4,22,24,30
8233,3844,3850,52,8,23,7,9,7,23,26,-3,23,23,30
8234,3844,3850,36,13,23,5,8,10,22,31,-9,18,28,23
8235,3844,3850,49,1,23,17,5,1,55,14,41,39,7,56
8236,3844,3850,37,10,23,7,8,8,19,22,-3,22,24,29
8237,3844,3850,4,16,23,4,5,14,16,42,-26,13,33,17
8238,3844,3850,20,11,23,6,10,7,26,21,5,22,24,28
8239,3844,3850,41,12,23,5,9,9,15,28,-13,19,27,24
8240,3844,3850,17,3,23,14,0,9,37,24,13,28,18,42
8241,3844,3850,43,4,23,12,5,6,38,24,14,29,17,41
8242,3844,3850,26,9,23,8,5,10,25,29,-4,21,25,29
8243,3886,3892,52,5,28,11,9,8,34,27,7,31,25,42
8244,3886,3892,28,8,28,10,7,11,34,37,-3,27,29,37
8245,3886,3892,36,14,28,6,10,12,25,34,-9,22,34,28
8246,3886,3892,43,3,28,16,5,7,49,27,22,37,19,53
8247,3886,3892,26,12,28,8,6,14,25,37,-12,22,34,30
8248,3886,3892,20,10,28,7,11,10,31,30,1,25,31,32
8249,3886,3892,41,11,28,6,13,9,17,29,-12,25,31,31
8250,3886,3892,21,9,28,9,6,13,29,45,-16,24,32,33
8251,3886,3892,4,16,28,4,6,18,19,55,-36,14,42,18
8252,3886,3892,49,1,28,20,5,3,62,21,41,45,11,65
8253,3886,3892,37,7,28,11,8,9,33,30,3,30,26,41
8254,3886,3892,53,6,28,11,9,8,30,29,1,31,25,42
8255,3886,3892,17,4,28,16,1,11,41,28,13,33,23,49
8256,3886,3892,1,2,28,19,4,5,67,32,35,42,14,61
8257,3886,3892,39,13,28,7,7,14,29,44,-15,21,35,28
8258,3886,3892,27,15,28,6,7,15,32,52,-20,19,37,25
8259,3893,3899,39,11,29,8,7,14,32,45,-13,23,35,31
8260,3893,3899,27,15,29,7,7,15,34,52,-18,21,37,28
8261,3893,3899,1,2,29,20,4,5,69,32,37,44,14,64
8262,3893,3899,17,4,29,17,1,11,43,28,15,35,23,52
8263,3893,3899,53,6,29,11,9,9,31,32,-1,31,27,42
8264,3893,3899,49,1,29,21,5,3,66,22,44,47,11,68
8265,3893,3899,37,7,29,11,8,10,33,32,1,30,28,41
8266,3893,3899,21,10,29,9,6,14,30,48,-18,24,34,33
8267,3893,3899,4,16,29,4,6,19,19,57,-38,14,44,18
8268,3893,3899,20,9,29,8,11,10,33,30,3,27,31,35
8269,3893,3899,41,13,29,6,13,10,17,32,-15,25,33,31
8270,3893,3899,43,3,29,17,5,7,52,28,24,39,19,56
8271,3893,3899,26,14,29,8,6,15,26,41,-15,22,36,30
8272,3893,3899,52,5,29,11,9,9,34,29,5,31,27,42
8273,7687,7693,41,6,5,3,0,2,9,7,2,6,4,9
8274,7687,7693,56,8,5,2,2,1,4,4,0,6,4,8
8275,7687,7693,20,12,5,1,2,2,5,4,1,4,6,5
8276,7687,7693,57,14,5,1,1,3,9,12,-3,3,7,4
8277,7687,7693,22,15,5,1,1,3,5,11,-6,3,7,4
8278,7687,7693,24,17,5,0,2,3,5,9,-4,2,8,2
8279,7687,7693,21,10,5,2,1,2,3,3,0,5,5,7
8280,7687,7693,49,2,5,3,2,0,10,3,7,8,2,11
8281,7687,7693,37,7,5,2,2,1,6,3,3,6,4,8
8282,7687,7693,1,13,5,1,1,3,8,9,-1,3,7,4
8283,7687,7693,4,1,5,4,0,1,10,4,6,8,2,12
8284,7687,7693,8,16,5,1,1,3,4,10,-6,3,7,4
8285,7687,7693,19,18,5,0,2,3,6,13,-7,2,8,2
8286,7687,7693,43,3,5,3,1,1,10,5,5,7,3,10
8287,7687,7693,17,4,5,3,1,1,8,5,3,7,3,10
8288,7687,7693,12,5,5,3,1,1,6,4,2,7,3,10
8289,7687,7693,3,9,5,2,1,2,8,8,0,5,5,7
8290,7687,7693,52,11,5,2,1,2,5,7,-2,5,5,7
8291,8100,8106,49,1,12,7,2,3,29,13,16,16,8,23
8292,8100,8106,37,7,12,5,5,2,25,10,15,15,9,20
8293,8100,8106,19,2,12,6,4,2,17,12,5,16,8,22
8294,8100,8106,17,10,12,4,3,5,11,17,-6,11,13,15
8295,8100,8106,1,5,12,6,3,3,17,13,4,15,9,21
8296,8100,8106,21,6,12,6,3,3,15,12,3,15,9,21
8297,8100,8106,4,8,12,4,6,2,16,12,4,14,10,18
8298,8100,8106,43,3,12,6,3,3,24,14,10,15,9,21
8299,8100,8106,22,16,12,2,3,7,12,20,-8,7,17,9
8300,8100,8106,57,18,12,1,5,6,13,18,-5,7,17,8
8301,8100,8106,52,11,12,3,5,4,12,14,-2,11,13,14
8302,8100,8106,3,17,12,2,3,7,12,25,-13,7,17,9
8303,8100,8106,12,4,12,6,3,3,17,11,6,15,9,21
8304,8100,8106,53,9,12,4,3,5,19,22,-3,11,13,15
8305,8100,8106,56,12,12,3,5,4,10,15,-5,11,13,14
8306,8100,8106,41,13,12,3,4,5,9,22,-13,10,14,13
8307,8100,8106,13,14,12,2,7,3,11,14,-3,11,13,13
8308,8100,8106,20,15,12,3,3,6,11,16,-5,9,15,12
8309,8254,8260,56,10,28,8,9,11,33,39,-6,25,31,33
8310,8254,8260,41,12,28,7,10,11,26,44,-18,24,32,31
8311,8254,8260,20,15,28,6,7,15,30,44,-14,19,37,25
8312,8254,8260,13,16,28,4,11,13,30,58,-28,19,37,23
8313,8254,8260,43,1,28,17,7,4,64,29,35,41,15,58
8314,8254,8260,57,14,28,6,10,12,32,46,-14,22,34,28
8315,8254,8260,22,17,28,4,9,15,29,49,-20,17,39,21
8316,8254,8260,49,2,28,17,6,5,66,31,35,40,16,57
8317,8254,8260,37,5,28,13,9,6,59,30,29,35,21,48
8318,8254,8260,21,3,28,17,5,6,44,26,18,39,17,56
8319,8254,8260,4,7,28,12,10,6,43,35,8,34,22,46
8320,8254,8260,1,4,28,14,8,6,47,35,12,36,20,50
8321,8254,8260,19,6,28,13,8,7,42,36,6,34,22,47
8322,8254,8260,17,13,28,8,6,14,27,43,-16,22,34,30
8323,8254,8260,52,9,28,9,11,8,29,26,3,29,27,38
8324,8254,8260,3,18,28,4,6,18,27,56,-29,14,42,18
8325,8254,8260,12,8,28,12,7,9,37,27,10,31,25,43
8326,8254,8260,53,11,28,8,7,13,37,48,-11,23,33,31
8327,8282,8288,12,8,31,12,8,11,38,32,6,32,30,44
8328,8282,8288,53,13,31,8,9,14,41,54,-13,25,37,33
8329,8282,8288,52,9,31,9,13,9,30,29,1,31,31,40
8330,8282,8288,3,18,31,4,7,20,29,60,-31,15,47,19
8331,8282,8288,19,7,31,14,8,9,47,44,3,36,26,50
8332,8282,8288,17,12,31,9,7,15,30,46,-16,25,37,34
8333,8282,8288,1,5,31,15,8,8,50,46,4,38,24,53
8334,8282,8288,21,3,31,19,5,7,53,29,24,43,19,62
8335,8282,8288,4,4,31,15,10,6,51,39,12,40,22,55
8336,8282,8288,57,14,31,7,12,12,37,48,-11,26,36,33
8337,8282,8288,22,17,31,4,10,17,30,54,-24,18,44,22
8338,8282,8288,49,1,31,20,6,5,72,31,41,46,16,66
8339,8282,8288,37,6,31,14,10,7,64,33,31,38,24,52
8340,8282,8288,43,2,31,19,8,4,71,31,40,46,16,65
8341,8282,8288,41,10,31,9,10,12,32,49,-17,28,34,37
8342,8282,8288,56,11,31,9,9,13,38,48,-10,27,35,36
8343,8282,8288,13,15,31,6,11,14,37,62,-25,23,39,29
8344,8282,8288,20,16,31,6,9,16,32,47,-15,21,41,27
8345,8562,8568,57,8,22,9,4,9,25,22,3,22,22,31
8346,8562,8568,24,9,22,7,10,5,26,26,0,24,20,31
8347,8562,8568,37,1,22,16,5,1,45,23,22,37,7,53
8348,8562,8568,49,4,22,11,5,6,34,23,11,27,17,38
8349,8562,8568,41,11,22,7,5,10,23,30,-7,19,25,26
8350,8562,8568,56,13,22,6,7,9,23,29,-6,19,25,25
8351,8562,8568,13,2,22,13,4,5,44,24,20,30,14,43
8352,5636,5642,40,14,23,4,10,9,22,35,-13,18,28,22
8353,5636,5642,24,16,23,4,8,11,26,39,-13,16,30,20
8354,5636,5642,43,2,22,13,4,5,45,25,20,30,14,43
8355,5636,5642,57,12,23,6,9,8,32,38,-6,21,25,27
8356,5475,5481,57,11,4,0,3,1,5,6,-1,3,5,3
8357,5475,5481,40,12,4,0,3,1,2,3,-1,3,5,3
8358,5475,5481,43,15,4,0,2,2,3,6,-3,2,6,2
8359,5475,5481,24,16,3,0,2,1,0,3,-3,2,4,2
8360,5475,5481,17,4,4,3,0,1,8,2,6,6,2,9
8361,5475,5481,8,18,4,0,1,3,1,11,-10,1,7,1
8362,5475,5481,12,1,4,4,0,0,12,3,9,8,0,12
8363,5475,5481,53,6,4,2,1,1,6,4,2,5,3,7
8364,5475,5481,20,5,3,2,1,0,7,0,7,5,1,7
8365,5475,5481,41,14,4,1,1,2,4,7,-3,3,5,4
8366,5475,5481,37,7,4,1,3,0,1,0,1,5,3,6
8367,5475,5481,5,9,4,1,2,1,4,4,0,4,4,5
8368,5475,5481,49,13,4,1,1,2,2,4,-2,3,5,4
8369,5475,5481,1,10,3,1,1,1,5,4,1,3,3,4
8370,5475,5481,21,2,4,3,1,0,6,1,5,7,1,10
8371,5475,5481,52,3,4,3,0,1,9,3,6,6,2,9
8372,5475,5481,48,8,3,1,2,0,4,2,2,4,2,5
8373,5475,5481,54,18,4,0,1,3,1,11,-10,1,7,1
8374,5475,5481,27,17,4,0,1,3,0,6,-6,1,7,1
8375,5979,5985,27,14,18,4,5,9,14,25,-11,13,23,17
8376,5979,5985,52,2,18,10,5,3,27,15,12,25,11,35
8377,5979,5985,21,6,18,8,5,5,26,24,2,21,15,29
8378,5979,5985,1,1,18,12,4,2,39,16,23,28,8,40
8379,5979,5985,49,9,18,7,7,4,18,13,5,21,15,28
8380,5979,5985,37,15,18,3,8,7,15,24,-9,14,22,17
8381,5979,5985,5,18,18,2,4,12,21,38,-17,8,28,10
8382,5979,5985,43,3,18,9,5,4,39,24,15,23,13,32
8383,5979,5985,56,8,18,8,4,6,24,23,1,20,16,28
8384,5979,5985,20,12,18,6,3,9,25,29,-4,15,21,21
8385,5979,5985,41,17,18,3,4,11,12,43,-31,10,26,13
8386,5979,5985,53,4,18,9,5,4,37,26,11,23,13,32
8387,5979,5985,12,10,18,6,6,6,22,19,3,18,18,24
8388,5979,5985,17,7,18,8,4,6,23,21,2,20,16,28
8389,5979,5985,8,13,18,6,3,9,24,28,-4,15,21,21
8390,5979,5985,57,5,18,8,5,5,36,24,12,21,15,29
8391,5979,5985,22,11,18,6,5,7,21,19,2,17,19,23
8392,5979,5985,24,16,18,3,6,9,16,28,-12,12,24,15
8393,6000,6006,43,2,21,11,6,4,49,27,22,28,14,39
8394,6000,6006,57,6,21,8,7,6,40,30,10,23,19,31
8395,6000,6006,22,12,21,7,6,8,26,25,1,20,22,27
8396,6000,6006,24,16,21,4,7,10,21,32,-11,15,27,19
8397,6000,6006,17,10,21,8,5,8,25,25,0,21,21,29
8398,6000,6006,8,13,21,6,5,10,27,33,-6,17,25,23
8399,6000,6006,53,4,21,9,8,4,42,31,11,26,16,35
8400,6000,6006,12,5,21,9,6,6,27,20,7,24,18,33
8401,6000,6006,56,8,21,8,7,6,28,27,1,23,19,31
8402,6000,6006,20,11,21,8,4,9,31,30,1,20,22,28
8403,6000,6006,41,18,21,3,4,14,12,53,-41,10,32,13
8404,6000,6006,49,7,21,8,7,6,22,19,3,23,19,31
8405,6000,6006,37,14,21,5,8,8,19,26,-7,18,24,23
8406,6000,6006,5,17,21,3,5,13,24,42,-18,11,31,14
8407,6000,6006,21,9,21,8,7,6,29,29,0,23,19,31
8408,6000,6006,52,3,21,11,6,4,32,21,11,28,14,39
8409,6000,6006,27,15,21,5,6,10,17,27,-10,16,26,21
8410,6000,6006,1,1,21,14,4,3,46,20,26,32,10,46
8411,6077,6083,27,15,30,8,8,14,25,38,-13,24,36,32
8412,6077,6083,1,1,30,20,5,5,58,26,32,45,15,65
8413,6077,6083,52,3,30,16,8,6,51,32,19,40,20,56
8414,6077,6083,49,4,30,15,8,7,41,24,17,38,22,53
8415,6077,6083,37,11,30,10,9,11,30,37,-7,29,31,39
8416,6077,6083,5,17,30,6,6,18,37,61,-24,18,42,24
8417,6077,6083,21,10,30,11,9,10,35,41,-6,31,29,42
8418,6077,6083,20,7,30,13,6,11,44,36,8,32,28,45
8419,6077,6083,56,12,30,9,9,12,37,43,-6,27,33,36
8420,6077,6083,41,18,30,6,5,19,26,71,-45,17,43,23
8421,6077,6083,12,5,30,14,6,10,46,32,14,34,26,48
8422,6077,6083,53,8,30,11,10,9,54,44,10,32,28,43
8423,6077,6083,17,6,30,14,5,11,40,35,5,33,27,47
8424,6077,6083,8,14,30,8,8,14,37,49,-12,24,36,32
8425,6077,6083,43,2,30,17,6,7,61,33,28,40,20,57
8426,6077,6083,57,9,30,11,9,10,51,46,5,31,29,42
8427,6077,6083,22,13,30,9,8,13,36,40,-4,26,34,35
8428,6077,6083,24,16,30,6,7,17,33,54,-21,19,41,25
8429,6098,6104,43,2,33,20,6,7,72,36,36,46,20,66
8430,6098,6104,57,8,33,12,10,11,56,51,5,34,32,46
8431,5356,5362,53,5,37,18,10,9,56,34,22,46,28,64
8432,5356,5362,12,8,37,14,12,11,50,48,2,40,34,54
8433,5356,5362,52,1,37,24,11,2,91,39,52,59,15,83
8434,5356,5362,48,15,37,8,15,14,33,46,-13,31,43,39
8435,5125,5131,53,7,6,3,0,3,6,6,0,6,6,9
8436,5125,5131,12,15,6,2,1,3,9,17,-8,5,7,7
8437,5125,5131,41,13,6,2,2,2,6,6,0,6,6,8
8438,5125,5131,20,18,6,0,5,1,5,6,-1,5,7,5
8439,5125,5131,24,4,6,3,1,2,7,5,2,7,5,10
8440,5125,5131,43,5,6,2,4,0,11,3,8,8,4,10
8441,5125,5131,57,11,6,2,3,1,6,6,0,7,5,9
8442,5125,5131,22,20,6,0,1,5,4,12,-8,1,11,1
8443,5125,5131,5,2,6,3,1,2,8,5,3,7,5,10
8444,5125,5131,49,12,6,2,2,2,11,11,0,6,6,8
8445,5125,5131,37,16,6,1,4,1,5,4,1,6,6,7
8446,5125,5131,21,3,6,3,1,2,9,7,2,7,5,10
8447,5125,5131,18,9,6,2,3,1,6,5,1,7,5,9
8448,5125,5131,1,10,6,2,3,1,8,8,0,7,5,9
8449,5125,5131,17,1,6,4,1,1,12,4,8,9,3,13
8450,5125,5131,8,17,6,2,0,4,7,11,-4,4,8,6
8451,5125,5131,52,6,6,2,4,0,9,5,4,8,4,10
8452,5125,5131,48,8,6,2,3,1,7,4,3,7,5,9
8453,5125,5131,36,19,6,0,2,4,3,11,-8,2,10,2
8454,5125,5131,27,14,6,2,1,3,7,10,-3,5,7,7
8455,5132,5138,27,10,7,3,1,3,8,10,-2,7,7,10
8456,5132,5138,52,3,7,3,4,0,13,6,7,10,4,13
8457,5132,5138,48,12,7,2,4,1,7,4,3,8,6,10
8458,5132,5138,36,19,7,0,3,4,4,12,-8,3,11,3
8459,5132,5138,17,1,7,4,1,2,12,6,6,9,5,13
8460,5132,5138,8,16,7,2,1,4,8,12,-4,5,9,7
8461,5132,5138,1,4,7,3,3,1,10,9,1,9,5,12
8462,5132,5138,18,15,7,2,3,2,6,8,-2,7,7,9
8463,5132,5138,21,8,7,3,1,3,9,8,1,7,7,10
8464,5132,5138,5,6,7,3,2,2,10,7,3,8,6,11
8465,5132,5138,49,13,7,2,3,2,12,12,0,7,7,9
8466,5132,5138,37,17,7,1,4,2,5,5,0,6,8,7
8467,5132,5138,43,2,7,3,4,0,13,3,10,10,4,13
8468,5132,5138,57,5,7,3,3,1,7,6,1,9,5,12
8469,5132,5138,24,7,7,3,2,2,7,5,2,8,6,11
8470,5132,5138,22,20,7,0,1,6,5,16,-11,1,13,1
8471,5132,5138,41,14,7,2,3,2,8,8,0,7,7,9
8472,5132,5138,20,18,7,0,5,2,6,8,-2,5,9,5
8473,5132,5138,53,9,7,3,1,3,7,7,0,7,7,10
8474,5132,5138,12,11,7,3,1,3,12,17,-5,7,7,10
8475,5461,5463,12,5,1,1,0,0,2,1,1,2,0,3
8476,5461,5463,53,9,1,0,1,0,1,1,0,1,1,1
8477,5461,5463,24,11,0,0,0,0,0,0,0,0,0,0
8478,5461,5463,57,12,1,0,0,1,1,2,-1,0,2,0
8479,5461,5463,40,14,1,0,0,1,0,1,-1,0,2,0
8480,5461,5463,43,16,1,0,0,1,0,2,-2,0,2,0
8481,5461,5463,49,14,1,0,0,1,0,1,-1,0,2,0
8482,5461,5463,5,5,1,1,0,0,2,1,1,2,0,3
8483,5461,5463,37,7,1,1,0,0,1,0,1,2,0,3
8484,5461,5463,17,2,1,1,0,0,3,0,3,2,0,3
8485,5461,5463,8,19,1,0,0,1,0,4,-4,0,2,0
8486,5461,5463,21,7,1,1,0,0,1,0,1,2,0,3
8487,5461,5463,54,16,1,0,0,1,0,2,-2,0,2,0
8488,5461,5463,20,3,1,1,0,0,2,0,2,2,0,3
8489,5461,5463,41,12,1,0,0,1,1,2,-1,0,2,0
8490,5461,5463,27,18,1,0,0,1,0,3,-3,0,2,0
8491,5461,5463,52,1,1,1,0,0,4,0,4,2,0,3
8492,5461,5463,48,3,1,1,0,0,2,0,2,2,0,3
8493,5461,5463,1,9,1,0,1,0,1,1,0,1,1,1
8494,5531,5544,1,2,11,6,3,2,21,11,10,15,7,21
8495,5531,5544,52,2,11,6,3,2,21,11,10,15,7,21
8496,5531,5544,27,18,12,2,3,7,12,18,-6,7,17,9
8497,5531,5544,37,6,12,5,4,3,13,6,7,14,10,19
8498,5531,5544,49,10,12,4,5,3,12,10,2,13,11,17
8499,5531,5544,5,13,11,1,7,3,11,13,-2,9,13,10
8500,5531,5544,54,14,11,4,1,6,8,20,-12,9,13,13
8501,5531,5544,48,16,11,1,6,4,7,14,-7,8,14,9
8502,5531,5544,17,5,12,6,2,4,23,15,8,14,10,20
8503,5531,5544,21,8,12,5,4,3,15,16,-1,14,10,19
8504,5531,5544,8,19,11,2,2,7,8,25,-17,6,16,8
8505,5531,5544,40,15,12,1,6,5,11,18,-7,8,16,9
8506,5531,5544,24,17,11,1,5,5,12,17,-5,7,15,8
8507,5531,5544,20,4,11,5,5,1,17,9,8,15,7,20
8508,5531,5544,41,11,11,4,2,5,18,22,-4,10,12,14
8509,5531,5544,43,7,11,5,4,2,18,12,6,14,8,19
8510,5531,5544,57,12,11,2,5,4,13,13,0,9,13,11
8511,5531,5544,12,1,12,7,2,3,22,14,8,16,8,23
8512,5531,5544,53,9,11,5,3,3,18,16,2,13,9,18
8513,3158,3164,20,10,28,10,5,13,44,48,-4,25,31,35
8514,3158,3164,49,1,28,18,7,3,59,16,43,43,13,61
8515,3158,3164,37,6,28,11,8,9,41,41,0,30,26,41
8516,3158,3164,43,5,28,12,10,6,58,32,26,34,22,46
8517,3158,3164,24,16,28,4,8,16,27,54,-27,16,40,20
8518,3382,3388,43,7,14,5,5,4,27,14,13,15,13,20
8519,3382,3388,26,13,14,3,4,7,15,26,-11,10,18,13
8520,3382,3388,20,10,14,4,5,5,15,27,-12,13,15,17
8521,3382,3388,41,16,14,3,2,9,18,25,-7,8,20,11
8522,3382,3388,17,5,14,6,6,2,21,11,10,18,10,24
8523,3382,3388,8,15,14,2,6,6,12,20,-8,10,18,12
8524,3382,3388,49,1,14,9,3,2,27,11,16,21,7,30
8525,3382,3388,37,6,14,6,5,3,19,12,7,17,11,23
8526,3382,3388,5,14,14,3,4,7,11,24,-13,10,18,13
8527,3382,3388,53,4,14,7,3,4,18,7,11,17,11,24
8528,3382,3388,52,11,14,4,4,6,16,23,-7,12,16,16
8529,3382,3388,28,12,14,3,4,7,17,27,-10,10,18,13
8530,3382,3388,4,2,14,9,2,3,26,14,12,20,8,29
8531,3382,3388,1,3,14,8,2,4,27,19,8,18,10,26
8532,3382,3388,27,8,14,5,2,7,16,20,-4,12,16,17
8533,3382,3388,39,9,14,4,5,5,12,17,-5,13,15,17
8534,3417,3423,27,4,18,9,2,7,27,21,6,20,16,29
8535,3417,3423,39,12,18,4,7,7,16,25,-9,15,21,19
8536,3417,3423,1,2,18,12,2,4,39,23,16,26,10,38
8537,3417,3423,4,3,18,11,3,4,34,18,16,25,11,36
8538,3417,3423,52,9,18,6,5,7,24,30,-6,17,19,23
8539,3417,3423,28,10,18,6,4,8,27,31,-4,16,20,22
8540,3417,3423,53,5,18,8,5,5,22,13,9,21,15,29
8541,3417,3423,49,1,18,12,4,2,38,13,25,28,8,40
8542,3417,3423,37,6,18,8,5,5,23,19,4,21,15,29
8543,3417,3423,5,13,18,4,5,9,18,36,-18,13,23,17
8544,3417,3423,17,7,18,7,6,5,24,18,6,20,16,27
8545,3417,3423,8,16,18,2,6,10,17,31,-14,10,26,12
8546,3417,3423,20,11,18,5,6,7,19,34,-15,16,20,21
8547,3417,3423,41,15,18,3,4,11,20,32,-12,10,26,13
8548,3417,3423,43,8,18,7,5,6,36,18,18,19,17,26
8549,3417,3423,26,14,18,3,5,10,16,38,-22,11,25,14
8550,3746,3752,52,8,13,4,5,4,18,17,1,13,13,17
8551,3746,3752,28,10,13,4,5,4,18,21,-3,13,13,17
8552,3746,3752,36,14,13,2,7,4,12,19,-7,11,15,13
8553,3746,3752,20,7,13,4,6,3,14,9,5,14,12,18
8554,3746,3752,41,13,13,3,4,6,8,18,-10,10,16,13
8555,3746,3752,21,4,13,6,2,5,16,15,1,14,12,20
8556,3746,3752,4,16,13,2,3,8,11,23,-12,7,19,9
8557,3746,3752,43,1,13,9,1,3,26,12,14,19,7,28
8558,3746,3752,26,11,13,4,3,6,12,19,-7,11,15,15
8559,3746,3752,49,2,13,8,4,1,31,10,21,20,6,28
8560,3746,3752,37,9,13,4,5,4,10,11,-1,13,13,17
8561,3746,3752,53,5,13,5,4,4,17,16,1,14,12,19
8562,3746,3752,17,6,13,6,0,7,19,18,1,12,14,18
8563,3746,3752,1,3,13,8,3,2,28,15,13,19,7,27
8564,3746,3752,39,12,13,3,4,6,15,21,-6,10,16,13
8565,3746,3752,27,15,13,2,4,7,15,26,-11,8,18,10
8566,3753,3759,39,13,14,3,4,7,15,22,-7,10,18,13
8567,3753,3759,27,15,14,2,4,8,15,27,-12,8,20,10
8568,3753,3759,1,3,14,9,3,2,31,16,15,21,7,30
8569,3753,3759,17,5,14,7,0,7,21,18,3,14,14,21
8570,3753,3759,53,4,14,6,4,4,18,16,2,16,12,22
8571,3753,3759,49,2,14,9,4,1,32,10,22,22,6,31
8572,3753,3759,37,10,14,4,5,5,11,14,-3,13,15,17
8573,3753,3759,43,1,14,10,1,3,28,13,15,21,7,31
8574,3753,3759,26,12,14,4,3,7,12,20,-8,11,17,15
8575,3753,3759,21,7,14,6,2,6,17,17,0,14,14,20
8576,3753,3759,4,16,14,2,3,9,11,26,-15,7,21,9
8577,3753,3759,20,6,14,5,6,3,17,9,8,16,12,21
8578,3753,3759,41,11,14,4,4,6,9,18,-9,12,16,16
8579,3753,3759,28,8,14,5,5,4,19,21,-2,15,13,20
8580,3753,3759,52,9,14,4,5,5,18,19,-1,13,15,17
8581,3753,3759,36,14,14,2,7,5,12,20,-8,11,17,13
8582,3858,3864,28,5,25,9,6,10,32,36,-4,24,26,33
8583,3858,3864,52,7,25,8,9,8,25,27,-2,25,25,33
8584,3858,3864,21,6,25,9,6,10,26,38,-12,24,26,33
8585,3858,3864,20,11,25,6,11,8,28,25,3,23,27,29
8586,3858,3864,41,12,25,5,11,9,15,28,-13,21,29,26
8587,3858,3864,43,3,25,14,5,6,43,24,19,33,17,47
8588,3858,3864,26,10,25,8,6,11,25,31,-6,22,28,30
8589,3858,3864,17,4,25,14,0,11,38,27,11,28,22,42
8590,3858,3864,49,1,25,19,5,1,57,14,43,43,7,62
8591,5734,5852,5,13,36,10,11,15,42,61,-19,31,41,41
8592,5734,5852,57,12,36,9,13,14,41,52,-11,31,41,40
8593,5734,5852,12,4,36,19,7,10,58,33,25,45,27,64
8594,5734,5852,53,7,36,16,9,11,59,54,5,41,31,57
8595,5734,5852,48,18,36,5,11,20,22,57,-35,21,51,26
8596,5734,5852,54,19,36,6,8,22,27,65,-38,20,52,26
8597,5734,5852,17,8,36,14,11,11,59,44,15,39,33,53
8598,5734,5852,8,17,36,7,13,16,27,50,-23,27,45,34
8599,5734,5852,21,11,36,10,14,12,40,55,-15,34,38,44
8600,5496,5509,8,18,6,1,1,4,4,16,-12,3,9,4
8601,5496,5509,52,5,6,4,1,1,13,5,8,9,3,13
8602,5496,5509,48,14,6,1,3,2,6,9,-3,5,7,6
8603,5496,5509,54,17,6,1,1,4,4,13,-9,3,9,4
8604,5496,5509,12,1,7,6,0,1,19,8,11,12,2,18
8605,5496,5509,53,11,7,3,1,3,11,12,-1,7,7,10
8606,5496,5509,5,10,7,1,5,1,8,8,0,7,7,8
8607,5496,5509,49,12,7,3,1,3,5,6,-1,7,7,10
8608,5496,5509,37,3,7,3,4,0,9,2,7,10,4,13
8609,5496,5509,43,9,7,2,3,2,10,9,1,7,7,9
8610,5496,5509,57,13,7,1,3,3,9,10,-1,5,9,6
8611,5496,5509,40,15,7,0,4,3,4,9,-5,4,10,4
8612,5496,5509,24,16,6,0,3,3,2,8,-6,3,9,3
8613,5496,5509,17,4,7,4,1,2,14,5,9,9,5,13
8614,5496,5509,41,7,7,3,2,2,13,12,1,8,6,11
8615,5496,5509,20,2,6,4,2,0,13,3,10,10,2,14
8616,5496,5509,21,6,7,4,1,2,11,12,-1,9,5,13
8617,5496,5509,27,19,7,0,1,6,2,13,-11,1,13,1
8618,5496,5509,1,8,6,2,3,1,10,7,3,7,5,9
8619,5930,5936,1,1,12,8,3,1,25,9,16,19,5,27
8620,5930,5936,27,13,12,3,3,6,9,16,-7,9,15,12
8621,5930,5936,21,5,12,6,3,3,15,14,1,15,9,21
8622,5930,5936,56,3,12,6,3,3,17,15,2,15,9,21
8623,5930,5936,20,15,12,3,1,8,14,22,-8,7,17,10
8624,5930,5936,41,16,12,2,3,7,11,23,-12,7,17,9
8625,5930,5936,22,12,12,4,2,6,14,14,0,10,14,14
8626,5930,5936,24,18,12,1,4,7,10,23,-13,6,18,7
8627,5930,5936,8,11,12,4,2,6,18,17,1,10,14,14
8628,5930,5936,37,14,12,2,6,4,10,17,-7,10,14,12
8629,5930,5936,5,17,12,2,2,8,17,28,-11,6,18,8
8630,5930,5936,43,7,12,5,5,2,27,15,12,15,9,20
8631,5930,5936,57,9,12,5,4,3,18,19,-1,14,10,19
8632,5930,5936,49,8,12,5,5,2,14,9,5,15,9,20
8633,5930,5936,53,6,12,6,2,4,27,20,7,14,10,20
8634,5930,5936,12,10,12,4,4,4,14,12,2,12,12,16
8635,5930,5936,52,2,12,7,3,2,20,9,11,17,7,24
8636,5930,5936,17,3,12,6,3,3,17,15,2,15,9,21
8637,6007,6013,21,7,22,9,7,6,30,29,1,25,19,34
8638,6007,6013,53,5,22,9,8,5,43,33,10,26,18,35
8639,6007,6013,12,4,22,10,6,6,31,21,10,26,18,36
8640,6007,6013,49,6,22,9,7,6,24,19,5,25,19,34
8641,6007,6013,37,14,22,6,8,8,21,27,-6,20,24,26
8642,6007,6013,5,17,22,4,5,13,26,43,-17,13,31,17
8643,6007,6013,43,3,22,11,6,5,49,28,21,28,16,39
8644,6007,6013,57,8,22,8,7,7,41,34,7,23,21,31
8645,6007,6013,22,12,22,7,6,9,26,27,-1,20,24,27
8646,6007,6013,24,15,22,5,7,10,24,32,-8,17,27,22
8647,6007,6013,17,10,22,8,5,9,27,28,-1,21,23,29
8648,6007,6013,8,13,22,7,5,10,30,34,-4,19,25,26
8649,6007,6013,56,9,22,8,7,7,29,30,-1,23,21,31
8650,6007,6013,20,11,22,8,4,10,32,32,0,20,24,28
8651,6007,6013,41,18,22,4,4,14,14,54,-40,12,32,16
8652,6007,6013,52,2,22,12,6,4,35,23,12,30,14,42
8653,6007,6013,27,16,22,5,6,11,17,30,-13,16,28,21
8654,6007,6013,1,1,22,14,4,4,47,22,25,32,12,46
8655,6084,6090,27,15,31,8,8,15,25,40,-15,24,38,32
8656,6084,6090,12,5,31,14,6,11,47,36,11,34,28,48
8657,6084,6090,53,8,31,11,11,9,55,45,10,33,29,44
8658,6084,6090,52,3,31,17,8,6,56,33,23,42,20,59
8659,6084,6090,1,1,31,21,5,5,62,27,35,47,15,68
8660,6084,6090,20,6,31,14,6,11,46,36,10,34,28,48
8661,6084,6090,56,13,31,9,10,12,37,43,-6,28,34,37
8662,6084,6090,41,16,31,7,5,19,29,73,-44,19,43,26
8663,6084,6090,43,2,31,18,6,7,64,35,29,42,20,60
8664,6084,6090,57,9,31,11,10,10,52,47,5,32,30,43
8665,6084,6090,22,12,31,10,8,13,37,40,-3,28,34,38
8666,6084,6090,24,18,31,6,7,18,34,59,-25,19,43,25
8667,6084,6090,49,4,31,15,9,7,42,25,17,39,23,54
8668,6084,6090,37,11,31,10,9,12,30,38,-8,29,33,39
8669,6084,6090,5,17,31,6,7,18,37,61,-24,19,43,25
8670,8026,8032,19,9,3,1,1,1,4,2,2,3,3,4
8671,8026,8032,17,11,3,1,1,1,2,3,-1,3,3,4
8672,8026,8032,53,2,3,2,1,0,4,2,2,5,1,7
8673,8026,8032,12,7,3,2,0,1,3,2,1,4,2,6
8674,8026,8032,4,14,3,0,2,1,4,5,-1,2,4,2
8675,8297,8302,12,8,33,13,8,12,40,36,4,34,32,47
8676,8297,8302,53,14,33,8,9,16,41,58,-17,25,41,33
8677,8297,8302,21,3,33,20,5,8,56,30,26,45,21,65
8678,8297,8302,4,4,33,17,10,6,57,41,16,44,22,61
8679,8297,8302,49,1,33,22,6,5,77,31,46,50,16,72
8680,8297,8302,37,6,33,15,10,8,67,36,31,40,26,55
8681,8297,8302,19,7,33,14,8,11,48,49,-1,36,30,50
8682,8297,8302,17,11,33,10,7,16,33,48,-15,27,39,37
8683,8297,8302,1,5,33,16,9,8,53,48,5,41,25,57
8684,8297,8302,43,2,33,20,8,5,74,33,41,48,18,68
8685,8297,8302,57,13,33,7,14,12,38,49,-11,28,38,35
8686,8297,8302,22,18,33,4,10,19,33,60,-27,18,48,22
8687,8297,8302,41,9,33,11,10,12,37,51,-14,32,34,43
8688,8297,8302,56,12,33,9,9,15,39,54,-15,27,39,36
8689,8297,8302,13,15,33,7,12,14,38,62,-24,26,40,33
8690,8297,8302,20,16,33,7,9,17,34,49,-15,23,43,30
8691,8297,8302,52,10,33,9,13,11,31,33,-2,31,35,40
8692,8297,8302,3,17,33,6,7,20,35,63,-28,19,47,25
8693,8037,8043,52,9,5,2,1,2,7,7,0,5,5,7
8694,8037,8043,3,17,5,0,2,3,4,9,-5,2,8,2
8695,8037,8043,56,7,5,2,2,1,8,8,0,6,4,8
8696,8037,8043,20,11,5,2,0,3,7,8,-1,4,6,6
8697,8037,8043,13,15,5,0,3,2,3,7,-4,3,7,3
8698,8037,8043,22,14,5,1,0,4,3,6,-3,2,8,3
8699,8037,8043,57,18,5,0,1,4,6,11,-5,1,9,1
8700,8037,8043,41,16,5,0,3,2,1,11,-10,3,7,3
8701,8037,8043,43,5,5,3,1,1,9,5,4,7,3,10
8702,8037,8043,37,2,5,3,2,0,11,2,9,8,2,11
8703,8037,8043,49,4,5,3,1,1,15,6,9,7,3,10
8704,8037,8043,21,8,5,2,1,2,7,6,1,5,5,7
8705,8037,8043,4,13,5,0,4,1,5,6,-1,4,6,4
8706,8037,8043,53,3,5,3,2,0,9,6,3,8,2,11
8707,8037,8043,12,6,5,3,1,1,7,5,2,7,3,10
8708,8037,8043,17,10,5,2,1,2,4,10,-6,5,5,7
8709,8037,8043,19,12,5,1,3,1,5,3,2,5,5,6
8710,8037,8043,1,1,5,4,0,1,9,4,5,8,2,12
8711,8058,8071,1,3,8,5,1,2,11,7,4,11,5,16
8712,8058,8071,17,8,8,4,1,3,10,14,-4,9,7,13
8713,8058,8071,19,9,8,3,3,2,10,9,1,9,7,12
8714,8058,8071,12,2,8,5,1,2,12,8,4,11,5,16
8715,8058,8071,53,6,8,4,2,2,14,13,1,10,6,14
8716,8058,8071,21,5,8,4,2,2,12,8,4,10,6,14
8717,8058,8071,4,10,8,2,4,2,9,9,0,8,8,10
8718,8058,8071,49,1,8,5,1,2,22,9,13,11,5,16
8719,8058,8071,37,4,8,4,3,1,16,4,12,11,5,15
8720,8058,8071,20,11,8,3,0,5,9,13,-4,6,10,9
8721,8058,8071,56,12,8,2,3,3,9,11,-2,7,9,9
8722,8058,8071,13,15,8,1,5,2,8,10,-2,7,9,8
8723,8058,8071,41,16,8,1,4,3,3,13,-10,6,10,7
8724,8058,8071,43,7,8,4,1,3,13,11,2,9,7,13
8725,8058,8071,22,17,8,1,2,5,7,11,-4,4,12,5
8726,8058,8071,57,18,8,0,2,6,7,15,-8,2,14,2
8727,8058,8071,52,13,8,2,3,3,8,12,-4,7,9,9
8728,8058,8071,3,14,8,2,2,4,11,14,-3,6,10,8
8729,8443,8449,13,2,10,6,2,2,18,9,9,14,6,20
8730,8443,8449,20,8,10,4,2,4,10,8,2,10,10,14
8731,8443,8449,56,15,10,2,3,5,9,14,-5,7,13,9
8732,8443,8449,41,16,10,2,2,6,9,19,-10,6,14,8
8733,8443,8449,57,3,10,6,1,3,11,7,4,13,7,19
8734,8443,8449,43,4,10,5,3,2,23,11,12,13,7,18
8735,8443,8449,24,6,10,3,6,1,15,12,3,12,8,15
8736,8443,8449,37,1,10,7,3,0,16,9,7,17,3,24
8737,8443,8449,49,5,10,4,3,3,13,8,5,11,9,15
8738,8443,8449,19,10,10,3,4,3,15,14,1,10,10,13
8739,8443,8449,17,14,10,3,1,6,13,17,-4,7,13,10
8740,8443,8449,8,17,10,2,2,6,10,22,-12,6,14,8
8741,8443,8449,12,9,10,4,2,4,11,10,1,10,10,14
8742,8443,8449,53,12,10,3,4,3,14,20,-6,10,10,13
8743,8443,8449,21,7,10,4,2,4,14,11,3,10,10,14
8744,8443,8449,4,13,10,3,2,5,12,14,-2,8,12,11
8745,8443,8449,52,18,10,1,4,5,10,16,-6,6,14,7
8746,8443,8449,1,11,10,3,4,3,13,15,-2,10,10,13
8747,8638,8652,1,3,32,16,10,6,68,35,33,42,22,58
8748,8638,8652,19,7,32,13,7,12,43,44,-1,33,31,46
8749,8638,8652,17,14,32,10,7,15,39,56,-17,27,37,37
8750,8638,8652,8,16,32,8,7,17,30,60,-30,23,41,31
8751,3893,3899,28,8,29,10,7,12,34,39,-5,27,31,37
8752,3893,3899,36,12,29,7,10,12,28,34,-6,24,34,31
8753,4117,4123,57,4,13,7,3,3,13,10,3,17,9,24
8754,4117,4123,24,7,13,5,4,4,13,8,5,14,12,19
8755,4117,4123,26,13,13,2,6,5,7,15,-8,10,16,12
8756,4117,4123,43,3,13,7,3,3,30,15,15,17,9,24
8757,4117,4123,17,15,13,2,4,7,12,23,-11,8,18,10
8758,4117,4123,37,14,13,3,2,8,13,24,-11,8,18,11
8759,4117,4123,41,11,13,4,2,7,13,25,-12,10,16,14
8760,4117,4123,20,12,13,3,3,7,16,18,-2,9,17,12
8761,4117,4123,49,2,13,9,3,1,27,7,20,21,5,30
8762,4117,4123,52,5,13,6,3,4,15,11,4,15,11,21
8763,4117,4123,28,9,13,4,4,5,12,14,-2,12,14,16
8764,4117,4123,36,10,13,4,3,6,14,25,-11,11,15,15
8765,4117,4123,53,16,13,2,3,8,9,21,-12,7,19,9
8766,4117,4123,21,8,13,5,3,5,18,14,4,13,13,18
8767,4117,4123,39,6,13,6,2,5,12,17,-5,14,12,20
8768,4117,4123,1,1,13,9,4,0,32,9,23,22,4,31
8769,4033,4039,1,1,3,2,1,0,9,2,7,5,1,7
8770,4033,4039,39,5,3,2,0,1,3,3,0,4,2,6
8771,4033,4039,53,15,3,0,1,2,2,6,-4,1,5,1
8772,4033,4039,20,6,3,1,1,1,5,4,1,3,3,4
8773,4033,4039,41,7,3,1,1,1,5,5,0,3,3,4
8774,4033,4039,49,3,3,2,0,1,5,3,2,4,2,6
8775,4033,4039,37,3,3,2,0,1,5,3,2,4,2,6
8776,4033,4039,21,13,3,1,0,2,4,5,-1,2,4,3
8777,4033,4039,17,7,3,1,1,1,5,5,0,3,3,4
8778,4033,4039,24,10,3,1,1,1,3,4,-1,3,3,4
8779,4033,4039,43,10,3,1,1,1,3,4,-1,3,3,4
8780,4033,4039,57,12,3,1,0,2,2,2,0,2,4,3
8781,4033,4039,26,14,3,0,2,1,1,2,-1,2,4,2
8782,4033,4039,52,2,3,2,1,0,3,1,2,5,1,7
8783,4033,4039,28,9,3,1,1,1,2,2,0,3,3,4
8784,4033,4039,36,16,3,0,1,2,3,9,-6,1,5,1
8785,4383,4389,24,2,1,1,0,0,2,1,1,2,0,3
8786,4383,4389,43,3,1,1,0,0,1,0,1,2,0,3
8787,4383,4389,26,8,1,0,1,0,0,0,0,1,1,1
8788,4383,4389,57,13,1,0,0,1,0,1,-1,0,2,0
8789,4383,4389,17,6,1,0,1,0,1,1,0,1,1,1
8790,4383,4389,8,8,1,0,1,0,0,0,0,1,1,1
8791,4383,4389,41,13,1,0,0,1,0,1,-1,0,2,0
8792,4383,4389,49,3,1,1,0,0,1,0,1,2,0,3
8793,4383,4389,52,3,1,1,0,0,1,0,1,2,0,3
8794,4383,4389,48,6,1,0,1,0,1,1,0,1,1,1
8795,4383,4389,28,8,1,0,1,0,0,0,0,1,1,1
8796,4383,4389,36,16,1,0,0,1,1,3,-2,0,2,0
8797,4383,4389,53,12,1,0,0,1,1,2,-1,0,2,0
8798,4383,4389,21,13,1,0,0,1,0,1,-1,0,2,0
8799,4383,4389,39,8,1,0,1,0,0,0,0,1,1,1
8800,4383,4389,1,1,1,1,0,0,3,1,2,2,0,3
8801,4509,4515,39,15,15,1,7,7,7,19,-12,9,21,10
8802,4509,4515,17,7,15,6,5,4,24,26,-2,17,13,23
8803,4509,4515,8,12,15,4,5,6,15,22,-7,13,17,17
8804,4509,4515,1,1,15,11,3,1,32,11,21,25,5,36
8805,4509,4515,53,3,15,8,2,5,23,18,5,18,12,26
8806,4509,4515,49,2,15,8,4,3,20,10,10,20,10,28
8807,4509,4515,41,11,15,5,4,6,13,16,-3,14,16,19
8808,4509,4515,21,9,15,6,3,6,19,16,3,15,15,21
8809,4509,4515,43,4,15,7,4,4,26,18,8,18,12,25
8810,4509,4515,24,6,15,6,5,4,21,18,3,17,13,23
8811,4509,4515,57,8,15,6,4,5,17,18,-1,16,14,22
8812,4509,4515,26,14,15,2,5,8,9,18,-9,9,21,11
8813,4509,4515,52,5,15,5,9,1,19,7,12,19,11,24
8814,4509,4515,48,10,15,5,4,6,13,13,0,14,16,19
8815,4509,4515,28,13,15,2,6,7,9,18,-9,10,20,12
8816,4509,4515,36,16,15,2,2,11,12,31,-19,6,24,8
8817,4572,4578,17,6,23,9,8,6,36,33,3,26,20,35
8818,4572,4578,8,12,23,7,7,9,22,28,-6,21,25,28
8819,4572,4578,43,5,23,10,8,5,39,23,16,28,18,38
8820,4572,4578,24,7,23,8,11,4,30,23,7,27,19,35
8821,4572,4578,57,10,23,7,9,7,27,28,-1,23,23,30
8822,4572,4578,26,16,23,2,6,15,12,42,-30,10,36,12
8823,4572,4578,41,11,23,7,8,8,21,26,-5,22,24,29
8824,4572,4578,49,2,23,10,10,3,30,17,13,30,16,40
8825,4572,4578,53,4,23,11,5,7,30,25,5,27,19,38
8826,4572,4578,52,3,23,9,12,2,35,12,23,30,16,39
8827,4572,4578,48,8,23,8,8,7,20,18,2,24,22,32
8828,4572,4578,28,14,23,3,10,10,18,31,-13,16,30,19
8829,4572,4578,36,15,23,4,3,16,20,45,-25,11,35,15
8830,4572,4578,21,9,23,9,4,10,30,27,3,22,24,31
8831,4572,4578,39,13,23,4,8,11,14,29,-15,16,30,20
8832,8562,8568,20,6,22,9,5,8,32,28,4,23,21,32
8833,8562,8568,43,3,22,11,7,4,48,29,19,29,15,40
8834,8562,8568,52,17,22,3,9,10,20,31,-11,15,29,18
8835,8562,8568,19,10,22,7,6,9,29,33,-4,20,24,27
8836,8562,8568,17,15,22,6,3,13,26,41,-15,15,29,21
8837,8562,8568,8,16,22,5,4,13,20,47,-27,14,30,19
8838,8562,8568,1,5,22,10,8,4,39,24,15,28,16,38
8839,8562,8568,12,12,22,7,5,10,23,31,-8,19,25,26
8840,8562,8568,53,14,22,5,9,8,29,41,-12,19,25,24
8841,8562,8568,21,7,22,8,8,6,36,27,9,24,20,32
8842,8562,8568,4,18,22,4,4,14,22,35,-13,12,32,16
8843,8404,8407,12,3,5,3,1,1,7,3,4,7,3,10
8844,8404,8407,52,12,5,1,3,1,5,6,-1,5,5,6
8845,8404,8407,1,3,5,3,1,1,7,3,4,7,3,10
8846,8404,8407,21,3,5,3,1,1,7,3,4,7,3,10
8847,8404,8407,4,14,5,1,1,3,7,9,-2,3,7,4
8848,8404,8407,19,7,5,2,2,1,10,6,4,6,4,8
8849,8404,8407,17,16,5,1,0,4,5,9,-4,2,8,3
8850,8404,8407,8,18,5,0,1,4,2,10,-8,1,9,1
8851,8404,8407,13,2,5,3,1,1,9,5,4,7,3,10
8852,8404,8407,56,9,5,2,1,2,6,5,1,5,5,7
8853,8404,8407,20,13,5,1,2,2,3,4,-1,4,6,5
8854,8404,8407,41,17,5,0,1,4,5,12,-7,1,9,1
8855,8404,8407,37,1,5,4,1,0,8,4,4,9,1,13
8856,8404,8407,49,8,5,2,1,2,6,4,2,5,5,7
8857,8404,8407,53,11,5,2,1,2,6,12,-6,5,5,7
8858,8404,8407,43,6,5,3,1,1,8,5,3,7,3,10
8859,8404,8407,57,10,5,2,1,2,5,4,1,5,5,7
8860,8404,8407,24,15,5,0,4,1,5,7,-2,4,6,4
8861,8408,8414,43,5,6,3,2,1,9,6,3,8,4,11
8862,8408,8414,57,7,6,3,1,2,6,4,2,7,5,10
8863,8408,8414,24,14,6,1,4,1,7,8,-1,6,6,7
8864,8408,8414,12,3,6,3,2,1,8,4,4,8,4,11
8865,8408,8414,37,1,6,5,1,0,9,4,5,11,1,16
8866,8408,8414,49,9,6,2,2,2,7,5,2,6,6,8
8867,8408,8414,13,2,6,3,2,1,10,6,4,8,4,11
8868,8408,8414,20,10,6,2,2,2,6,6,0,6,6,8
8869,8408,8414,56,13,6,2,1,3,6,8,-2,5,7,7
8870,8408,8414,41,17,6,0,2,4,6,13,-7,2,10,2
8871,8408,8414,19,8,6,2,2,2,11,8,3,6,6,8
8872,8408,8414,17,16,6,1,0,5,5,10,-5,2,10,3
8873,8408,8414,8,18,6,0,2,4,3,11,-8,2,10,2
8874,8408,8414,21,6,6,3,1,2,7,4,3,7,5,10
8875,8408,8414,4,12,6,2,1,3,10,9,1,5,7,7
8876,8408,8414,52,15,6,1,3,2,7,9,-2,5,7,6
8877,8408,8414,53,11,6,2,2,2,7,13,-6,6,6,8
8878,8408,8414,1,3,6,3,2,1,8,4,4,8,4,11
8879,8415,8421,1,8,7,3,2,2,9,10,-1,8,6,11
8880,8415,8421,12,4,7,4,2,1,11,5,6,10,4,14
8881,8415,8421,53,12,7,2,3,2,9,15,-6,7,7,9
8882,8415,8421,52,16,7,1,3,3,8,12,-4,5,9,6
8883,8415,8421,4,13,7,2,1,4,10,10,0,5,9,7
8884,8415,8421,21,6,7,3,2,2,9,6,3,8,6,11
8885,8415,8421,19,11,7,2,3,2,13,10,3,7,7,9
8886,8415,8421,17,15,7,2,0,5,8,12,-4,4,10,6
8887,8415,8421,8,18,7,0,2,5,5,14,-9,2,12,2
8888,8415,8421,13,3,7,4,2,1,12,6,6,10,4,14
8889,8415,8421,20,7,7,3,2,2,7,6,1,8,6,11
8890,8415,8421,56,14,7,2,1,4,6,10,-4,5,9,7
8891,8415,8421,41,17,7,0,2,5,6,14,-8,2,12,2
8892,8415,8421,37,1,7,5,2,0,11,6,5,12,2,17
8893,8415,8421,49,5,7,3,2,2,10,7,3,8,6,11
8894,8415,8421,43,2,7,4,2,1,15,7,8,10,4,14
8895,8415,8421,57,9,7,3,1,3,8,7,1,7,7,10
8896,8415,8421,24,10,7,2,4,1,8,8,0,8,6,10
8897,8919,8939,20,2,19,13,2,4,42,24,18,28,10,41
8898,8919,8939,41,3,19,10,6,3,35,18,17,26,12,36
8899,8919,8939,13,9,19,6,6,7,25,28,-3,18,20,24
8900,8919,8939,37,6,19,9,4,6,34,18,16,22,16,31
8901,8919,8939,49,8,19,6,6,7,26,24,2,18,20,24
8902,8919,8939,56,10,19,6,5,8,25,32,-7,17,21,23
8903,8919,8939,43,1,19,14,5,0,61,17,44,33,5,47
8904,8919,8939,57,12,19,5,6,8,20,27,-7,16,22,21
8905,8919,8939,24,13,19,5,6,8,25,33,-8,16,22,21
8906,8919,8939,2,18,19,3,4,12,22,45,-23,10,28,13
8907,8919,8939,4,4,19,10,4,5,42,23,19,24,14,34
8908,8919,8939,21,7,19,6,8,5,21,27,-6,20,18,26
8909,8919,8939,12,11,19,6,4,9,27,37,-10,16,22,22
8910,8919,8939,53,14,19,5,4,10,27,41,-14,14,24,19
8911,8919,8939,11,17,19,3,6,10,20,36,-16,12,26,15
8912,8919,8939,1,5,19,9,6,4,30,25,5,24,14,33
8913,5559,5565,12,5,14,8,2,4,25,17,8,18,10,26
8914,5559,5565,53,10,13,5,4,4,19,21,-2,14,12,19
8915,5559,5565,57,11,13,3,6,4,17,15,2,12,14,15
8916,5559,5565,43,3,13,7,4,2,24,14,10,18,8,25
8917,5559,5565,17,6,14,7,3,4,29,18,11,17,11,24
8918,5559,5565,8,18,13,3,2,8,10,28,-18,8,18,11
8919,5559,5565,21,8,14,6,4,4,17,19,-2,16,12,22
8920,5559,5565,52,7,13,6,4,3,22,14,8,16,10,22
8921,5559,5565,54,15,13,4,1,8,8,23,-15,9,17,13
8922,5559,5565,48,17,13,1,6,6,8,20,-12,8,18,9
8923,5559,5565,40,14,13,1,7,5,13,20,-7,9,17,10
8924,5559,5565,24,16,13,1,6,6,14,21,-7,8,18,9
8925,5559,5565,37,2,14,7,4,3,19,6,13,18,10,25
8926,5559,5565,49,9,13,5,5,3,16,13,3,15,11,20
8927,5559,5565,5,12,13,2,7,4,12,15,-3,11,15,13
8928,5559,5565,20,4,13,6,6,1,20,10,10,18,8,24
8929,5559,5565,41,13,13,4,3,6,22,29,-7,11,15,15
8930,5559,5565,27,19,14,2,3,9,15,23,-8,7,21,9
8931,5559,5565,1,1,13,8,3,2,27,11,16,19,7,27
8932,5629,5635,52,2,21,12,5,4,39,21,18,29,13,41
8933,5629,5635,27,16,22,5,5,12,27,41,-14,15,29,20
8934,5629,5635,1,1,22,13,5,4,44,22,22,31,13,44
8935,5629,5635,20,6,22,9,8,5,41,24,17,26,18,35
8936,5629,5635,41,12,22,7,7,8,35,38,-3,21,23,28
8937,5629,5635,49,8,22,9,7,6,30,25,5,25,19,34
8938,5629,5635,5,13,22,5,9,8,26,31,-5,19,25,24
8939,5629,5635,48,18,22,2,8,12,15,39,-24,12,32,14
8940,5629,5635,54,19,21,4,4,13,11,38,-27,12,30,16
8941,5629,5635,43,4,21,12,4,5,42,25,17,28,14,40
8942,5629,5635,21,9,22,9,7,6,26,28,-2,25,19,34
8943,5629,5635,17,7,22,11,3,8,42,30,12,25,19,36
8944,5629,5635,8,17,22,5,5,12,16,37,-21,15,29,20
8945,5629,5635,57,11,22,6,9,7,31,33,-2,21,23,27
8946,5629,5635,24,14,22,4,8,10,26,36,-10,16,28,20
8947,5629,5635,40,15,22,3,10,9,21,35,-14,16,28,19
8948,5629,5635,53,10,21,8,7,6,33,33,0,23,19,31
8949,5629,5635,12,3,22,13,2,7,43,26,17,28,16,41
8950,5629,5635,37,5,22,9,9,4,25,11,14,27,17,36
8951,5643,5649,12,5,24,13,3,8,43,27,16,29,19,42
8952,5643,5649,53,10,23,9,7,7,40,39,1,25,21,34
8953,5643,5649,17,6,24,12,4,8,45,30,15,28,20,40
8954,5643,5649,8,17,24,5,7,12,17,38,-21,17,31,22
8955,5643,5649,21,8,24,10,8,6,28,29,-1,28,20,38
8956,5643,5649,43,2,23,13,5,5,47,27,20,31,15,44
8957,5643,5649,57,12,24,6,10,8,32,38,-6,22,26,28
8958,5643,5649,24,15,24,5,8,11,27,39,-12,18,30,23
8959,5643,5649,40,16,24,4,10,10,24,41,-17,18,30,22
8960,5643,5649,52,3,23,12,6,5,39,22,17,30,16,42
8961,5643,5649,48,18,24,2,10,12,16,40,-24,14,34,16
8962,5643,5649,54,19,23,4,4,15,11,41,-30,12,34,16
8963,5643,5649,37,7,24,9,10,5,26,13,13,28,20,37
8964,5643,5649,49,9,24,10,7,7,34,30,4,27,21,37
8965,5643,5649,5,13,23,5,9,9,28,35,-7,19,27,24
8966,5643,5649,20,4,24,10,9,5,42,24,18,29,19,39
8967,5643,5649,41,11,23,8,7,8,39,39,0,23,23,31
8968,5643,5649,27,14,24,6,6,12,31,43,-12,18,30,24
8969,5643,5649,1,1,24,14,6,4,49,23,26,34,14,48
8970,5937,5943,1,1,13,9,3,1,27,9,18,21,5,30
8971,5937,5943,52,2,13,8,3,2,22,10,12,19,7,27
8972,5937,5943,27,14,13,3,3,7,9,18,-9,9,17,12
8973,5937,5943,56,7,13,6,3,4,17,17,0,15,11,21
8974,5937,5943,20,13,13,4,1,8,16,22,-6,9,17,13
8975,5937,5943,41,15,13,3,3,7,12,23,-11,9,17,12
8976,5937,5943,21,8,13,6,3,4,15,16,-1,15,11,21
8977,5937,5943,17,3,13,7,3,3,18,15,3,17,9,24
8978,5937,5943,8,12,13,4,2,7,18,18,0,10,16,14
8979,5937,5943,53,4,13,7,2,4,29,20,9,16,10,23
8980,5937,5943,12,10,13,4,4,5,16,15,1,12,14,16
8981,5937,5943,43,5,13,6,5,2,30,17,13,17,9,23
8982,5937,5943,57,9,13,5,4,4,19,21,-2,14,12,19
8983,5937,5943,22,11,13,4,3,6,14,14,0,11,15,15
8984,5937,5943,24,18,13,1,4,8,10,24,-14,6,20,7
8985,5937,5943,49,6,13,6,5,2,15,9,6,17,9,23
8986,5937,5943,37,16,13,2,6,5,10,18,-8,10,16,12
8987,5937,5943,5,17,13,2,3,8,17,28,-11,7,19,9
8988,6336,6342,53,7,19,7,9,3,33,25,8,23,15,30
8989,6336,6342,12,11,19,6,5,8,24,21,3,17,21,23
8990,6336,6342,17,5,19,9,4,6,29,25,4,22,16,31
8991,6098,6104,22,11,33,12,8,13,43,42,1,32,34,44
8992,6098,6104,24,18,33,6,7,20,36,65,-29,19,47,25
8993,6098,6104,17,7,33,14,6,13,45,44,1,34,32,48
8994,6098,6104,8,14,33,8,9,16,39,56,-17,25,41,33
8995,6098,6104,20,6,33,14,6,13,46,39,7,34,32,48
8996,6098,6104,56,13,33,10,10,13,39,46,-7,30,36,40
8997,6098,6104,41,16,33,9,5,19,35,76,-41,23,43,32
8998,6098,6104,21,9,33,12,9,12,40,48,-8,33,33,45
8999,6098,6104,49,4,33,17,9,7,47,26,21,43,23,60
9000,6098,6104,37,12,33,11,9,13,34,40,-6,31,35,42
9001,6098,6104,5,17,33,6,8,19,39,68,-29,20,46,26
9002,6098,6104,52,3,33,18,8,7,61,35,26,44,22,62
9003,6098,6104,12,5,33,15,7,11,53,39,14,37,29,52
9004,6098,6104,53,10,33,11,12,10,57,50,7,34,32,45
9005,6098,6104,1,1,33,22,6,5,66,28,38,50,16,72
9006,6098,6104,27,15,33,8,9,16,27,46,-19,25,41,33
9007,5867,5873,27,8,4,2,0,2,5,5,0,4,4,6
9008,5867,5873,1,3,4,3,1,0,6,2,4,7,1,10
9009,5867,5873,53,1,4,3,1,0,12,5,7,7,1,10
9010,5867,5873,12,4,4,2,1,1,4,2,2,5,3,7
9011,5867,5873,52,11,4,1,2,1,2,2,0,4,4,5
9012,5867,5873,49,5,4,2,1,1,5,5,0,5,3,7
9013,5867,5873,5,14,4,1,0,3,7,6,1,2,6,3
9014,5867,5873,37,16,4,0,2,2,2,6,-4,2,6,2
9015,5867,5873,17,6,4,2,1,1,5,7,-2,5,3,7
9016,5867,5873,8,15,4,1,0,3,5,6,-1,2,6,3
9017,5867,5873,21,2,4,3,1,0,8,4,4,7,1,10
9018,5867,5873,41,10,4,1,2,1,4,4,0,4,4,5
9019,5867,5873,56,12,4,1,2,1,3,4,-1,4,4,5
9020,5867,5873,20,17,4,0,1,3,3,8,-5,1,7,1
9021,5867,5873,57,6,4,2,1,1,5,7,-2,5,3,7
9022,5867,5873,43,9,4,1,3,0,9,4,5,5,3,6
9023,5867,5873,24,13,4,1,1,2,2,6,-4,3,5,4
9024,5867,5873,22,18,4,0,0,4,2,6,-4,0,8,0
9025,6252,6272,43,4,12,6,4,2,23,9,14,16,8,22
9026,6252,6272,22,5,12,6,4,2,21,12,9,16,8,22
9027,6252,6272,40,14,12,4,1,7,14,24,-10,9,15,13
9028,6252,6272,57,17,12,2,3,7,9,23,-14,7,17,9
9029,6252,6272,41,16,12,2,3,7,13,22,-9,7,17,9
9030,6252,6272,14,18,12,2,2,8,15,32,-17,6,18,8
9031,6252,6272,21,6,12,5,4,3,18,11,7,14,10,19
9032,6252,6272,20,9,12,5,1,6,17,17,0,11,13,16
9033,6252,6272,56,10,12,4,4,4,14,16,-2,12,12,16
9034,6252,6272,17,7,12,5,4,3,14,11,3,14,10,19
9035,6252,6272,8,12,12,4,2,6,7,14,-7,10,14,14
9036,6252,6272,49,2,12,7,3,2,26,16,10,17,7,24
9037,6252,6272,37,3,12,7,2,3,20,10,10,16,8,23
9038,6252,6272,12,13,12,4,1,7,14,14,0,9,15,13
9039,6252,6272,52,15,12,3,4,5,19,20,-1,10,14,13
9040,6252,6272,1,1,12,8,1,3,30,21,9,17,7,25
9041,6252,6272,27,8,12,5,2,5,16,20,-4,12,12,17
9042,6252,6272,53,11,12,3,7,2,20,18,2,13,11,16
9043,6392,6398,27,13,26,8,4,14,30,46,-16,20,32,28
9044,6392,6398,1,1,26,18,5,3,61,36,25,41,11,59
9045,6392,6398,53,8,26,9,11,6,45,33,12,29,23,38
9046,6392,6398,12,11,26,9,7,10,38,30,8,25,27,34
9047,6392,6398,49,2,26,15,7,4,52,25,27,37,15,52
9048,6392,6398,37,5,26,12,6,8,36,24,12,30,22,42
9049,6392,6398,14,17,26,4,6,16,27,61,-34,14,38,18
9050,6392,6398,52,6,26,11,6,9,46,39,7,28,24,39
9051,6392,6398,17,4,26,15,4,7,47,31,16,34,18,49
9052,6392,6398,8,10,26,10,5,11,28,33,-5,25,27,35
9053,6392,6398,21,9,26,10,7,9,35,29,6,27,25,37
9054,6392,6398,20,12,26,8,6,12,32,41,-9,22,30,30
9055,6392,6398,56,14,26,6,9,11,31,39,-8,21,31,27
9056,6392,6398,41,16,26,6,8,12,38,42,-4,20,32,26
9057,6392,6398,43,3,26,15,5,6,46,23,23,35,17,50
9058,6392,6398,22,7,26,10,8,8,37,40,-3,28,24,38
9059,6392,6398,40,15,26,7,5,14,24,49,-25,19,33,26
9060,6392,6398,57,18,26,3,7,16,18,50,-32,13,39,16
9061,6434,6440,43,2,32,20,6,6,64,23,41,46,18,66
9062,6434,6440,22,7,32,13,8,11,48,51,-3,34,30,47
9063,6434,6440,40,15,32,8,7,17,27,61,-34,23,41,31
9064,6434,6440,57,17,32,4,8,20,22,59,-37,16,48,20
9065,6434,6440,20,10,32,12,8,12,43,43,0,32,32,44
9066,6434,6440,41,14,32,8,9,15,40,47,-7,25,39,33
9067,6434,6440,56,16,32,6,12,14,33,47,-14,24,40,30
9068,6434,6440,49,3,32,19,8,5,67,31,36,46,18,65
9069,6434,6440,37,5,32,14,10,8,42,26,16,38,26,52
9070,7302,7304,49,8,1,0,1,0,2,2,0,1,1,1
9071,7302,7304,8,8,1,0,1,0,2,2,0,1,1,1
9072,7302,7304,17,10,1,0,1,0,0,0,0,1,1,1
9073,7302,7304,19,15,1,0,0,1,2,4,-2,0,2,0
9074,7302,7304,48,3,1,1,0,0,2,0,2,2,0,3
9075,7302,7304,52,5,1,1,0,0,1,0,1,2,0,3
9076,7302,7304,12,5,1,1,0,0,1,0,1,2,0,3
9077,7302,7304,53,16,1,0,0,1,0,2,-2,0,2,0
9078,7302,7304,1,3,1,1,0,0,2,0,2,2,0,3
9079,7540,7546,1,5,31,15,5,11,70,49,21,35,27,50
9080,7540,7546,12,2,31,17,6,8,64,35,29,40,22,57
9081,7540,7546,53,16,31,8,6,17,33,50,-17,22,40,30
9082,7540,7546,52,7,31,13,6,12,44,44,0,32,30,45
9083,7540,7546,48,18,31,5,9,17,27,75,-48,19,43,24
9084,7540,7546,17,9,31,10,11,10,54,47,7,31,31,41
9085,7540,7546,19,15,31,9,5,17,48,69,-21,23,39,32
9086,7540,7546,8,17,31,7,7,17,34,59,-25,21,41,28
9087,7540,7546,49,3,31,17,5,9,60,41,19,39,23,56
9088,7540,7546,37,4,31,16,8,7,48,29,19,40,22,56
9089,7540,7546,4,8,31,12,8,11,48,42,6,32,30,44
9090,7540,7546,21,10,31,10,11,10,39,47,-8,31,31,41
9091,7540,7546,20,11,31,10,10,11,37,39,-2,30,32,40
9092,7540,7546,41,13,31,9,8,14,44,42,2,26,36,35
9093,7540,7546,56,14,31,9,8,14,36,53,-17,26,36,35
9094,7540,7546,43,1,31,23,5,3,71,22,49,51,11,74
9095,7540,7546,22,6,31,14,6,11,42,40,2,34,28,48
9096,7540,7546,57,12,31,10,6,15,45,61,-16,26,36,36
9097,7764,7770,57,16,16,4,3,9,21,29,-8,11,21,15
9098,7764,7770,24,18,16,1,4,11,13,25,-12,6,26,7
9099,7764,7770,21,3,16,9,4,3,25,11,14,22,10,31
9100,7764,7770,4,5,16,8,5,3,23,13,10,21,11,29
9101,7764,7770,49,6,16,8,5,3,23,14,9,21,11,29
9102,7764,7770,37,8,16,6,6,4,18,13,5,18,14,24
9103,7764,7770,43,1,16,10,3,3,30,18,12,23,9,33
9104,7764,7770,22,15,16,4,4,8,11,24,-13,12,20,16
9105,7764,7770,56,2,16,10,2,4,26,18,8,22,10,32
9106,7764,7770,20,10,16,5,4,7,15,14,1,14,18,19
9107,7764,7770,41,11,16,5,4,7,20,20,0,14,18,19
9108,7764,7770,12,7,16,7,4,5,20,16,4,18,14,25
9109,7764,7770,52,9,16,6,2,8,21,25,-4,14,18,20
9110,7764,7770,3,12,16,5,4,7,19,24,-5,14,18,19
9111,7764,7770,17,4,16,9,4,3,24,18,6,22,10,31
9112,7764,7770,8,13,16,5,4,7,15,22,-7,14,18,19
9113,7764,7770,19,14,16,4,5,7,17,28,-11,13,19,17
9114,7764,7770,1,17,16,3,3,10,20,29,-9,9,23,12
9115,7813,7819,1,17,20,4,4,12,25,33,-8,12,28,16
9116,7813,7819,49,4,20,10,7,3,30,19,11,27,13,37
9117,7813,7819,37,7,20,8,7,5,25,18,7,23,17,31
9118,7813,7819,12,8,20,8,6,6,29,22,7,22,18,30
9119,7813,7819,52,9,20,9,2,9,30,28,2,20,20,29
9120,7813,7819,3,13,20,5,6,9,22,35,-13,16,24,21
9121,7813,7819,56,5,20,11,3,6,28,24,4,25,15,36
9122,7813,7819,20,10,20,7,6,7,22,19,3,20,20,27
9123,7813,7819,41,15,20,5,5,10,21,29,-8,15,25,20
9124,7813,7819,17,6,20,10,5,5,30,25,5,25,15,35
9125,7813,7819,19,11,20,6,6,8,22,32,-10,18,22,24
9126,7813,7819,8,12,20,6,5,9,20,28,-8,17,23,23
9127,7813,7819,21,2,20,11,5,4,29,13,16,27,13,38
9128,7813,7819,4,3,20,10,7,3,28,14,14,27,13,37
9129,7813,7819,43,1,20,12,4,4,37,21,16,28,12,40
9130,7813,7819,22,14,20,5,6,9,14,27,-13,16,24,21
9131,7813,7819,57,16,20,5,4,11,31,40,-9,14,26,19
9132,7813,7819,24,18,20,2,4,14,16,32,-16,8,32,10
9133,7869,7875,43,1,27,16,7,4,48,25,23,39,15,55
9134,7869,7875,22,12,27,9,7,11,22,31,-9,25,29,34
9135,7869,7875,57,14,27,7,8,12,40,48,-8,22,32,29
9136,7869,7875,49,2,27,14,10,3,43,22,21,38,16,52
9137,7869,7875,37,8,27,10,9,8,32,24,8,29,25,39
9138,7869,7875,56,7,27,11,8,8,32,30,2,30,24,41
9139,7869,7875,20,9,27,9,9,9,27,24,3,27,27,36
9140,7869,7875,41,13,27,8,6,13,30,39,-9,22,32,30
9141,7869,7875,24,18,27,5,4,18,24,46,-22,14,40,19
9142,7869,7875,4,4,27,12,11,4,32,16,16,35,19,47
9143,7869,7875,21,5,27,13,7,7,34,19,15,33,21,46
9144,7869,7875,12,3,27,13,8,6,46,27,19,34,20,47
9145,7869,7875,52,10,27,10,4,13,35,35,0,24,30,34
9146,7869,7875,3,15,27,7,8,12,28,47,-19,22,32,29
9147,7869,7875,17,6,27,12,6,9,38,41,-3,30,24,42
9148,7869,7875,19,11,27,9,7,11,35,44,-9,25,29,34
9149,8919,8939,19,15,19,4,7,8,13,22,-9,15,23,19
9150,8919,8939,17,16,19,4,5,10,16,34,-18,13,25,17
9151,8947,8953,17,15,21,5,5,11,17,37,-20,15,27,20
9152,8947,8953,19,16,21,4,8,9,16,30,-14,16,26,20
9153,8947,8953,1,4,21,10,7,4,35,27,8,27,15,37
9154,8947,8953,12,7,21,8,4,9,34,37,-3,20,22,28
9155,8947,8953,53,14,21,5,5,11,27,42,-15,15,27,20
9156,8947,8953,11,17,21,4,7,10,25,38,-13,15,27,19
9157,8947,8953,4,5,21,10,6,5,45,26,19,26,16,36
9158,8947,8953,21,8,21,6,9,6,22,32,-10,21,21,27
9159,8947,8953,43,1,21,16,5,0,68,17,51,37,5,53
9160,8947,8953,57,10,21,6,7,8,23,28,-5,19,23,25
9161,8947,8953,24,13,21,5,8,8,25,33,-8,18,24,23
9162,8947,8953,2,18,21,3,4,14,22,50,-28,10,32,13
9163,8947,8953,20,2,21,14,3,4,48,25,23,31,11,45
9164,8947,8953,41,3,21,11,7,3,40,19,21,29,13,40
9165,8947,8953,13,11,21,6,6,9,27,39,-12,18,24,24
9166,8947,8953,56,12,21,6,5,10,26,40,-14,17,25,23
9167,8947,8953,37,6,21,10,5,6,37,18,19,25,17,35
9168,8947,8953,49,9,21,6,7,8,27,26,1,19,23,25
9169,8982,8988,20,2,26,16,4,6,53,30,23,36,16,52
9170,8982,8988,41,4,26,13,8,5,45,27,18,34,18,47
9171,8982,8988,13,12,26,8,6,12,33,47,-14,22,30,30
9172,8982,8988,56,13,26,7,7,12,32,50,-18,21,31,28
9173,8982,8988,37,5,26,13,6,7,48,19,29,32,20,45
9174,8982,8988,49,11,26,7,10,9,31,33,-2,24,28,31
9175,8982,8988,43,1,26,21,5,0,79,17,62,47,5,68
9176,8982,8988,24,8,26,8,8,10,31,37,-6,24,28,32
9177,8982,8988,57,9,26,8,8,10,27,37,-10,24,28,32
9178,8982,8988,2,18,26,3,6,17,28,60,-32,12,40,15
9179,8982,8988,4,6,26,11,8,7,52,29,23,30,22,41
9180,8982,8988,21,7,26,8,12,6,30,36,-6,28,24,36
9181,8982,8988,1,3,26,14,8,4,49,30,19,36,16,50
9182,8982,8988,12,10,26,8,7,11,37,45,-8,23,29,31
9183,8982,8988,53,16,26,6,6,14,33,52,-19,18,34,24
9184,8982,8988,11,17,26,4,8,14,29,53,-24,16,36,20
9185,8982,8988,19,14,26,6,10,10,19,31,-12,22,30,28
9186,8982,8988,17,15,26,6,7,13,21,44,-23,19,33,25
9187,9021,9023,1,2,32,18,10,4,72,44,28,46,18,64
9188,9021,9023,12,10,32,9,10,13,49,54,-5,28,36,37
9189,9021,9023,53,16,32,7,8,17,37,59,-22,22,42,29
9190,9021,9023,11,17,32,5,9,18,37,74,-37,19,45,24
9191,9021,9023,4,6,32,13,11,8,59,35,24,37,27,50
9192,9021,9023,21,7,32,11,13,8,39,44,-5,35,29,46
9193,9021,9023,43,1,32,24,7,1,92,22,70,55,9,79
9194,9021,9023,57,9,32,10,8,14,32,47,-15,28,36,38
9195,9021,9023,24,11,32,9,10,13,36,50,-14,28,36,37
9196,9021,9023,19,12,32,8,13,11,26,37,-11,29,35,37
9197,9021,9023,17,15,32,7,10,15,25,50,-25,24,40,31
9198,9021,9023,37,5,32,16,6,10,63,30,33,38,26,54
9199,9021,9023,49,8,32,9,12,11,39,41,-2,30,34,39
9200,9021,9023,20,3,32,19,6,7,61,34,27,44,20,63
9201,9021,9023,41,4,32,16,11,5,59,34,25,43,21,59
9202,9021,9023,13,13,32,9,8,15,42,59,-17,26,38,35
9203,9021,9023,56,14,32,8,10,14,40,60,-20,26,38,34
9204,9021,9023,2,18,32,5,8,19,37,71,-34,18,46,23
9205,9031,9110,43,1,34,26,7,1,100,25,75,59,9,85
9206,9031,9110,57,11,34,10,9,15,33,51,-18,29,39,39
9207,9031,9110,24,12,34,9,10,15,37,54,-17,28,40,37
9208,9031,9110,2,18,34,5,9,20,38,76,-38,19,49,24
9209,9031,9110,20,3,34,19,7,8,64,39,25,45,23,64
9210,9031,9110,41,4,34,17,12,5,64,36,28,46,22,63
9211,9031,9110,13,13,34,9,8,17,42,64,-22,26,42,35
9212,9031,9110,56,14,34,8,11,15,41,64,-23,27,41,35
9213,9031,9110,37,5,34,17,7,10,67,32,35,41,27,58
9214,9031,9110,49,8,34,10,13,11,42,43,-1,33,35,43
9215,9031,9110,4,6,34,14,12,8,62,36,26,40,28,54
9216,9031,9110,21,7,34,13,13,8,44,46,-2,39,29,52
9217,9031,9110,12,10,34,10,10,14,55,59,-4,30,38,40
9218,9031,9110,53,16,34,7,10,17,38,60,-22,24,44,31
9219,9031,9110,11,17,34,6,9,19,42,78,-36,21,47,27
9220,9031,9110,19,9,34,9,14,11,29,37,-8,32,36,41
9221,9031,9110,17,15,34,7,11,16,26,58,-32,25,43,32
9222,9031,9110,1,2,34,19,10,5,80,46,34,48,20,67
9223,9318,9324,19,17,28,5,8,15,20,51,-31,18,38,23
9224,9318,9324,17,18,28,4,9,15,26,53,-27,17,39,21
9225,9318,9324,1,2,28,17,7,4,57,27,30,41,15,58
9226,6336,6342,8,13,19,6,3,10,18,26,-8,15,23,21
9227,6336,6342,21,10,19,7,5,7,28,24,4,19,19,26
9228,6336,6342,43,4,19,10,4,5,34,19,15,24,14,34
9229,6336,6342,22,6,19,8,7,4,28,20,8,23,15,31
9230,6336,6342,40,14,19,5,3,11,18,36,-18,13,25,18
9231,6336,6342,57,18,19,2,5,12,12,36,-24,9,29,11
9232,6336,6342,20,9,19,8,3,8,29,27,2,19,19,27
9233,6336,6342,56,15,19,4,6,9,22,32,-10,14,24,18
9234,6336,6342,41,16,19,4,5,10,24,32,-8,13,25,17
9235,6336,6342,49,2,19,12,4,3,39,21,18,28,10,40
9236,6336,6342,37,3,19,11,3,5,30,16,14,25,13,36
9237,6336,6342,14,17,19,4,4,11,23,46,-23,12,26,16
9238,6336,6342,1,1,19,13,3,3,45,29,16,29,9,42
9239,6336,6342,52,12,19,6,5,8,34,33,1,17,21,23
9240,6336,6342,27,8,19,8,4,7,28,30,-2,20,18,28
9241,6735,6741,52,4,19,8,6,5,25,21,4,22,16,30
9242,6735,6741,48,16,19,3,9,7,12,22,-10,15,23,18
9243,6735,6741,27,9,19,7,4,8,21,25,-4,18,20,25
9244,6735,6741,12,3,19,8,7,4,24,19,5,23,15,31
9245,6735,6741,53,11,19,6,6,7,24,24,0,18,20,24
9246,6735,6741,1,5,19,7,9,3,25,18,7,23,15,30
9247,6735,6741,20,15,19,3,9,7,14,24,-10,15,23,18
9248,6735,6741,41,17,19,4,5,10,20,31,-11,13,25,17
9249,6735,6741,56,18,19,2,8,9,10,27,-17,12,26,14
9250,6735,6741,37,1,19,12,5,2,34,11,23,29,9,41
9251,6735,6741,49,6,19,7,7,5,23,17,6,21,17,28
9252,6735,6741,43,2,19,12,1,6,43,23,20,25,13,37
9253,6735,6741,22,13,19,4,9,6,23,25,-2,17,21,21
9254,6735,6741,40,14,19,4,6,9,25,41,-16,14,24,18
9255,6735,6741,21,7,19,6,10,3,22,16,6,22,16,28
9256,6735,6741,19,8,19,6,8,5,19,16,3,20,18,26
9257,6735,6741,17,10,19,7,3,9,22,24,-2,17,21,24
9258,6735,6741,8,12,19,5,8,6,20,22,-2,18,20,23
9259,6742,6755,19,9,20,6,9,5,21,18,3,21,19,27
9260,6742,6755,17,11,20,7,3,10,22,27,-5,17,23,24
9261,6742,6755,8,13,20,5,8,7,20,23,-3,18,22,23
9262,6742,6755,21,6,20,7,10,3,23,16,7,24,16,31
9263,6742,6755,43,2,20,13,1,6,50,25,25,27,13,40
9264,6742,6755,22,12,20,5,9,6,24,25,-1,19,21,24
9265,6742,6755,40,16,20,4,6,10,27,45,-18,14,26,18
9266,6742,6755,37,1,20,13,5,2,38,13,25,31,9,44
9267,6742,6755,49,4,20,8,7,5,25,18,7,23,17,31
9268,6742,6755,20,14,20,3,10,7,14,24,-10,16,24,19
9269,6742,6755,41,17,20,4,5,11,21,33,-12,13,27,17
9270,6742,6755,56,18,20,2,8,10,12,34,-22,12,28,14
9271,6742,6755,1,5,20,7,10,3,27,20,7,24,16,31
9272,6742,6755,12,3,20,9,7,4,27,19,8,25,15,34
9273,6742,6755,53,8,20,7,6,7,26,24,2,20,20,27
9274,6742,6755,27,10,20,7,4,9,21,27,-6,18,22,25
9275,6742,6755,52,7,20,8,6,6,25,22,3,22,18,30
9276,6742,6755,48,15,20,3,10,7,12,22,-10,16,24,19
9277,6756,6762,52,6,21,9,6,6,30,23,7,24,18,33
9278,6756,6762,48,14,21,3,11,7,13,23,-10,17,25,20
9279,6756,6762,27,9,21,8,4,9,23,28,-5,20,22,28
9280,6756,6762,12,3,21,9,8,4,28,20,8,26,16,35
9281,6756,6762,53,11,21,7,6,8,26,25,1,20,22,27
9282,6756,6762,1,5,21,8,10,3,29,21,8,26,16,34
9283,6756,6762,20,15,21,3,10,8,15,29,-14,16,26,19
9284,6756,6762,41,16,21,4,6,11,22,34,-12,14,28,18
9285,6756,6762,56,18,21,2,9,10,13,35,-22,13,29,15
9286,6756,6762,37,1,21,14,5,2,41,14,27,33,9,47
9287,6756,6762,49,4,21,9,7,5,26,18,8,25,17,34
9288,6756,6762,43,2,21,13,1,7,50,26,24,27,15,40
9289,6756,6762,22,12,21,5,9,7,25,27,-2,19,23,24
9290,6756,6762,40,17,21,4,6,11,28,47,-19,14,28,18
9291,6756,6762,21,7,21,7,10,4,24,19,5,24,18,31
9292,6756,6762,19,8,21,7,9,5,23,19,4,23,19,30
9293,6756,6762,17,10,21,8,3,10,23,27,-4,19,23,27
9294,6756,6762,8,13,21,5,8,8,21,25,-4,18,24,23
9295,6602,6608,17,5,6,3,1,2,9,7,2,7,5,10
9296,6602,6608,19,8,6,2,3,1,4,3,1,7,5,9
9297,6602,6608,8,13,6,2,2,2,5,9,-4,6,6,8
9298,6602,6608,21,4,6,3,1,2,10,7,3,7,5,10
9299,6602,6608,20,9,6,2,3,1,8,8,0,7,5,9
9300,6602,6608,41,15,6,2,0,4,5,12,-7,4,8,6
9301,6602,6608,43,1,6,5,0,1,19,7,12,10,2,15
9302,6602,6608,40,10,6,2,2,2,12,9,3,6,6,8
9303,6602,6608,22,16,6,1,2,3,5,9,-4,4,8,5
9304,6602,6608,56,18,6,0,2,4,3,11,-8,2,10,2
9305,7820,7826,1,17,21,4,5,12,26,34,-8,13,29,17
9306,7820,7826,52,9,21,9,3,9,30,28,2,21,21,30
9307,7820,7826,3,13,21,5,7,9,23,36,-13,17,25,22
9308,7827,7833,1,17,22,4,6,12,28,36,-8,14,30,18
9309,7827,7833,56,5,22,11,5,6,29,25,4,27,17,38
9310,7827,7833,20,10,22,7,7,8,24,22,2,21,23,28
9311,7827,7833,41,12,22,6,5,11,23,30,-7,17,27,23
9312,7827,7833,49,3,22,11,8,3,34,20,14,30,14,41
9313,7827,7833,37,8,22,9,8,5,26,18,8,26,18,35
9314,7827,7833,43,1,22,13,5,4,38,21,17,31,13,44
9315,7827,7833,22,14,22,5,7,10,14,28,-14,17,27,22
9316,7827,7833,57,16,22,5,6,11,34,43,-9,16,28,21
9317,7827,7833,24,18,22,4,4,14,19,32,-13,12,32,16
9318,7827,7833,12,7,22,10,6,6,37,25,12,26,18,36
9319,7827,7833,52,9,22,9,3,10,30,29,1,21,23,30
9320,7827,7833,3,15,22,5,7,10,24,39,-15,17,27,22
9321,7827,7833,17,6,22,11,5,6,31,28,3,27,17,38
9322,7827,7833,19,11,22,7,6,9,26,37,-11,20,24,27
9323,7827,7833,8,13,22,6,5,11,20,32,-12,17,27,23
9324,7827,7833,4,2,22,11,8,3,30,15,15,30,14,41
9325,7827,7833,21,4,22,11,5,6,29,16,13,27,17,38
9326,7918,8018,4,4,34,16,13,5,38,20,18,45,23,61
9327,7918,8018,21,5,34,17,9,8,45,23,22,43,25,60
9328,7918,8018,17,8,34,14,8,12,49,51,-2,36,32,50
9329,7918,8018,3,10,34,11,8,15,40,54,-14,30,38,41
9330,7918,8018,52,11,34,11,7,16,41,49,-8,29,39,40
9331,7918,8018,43,2,34,19,8,7,56,31,25,46,22,65
9332,7918,8018,22,13,34,10,9,15,24,49,-25,29,39,39
9333,7918,8018,57,15,34,10,8,16,57,61,-4,28,40,38
9334,7918,8018,24,18,34,6,5,23,28,65,-37,17,51,23
9335,7918,8018,49,1,34,19,10,5,59,28,31,48,20,67
9336,7918,8018,37,7,34,14,9,11,45,33,12,37,31,51
9337,7918,8018,56,6,34,14,10,10,39,35,4,38,30,52
9338,7918,8018,20,12,34,10,9,15,30,34,-4,29,39,39
9339,7918,8018,41,16,34,10,8,16,36,50,-14,28,40,38
9340,7918,8018,19,9,34,11,8,15,44,55,-11,30,38,41
9341,7918,8018,8,17,34,9,9,16,33,50,-17,27,41,36
9342,7918,8018,1,14,34,10,8,16,46,46,0,28,40,38
9343,7918,8018,12,3,34,17,10,7,56,32,24,44,24,61
9344,8233,8246,12,6,26,12,7,7,36,23,13,31,21,43
9345,8233,8246,53,12,26,7,7,12,34,46,-12,21,31,28
9346,8233,8246,49,3,26,15,6,5,58,30,28,36,16,51
9347,8233,8246,37,8,26,11,9,6,55,29,26,31,21,42
9348,8233,8246,19,5,26,12,8,6,40,32,8,32,20,44
9349,8233,8246,17,11,26,8,6,12,26,38,-12,22,30,30
9350,8233,8246,56,10,26,8,9,9,31,34,-3,25,27,33
9351,8233,8246,41,14,26,5,10,11,21,44,-23,20,32,25
9352,8233,8246,20,15,26,6,6,14,30,41,-11,18,34,24
9353,8233,8246,13,16,26,3,11,12,26,56,-30,17,35,20
9354,8233,8246,52,9,26,8,10,8,27,26,1,26,26,34
9355,8233,8246,3,17,26,4,6,16,27,52,-25,14,38,18
9356,8233,8246,43,1,26,16,7,3,59,27,32,39,13,55
9357,8233,8246,57,13,26,6,9,11,29,38,-9,21,31,27
9358,8233,8246,22,18,26,3,8,15,24,46,-22,14,38,17
9359,8233,8246,1,4,26,12,8,6,43,33,10,32,20,44
9360,8233,8246,21,2,26,16,5,5,43,24,19,37,15,53
9361,8233,8246,4,7,26,11,10,5,41,31,10,32,20,43
9362,8033,8036,49,2,4,3,0,1,13,4,9,6,2,9
9363,8033,8036,37,5,4,2,2,0,5,2,3,6,2,8
9364,8033,8036,52,8,4,2,0,2,6,6,0,4,4,6
9365,8033,8036,3,18,4,0,1,3,2,7,-5,1,7,1
9366,8033,8036,43,6,4,2,1,1,7,4,3,5,3,7
9367,8033,8036,22,13,4,1,0,3,2,4,-2,2,6,3
9368,8033,8036,57,17,4,0,1,3,5,9,-4,1,7,1
9369,8033,8036,20,8,4,2,0,2,6,6,0,4,4,6
9370,8033,8036,56,11,4,1,2,1,6,7,-1,4,4,5
9371,8033,8036,13,15,4,0,3,1,3,5,-2,3,5,3
9372,8033,8036,41,16,4,0,3,1,1,5,-4,3,5,3
9373,8033,8036,19,10,4,1,2,1,4,2,2,4,4,5
9374,8033,8036,17,12,4,1,1,2,2,10,-8,3,5,4
9375,8033,8036,1,3,4,3,0,1,7,3,4,6,2,9
9376,8033,8036,21,7,4,2,0,2,6,5,1,4,4,6
9377,8033,8036,4,14,4,0,3,1,4,5,-1,3,5,3
9378,8033,8036,53,1,4,3,1,0,7,4,3,7,1,10
9379,8033,8036,12,4,4,3,0,1,5,3,2,6,2,9
9380,8072,8078,12,4,9,5,2,2,12,8,4,12,6,17
9381,8072,8078,53,8,9,4,2,3,15,16,-1,10,8,14
9382,8072,8078,1,1,9,6,1,2,13,7,6,13,5,19
9383,8072,8078,19,7,9,4,3,2,12,10,2,11,7,15
9384,7869,7875,8,16,27,6,7,14,24,41,-17,19,35,25
9385,7869,7875,1,17,27,5,8,14,33,44,-11,18,36,23
9386,7708,7714,1,15,8,2,1,5,12,16,-4,5,11,7
9387,7708,7714,17,6,8,4,2,2,12,10,2,10,6,14
9388,7708,7714,8,12,8,3,1,4,11,15,-4,7,9,10
9389,7708,7714,19,17,8,1,3,4,8,16,-8,5,11,6
9390,7708,7714,3,8,8,3,2,3,11,11,0,8,8,11
9391,7708,7714,52,11,8,3,1,4,10,12,-2,7,9,10
9392,7708,7714,12,7,8,4,1,3,9,8,1,9,7,13
9393,7708,7714,41,4,8,4,2,2,13,7,6,10,6,14
9394,7708,7714,56,9,8,3,2,3,8,11,-3,8,8,11
9395,7708,7714,20,14,8,2,2,4,7,7,0,6,10,8
9396,7708,7714,49,3,8,4,3,1,16,8,8,11,5,15
9397,7708,7714,37,13,8,2,3,3,6,8,-2,7,9,9
9398,7708,7714,4,2,8,6,1,1,13,5,8,13,3,19
9399,7708,7714,21,5,8,4,2,2,10,4,6,10,6,14
9400,7708,7714,43,1,8,6,1,1,20,9,11,13,3,19
9401,7708,7714,57,10,8,3,1,4,16,18,-2,7,9,10
9402,7708,7714,22,16,8,2,1,5,6,16,-10,5,11,7
9403,7708,7714,24,18,8,0,3,5,8,15,-7,3,13,3
9404,8114,8120,21,7,14,6,4,4,16,16,0,16,12,22
9405,8114,8120,4,8,14,5,6,3,20,17,3,16,12,21
9406,8114,8120,52,9,14,5,5,4,15,14,1,15,13,20
9407,8114,8120,3,18,14,2,3,9,15,30,-15,7,21,9
9408,8114,8120,56,11,14,4,5,5,15,20,-5,13,15,17
9409,8114,8120,20,12,14,4,3,7,14,19,-5,11,17,15
9410,8114,8120,41,14,14,3,4,7,11,29,-18,10,18,13
9411,8114,8120,13,15,14,2,7,5,12,20,-8,11,17,13
9412,8114,8120,43,2,14,8,3,3,29,16,13,19,9,27
9413,8114,8120,22,16,14,3,3,8,16,21,-5,9,19,12
9414,8114,8120,57,17,14,2,5,7,15,23,-8,9,19,11
9415,8114,8120,19,3,14,7,5,2,19,13,6,19,9,26
9416,8114,8120,17,13,14,4,3,7,13,22,-9,11,17,15
9417,8114,8120,12,5,14,7,4,3,19,12,7,18,10,25
9418,8114,8120,53,10,14,5,3,6,22,31,-9,13,15,18
9419,8114,8120,49,1,14,9,2,3,38,15,23,20,8,29
9420,8114,8120,37,6,14,6,5,3,33,12,21,17,11,23
9421,8114,8120,1,4,14,7,4,3,21,13,8,18,10,25
9422,8205,8218,1,4,23,12,6,5,37,24,13,30,16,42
9423,8205,8218,37,7,23,9,9,5,48,24,24,27,19,36
9424,8205,8218,19,5,23,11,7,5,37,27,10,29,17,40
9425,8205,8218,17,11,23,7,5,11,23,35,-12,19,27,26
9426,8205,8218,12,6,23,10,6,7,29,22,7,26,20,36
9427,8205,8218,53,13,23,6,7,10,29,42,-13,19,27,25
9428,8205,8218,3,18,23,3,5,15,24,48,-24,11,35,14
9429,8205,8218,21,2,23,14,4,5,36,22,14,32,14,46
9430,8205,8218,4,8,23,9,9,5,35,28,7,27,19,36
9431,8205,8218,43,1,23,14,6,3,49,24,25,34,12,48
9432,8205,8218,57,12,23,6,7,10,27,34,-7,19,27,25
9433,8205,8218,22,17,23,3,6,14,22,41,-19,12,34,15
9434,8205,8218,56,9,23,8,9,6,30,27,3,25,21,33
9435,8205,8218,41,14,23,5,9,9,20,41,-21,19,27,24
9436,8205,8218,20,15,23,5,5,13,26,37,-11,15,31,20
9437,8205,8218,13,16,23,2,11,10,23,49,-26,15,31,17
9438,8205,8218,49,3,23,13,6,4,54,25,29,32,14,45
9439,8205,8218,52,10,23,7,9,7,24,23,1,23,23,30
9440,8226,8232,56,10,25,8,9,8,31,32,-1,25,25,33
9441,8226,8232,41,14,25,5,10,10,21,43,-22,20,30,25
9442,8226,8232,20,15,25,6,5,14,29,40,-11,17,33,23
9443,8226,8232,13,16,25,3,11,11,26,52,-26,17,33,20
9444,8226,8232,43,2,25,15,7,3,55,27,28,37,13,52
9445,8226,8232,57,13,25,6,8,11,28,37,-9,20,30,26
9446,8226,8232,22,17,25,3,7,15,23,45,-22,13,37,16
9447,8226,8232,21,1,25,16,4,5,42,23,19,36,14,52
9448,8226,8232,4,7,25,10,10,5,39,30,9,30,20,40
9449,8226,8232,52,9,25,8,9,8,26,25,1,25,25,33
9450,8226,8232,3,18,25,3,6,16,25,52,-27,12,38,15
9451,8226,8232,12,6,25,12,6,7,35,22,13,30,20,42
9452,8226,8232,53,12,25,7,7,11,32,43,-11,21,29,28
9453,8226,8232,19,5,25,12,7,6,38,30,8,31,19,43
9454,8226,8232,17,11,25,8,6,11,25,36,-11,22,28,30
9455,8226,8232,49,3,25,14,6,5,57,30,27,34,16,48
9456,8226,8232,37,8,25,10,9,6,52,27,25,29,21,39
9457,8226,8232,1,4,25,12,7,6,41,31,10,31,19,43
9458,8261,8274,1,5,29,14,8,7,47,39,8,36,22,50
9459,8261,8274,19,7,29,13,8,8,42,39,3,34,24,47
9460,8261,8274,17,13,29,8,7,14,28,44,-16,23,35,31
9461,8261,8274,49,2,29,18,6,5,68,31,37,42,16,60
9462,8261,8274,37,4,29,14,9,6,63,30,33,37,21,51
9463,6084,6090,17,7,31,14,5,12,42,38,4,33,29,47
9464,6084,6090,8,14,31,8,9,14,38,50,-12,25,37,33
9465,6084,6090,21,10,31,11,9,11,37,44,-7,31,31,42
9466,5895,5915,17,5,9,5,2,2,13,11,2,12,6,17
9467,5895,5915,8,14,9,2,1,6,11,15,-4,5,13,7
9468,5895,5915,49,7,9,4,3,2,10,8,2,11,7,15
9469,5895,5915,5,15,9,2,1,6,16,23,-7,5,13,7
9470,5895,5915,37,17,9,1,4,4,7,15,-8,6,12,7
9471,5895,5915,52,4,9,5,2,2,14,7,7,12,6,17
9472,5895,5915,53,8,9,4,2,3,18,16,2,10,8,14
9473,5895,5915,12,10,9,3,3,3,11,10,1,9,9,12
9474,5895,5915,43,2,9,5,4,0,23,9,14,14,4,19
9475,5895,5915,57,9,9,3,4,2,12,14,-2,10,8,13
9476,5895,5915,22,13,9,2,1,6,9,12,-3,5,13,7
9477,5895,5915,24,16,9,1,4,4,9,15,-6,6,12,7
9478,5895,5915,41,18,9,1,2,6,8,19,-11,4,14,5
9479,5895,5915,21,3,9,5,3,1,12,9,3,13,5,18
9480,5895,5915,56,6,9,4,3,2,11,9,2,11,7,15
9481,5895,5915,20,11,9,3,1,5,13,15,-2,7,11,10
9482,5895,5915,27,12,9,3,1,5,9,12,-3,7,11,10
9483,5895,5915,1,1,9,6,3,0,19,6,13,15,3,21
9484,6273,6286,27,10,13,5,3,5,17,21,-4,13,13,18
9485,6273,6286,1,2,13,8,2,3,30,21,9,18,8,26
9486,6273,6286,21,7,13,5,4,4,18,12,6,14,12,19
9487,6273,6286,20,6,13,6,1,6,18,17,1,13,13,19
9488,6273,6286,56,13,13,4,4,5,14,18,-4,12,14,16
9489,6273,6286,41,16,13,2,4,7,14,23,-9,8,18,10
9490,6273,6286,43,3,13,7,4,2,24,9,15,18,8,25
9491,6273,6286,22,5,13,6,5,2,21,12,9,17,9,23
9492,6273,6286,40,15,13,4,1,8,15,28,-13,9,17,13
9493,6273,6286,57,17,13,2,3,8,9,24,-15,7,19,9
9494,6273,6286,52,12,13,4,4,5,22,21,1,12,14,16
9495,6273,6286,12,11,13,5,1,7,18,16,2,11,15,16
9496,6273,6286,53,9,13,4,7,2,22,18,4,15,11,19
9497,6273,6286,49,1,13,8,3,2,30,17,13,19,7,27
9498,6273,6286,37,4,13,7,3,3,20,10,10,17,9,24
9499,6273,6286,14,18,13,2,3,8,15,32,-17,7,19,9
9500,6273,6286,17,8,13,5,4,4,16,15,1,14,12,19
9501,6273,6286,8,14,13,4,2,7,8,17,-9,10,16,14
9502,6315,6335,21,10,18,6,5,7,25,22,3,17,19,23
9503,6315,6335,17,5,18,9,4,5,27,20,7,22,14,31
9504,6315,6335,8,12,18,6,3,9,18,24,-6,15,21,21
9505,6315,6335,49,2,18,11,4,3,35,21,14,26,10,37
9506,6315,6335,37,3,18,10,3,5,29,16,13,23,13,33
9507,6315,6335,22,6,18,8,6,4,27,19,8,22,14,30
9508,6315,6335,40,15,18,5,2,11,17,35,-18,12,24,17
9509,6315,6335,57,18,18,2,5,11,12,34,-22,9,27,11
9510,6315,6335,14,16,18,4,4,10,23,42,-19,12,24,16
9511,6315,6335,53,7,18,7,9,2,32,23,9,23,13,30
9512,6315,6335,12,13,18,5,5,8,22,21,1,15,21,20
9513,6315,6335,43,4,18,9,4,5,32,18,14,22,14,31
9514,6315,6335,20,9,18,7,3,8,27,27,0,17,19,24
9515,6315,6335,56,14,18,4,6,8,20,29,-9,14,22,18
9516,6315,6335,41,17,18,3,5,10,19,30,-11,11,25,14
9517,6315,6335,1,1,18,12,3,3,42,27,15,27,9,39
9518,6315,6335,27,8,18,8,4,6,28,29,-1,20,16,28
9519,6315,6335,52,11,18,6,5,7,32,30,2,17,19,23
9520,6448,6569,1,1,34,22,7,5,73,48,25,51,17,73
9521,6448,6569,53,7,34,12,15,7,59,41,18,39,29,51
9522,6448,6569,12,13,34,9,10,15,46,46,0,28,40,37
9523,6448,6569,27,12,34,12,5,17,40,56,-16,29,39,41
9524,6448,6569,56,16,34,6,12,16,35,53,-18,24,44,30
9525,6448,6569,20,11,34,12,8,14,43,48,-5,32,36,44
9526,6448,6569,41,14,34,9,10,15,43,48,-5,28,40,37
9527,6448,6569,21,8,34,13,10,11,44,35,9,36,32,49
9528,6448,6569,14,18,34,4,7,23,31,88,-57,15,53,19
9529,6448,6569,52,6,34,15,6,13,55,46,9,36,32,51
9530,6448,6569,49,3,34,20,9,5,70,33,37,49,19,69
9531,6448,6569,37,5,34,15,10,9,45,29,16,40,28,55
9532,6448,6569,43,2,34,22,6,6,69,24,45,50,18,72
9533,6448,6569,22,9,34,13,8,13,50,56,-6,34,34,47
9534,6448,6569,40,15,34,9,7,18,29,63,-34,25,43,34
9535,6448,6569,57,17,34,4,8,22,24,65,-41,16,52,20
9536,6448,6569,17,4,34,21,5,8,70,41,29,47,21,68
9537,6448,6569,8,10,34,13,7,14,38,44,-6,33,35,46
9538,6213,6216,21,15,4,0,2,2,3,6,-3,2,6,2
9539,6213,6216,17,9,4,2,1,1,3,4,-1,5,3,7
9540,6213,6216,8,12,4,1,1,2,1,2,-1,3,5,4
9541,6213,6216,37,4,4,2,1,1,7,4,3,5,3,7
9542,8072,8078,17,9,9,4,1,4,10,15,-5,9,9,13
9543,8072,8078,56,10,9,3,3,3,10,11,-1,9,9,12
9544,8072,8078,41,12,9,2,4,3,5,14,-9,8,10,10
9545,8072,8078,20,13,9,3,0,6,9,14,-5,6,12,9
9546,8072,8078,13,15,9,1,6,2,8,10,-2,8,10,9
9547,8072,8078,52,14,9,2,3,4,9,14,-5,7,11,9
9548,8072,8078,3,16,9,2,2,5,11,16,-5,6,12,8
9549,8072,8078,37,2,9,5,3,1,23,6,17,13,5,18
9550,8072,8078,49,5,9,5,1,3,23,11,12,11,7,16
9551,8072,8078,43,6,9,5,1,3,16,12,4,11,7,16
9552,8072,8078,22,17,9,1,2,6,9,18,-9,4,14,5
9553,8072,8078,57,18,9,0,3,6,8,16,-8,3,15,3
9554,8072,8078,21,3,9,5,2,2,13,8,5,12,6,17
9555,8072,8078,4,11,9,2,5,2,10,10,0,9,9,11
9556,8383,8386,21,11,1,0,1,0,0,0,0,1,1,1
9557,8383,8386,4,17,1,0,0,1,0,2,-2,0,2,0
9558,8383,8386,19,7,1,0,1,0,1,1,0,1,1,1
9559,8383,8386,17,14,1,0,0,1,0,1,-1,0,2,0
9560,8383,8386,8,18,1,0,0,1,1,4,-3,0,2,0
9561,8383,8386,1,7,1,0,1,0,1,1,0,1,1,1
9562,8383,8386,24,7,1,0,1,0,1,1,0,1,1,1
9563,8383,8386,43,13,1,0,0,1,1,2,-1,0,2,0
9564,8383,8386,57,14,1,0,0,1,0,1,-1,0,2,0
9565,8383,8386,49,2,1,1,0,0,2,0,2,2,0,3
9566,8383,8386,37,4,1,1,0,0,1,0,1,2,0,3
9567,8383,8386,52,11,1,0,1,0,0,0,0,1,1,1
9568,8383,8386,13,4,1,1,0,0,1,0,1,2,0,3
9569,8383,8386,56,4,1,1,0,0,1,0,1,2,0,3
9570,8383,8386,20,7,1,0,1,0,1,1,0,1,1,1
9571,8383,8386,41,14,1,0,0,1,0,1,-1,0,2,0
9572,8383,8386,12,1,1,1,0,0,4,1,3,2,0,3
9573,8383,8386,53,3,1,1,0,0,2,1,1,2,0,3
9574,8842,8848,12,7,14,6,3,5,22,25,-3,15,13,21
9575,8842,8848,53,12,14,4,3,7,22,28,-6,11,17,15
9576,8842,8848,11,15,14,3,5,6,15,26,-11,11,17,14
9577,8842,8848,37,6,14,7,2,5,31,15,16,16,12,23
9578,8842,8848,49,8,14,5,4,5,21,19,2,14,14,19
9579,8842,8848,17,16,14,3,4,7,11,24,-13,10,18,13
9580,8842,8848,19,17,14,1,6,7,5,19,-14,8,20,9
9581,8842,8848,20,2,14,9,2,3,30,15,15,20,8,29
9582,8842,8848,41,5,14,6,6,2,28,15,13,18,10,24
9583,8842,8848,56,10,14,4,5,5,18,21,-3,13,15,17
9584,8842,8848,13,11,14,4,5,5,19,24,-5,13,15,17
9585,8842,8848,43,1,14,10,4,0,46,12,34,24,4,34
9586,8842,8848,24,13,14,3,6,5,19,28,-9,12,16,15
9587,8842,8848,57,14,14,3,5,6,13,17,-4,11,17,14
9588,8842,8848,2,18,14,2,2,10,14,38,-24,6,22,8
9589,8842,8848,1,3,14,7,4,3,22,20,2,18,10,25
9590,8842,8848,4,4,14,7,3,4,32,20,12,17,11,24
9591,8842,8848,21,9,14,4,7,3,17,19,-2,15,13,19
9592,8856,8862,4,3,16,9,3,4,37,21,16,21,11,30
9593,8856,8862,21,10,16,4,8,4,18,22,-4,16,16,20
9594,8856,8862,1,4,16,8,5,3,23,20,3,21,11,29
9595,8856,8862,43,1,16,12,4,0,56,14,42,28,4,40
9596,8856,8862,57,11,16,4,6,6,15,18,-3,14,18,18
9597,8856,8862,24,13,16,4,6,6,20,29,-9,14,18,18
9598,8856,8862,2,18,16,3,2,11,18,39,-21,8,24,11
9599,8856,8862,20,2,16,10,2,4,33,23,10,22,10,32
9600,8856,8862,41,6,16,7,6,3,30,17,13,20,12,27
9601,8856,8862,56,9,16,5,5,6,21,25,-4,15,17,20
9602,8856,8862,13,12,16,4,6,6,19,27,-8,14,18,18
9603,8856,8862,17,16,16,3,4,9,11,27,-16,10,22,13
9604,8856,8862,19,17,16,2,7,7,7,20,-13,11,21,13
9605,8856,8862,37,5,16,8,3,5,33,16,17,19,13,27
9606,8856,8862,49,7,16,6,4,6,23,20,3,16,16,22
9607,8856,8862,12,8,16,6,4,6,25,30,-5,16,16,22
9608,8856,8862,53,14,16,4,4,8,25,33,-8,12,20,16
9609,8856,8862,11,15,16,3,5,8,16,29,-13,11,21,14
9610,9024,9030,1,2,33,19,10,4,79,44,35,48,18,67
9611,9024,9030,43,1,33,25,7,1,96,22,74,57,9,82
9612,9024,9030,57,10,33,10,8,15,33,51,-18,28,38,38
9613,9024,9030,24,12,33,9,10,14,37,53,-16,28,38,37
9614,9024,9030,2,18,33,5,8,20,37,75,-38,18,48,23
9615,9024,9030,12,8,33,10,10,13,52,55,-3,30,36,40
9616,9024,9030,53,16,33,7,9,17,38,60,-22,23,43,30
9617,9024,9030,11,17,33,5,9,19,38,77,-39,19,47,24
9618,9024,9030,20,3,33,19,7,7,63,36,27,45,21,64
9619,9024,9030,41,4,33,17,11,5,63,35,28,45,21,62
9620,9024,9030,13,13,33,9,8,16,42,61,-19,26,40,35
9621,9024,9030,56,14,33,8,11,14,40,60,-20,27,39,35
9622,8261,8274,12,8,29,12,7,10,37,30,7,31,27,43
9623,8261,8274,53,12,29,8,7,14,38,51,-13,23,35,31
9624,8261,8274,52,9,29,9,11,9,29,28,1,29,29,38
9625,8261,8274,3,18,29,4,6,19,28,58,-30,14,44,18
9626,8261,8274,41,10,29,8,10,11,29,45,-16,26,32,34
9627,8261,8274,56,11,29,8,9,12,34,44,-10,25,33,33
9628,8261,8274,20,15,29,6,8,15,31,45,-14,20,38,26
9629,8261,8274,13,16,29,5,11,13,33,58,-25,21,37,26
9630,8261,8274,21,3,29,18,5,6,46,27,19,41,17,59
9631,8261,8274,4,6,29,13,10,6,45,36,9,36,22,49
9632,8261,8274,43,1,29,18,7,4,69,30,39,43,15,61
9633,8261,8274,57,14,29,7,10,12,35,46,-11,24,34,31
9634,8261,8274,22,17,29,4,9,16,30,51,-21,17,41,21
9635,8289,8296,43,2,32,19,8,5,72,33,39,46,18,65
9636,8289,8296,57,13,32,7,13,12,38,49,-11,27,37,34
9637,8289,8296,22,18,32,4,10,18,31,56,-25,18,46,22
9638,8289,8296,21,3,32,19,5,8,53,30,23,43,21,62
9639,8289,8296,4,4,32,16,10,6,54,40,14,42,22,58
9640,8289,8296,41,9,32,10,10,12,34,50,-16,30,34,40
9641,8289,8296,56,12,32,9,9,14,39,51,-12,27,37,36
9642,8289,8296,13,15,32,7,11,14,38,62,-24,25,39,32
9643,8289,8296,20,16,32,6,9,17,32,49,-17,21,43,27
9644,8289,8296,52,10,32,9,13,10,31,31,0,31,33,40
9645,8289,8296,3,17,32,5,7,20,31,61,-30,17,47,22
9646,8289,8296,12,8,32,13,8,11,40,33,7,34,30,47
9647,8289,8296,53,14,32,8,9,15,41,56,-15,25,39,33
9648,8289,8296,49,1,32,21,6,5,74,31,43,48,16,69
9649,8289,8296,37,5,32,15,10,7,66,33,33,40,24,55
9650,8289,8296,19,7,32,14,8,10,47,46,1,36,28,50
9651,8289,8296,17,11,32,10,7,15,32,46,-14,27,37,37
9652,8289,8296,1,6,32,15,9,8,51,47,4,39,25,54
9653,8485,8491,1,7,14,5,6,3,23,18,5,16,12,21
9654,8485,8491,19,5,14,6,4,4,22,16,6,16,12,22
9655,8485,8491,17,11,14,5,2,7,19,24,-5,12,16,17
9656,8485,8491,8,17,14,3,2,9,15,34,-19,8,20,11
9657,8485,8491,49,8,14,5,4,5,19,16,3,14,14,19
9658,8485,8491,12,10,14,5,3,6,15,18,-3,13,15,18
9659,8485,8491,53,13,14,3,7,4,18,25,-7,13,15,16
9660,8485,8491,21,8,14,5,4,5,19,16,3,14,14,19
9661,8485,8491,4,16,14,3,3,8,16,24,-8,9,19,12
9662,8485,8491,52,18,14,1,6,7,13,22,-9,8,20,9
9663,8485,8491,24,12,14,3,8,3,18,21,-3,14,14,17
9664,8485,8491,37,1,14,10,4,0,28,14,14,24,4,34
9665,8485,8491,13,2,14,8,3,3,28,15,13,19,9,27
9666,8485,8491,20,4,14,6,4,4,20,12,8,16,12,22
9667,8485,8491,41,14,14,4,3,7,14,23,-9,11,17,15
9668,8485,8491,56,15,14,3,5,6,14,19,-5,11,17,14
9669,8485,8491,43,3,14,7,5,2,32,18,14,19,9,26
9670,8485,8491,57,6,14,6,3,5,14,12,2,15,13,21
9671,8534,8540,13,2,18,11,4,3,38,18,20,26,10,37
9672,8534,8540,20,7,18,7,5,6,28,23,5,19,17,26
9673,8534,8540,56,11,18,5,7,6,21,24,-3,17,19,22
9674,8534,8540,41,14,18,5,5,8,17,26,-9,15,21,20
9675,8534,8540,43,3,18,9,5,4,42,25,17,23,13,32
9676,8534,8540,57,6,18,8,3,7,20,16,4,19,17,27
9677,8534,8540,24,8,18,5,10,3,22,23,-1,20,16,25
9678,8534,8540,21,10,18,5,7,6,24,22,2,17,19,22
9679,8534,8540,4,16,18,4,4,10,19,28,-9,12,24,16
9680,8534,8540,52,18,18,1,8,9,16,29,-13,10,26,11
9681,8534,8540,12,13,18,5,5,8,20,27,-7,15,21,20
9682,8534,8540,53,15,18,3,9,6,21,34,-13,15,21,18
9683,8534,8540,37,1,18,13,4,1,36,17,19,30,6,43
9684,8534,8540,49,4,18,8,5,5,29,21,8,21,15,29
9685,8534,8540,19,9,18,6,5,7,26,27,-1,17,19,23
9686,8534,8540,17,12,18,6,3,9,23,31,-8,15,21,21
9687,8534,8540,8,17,18,4,4,10,18,38,-20,12,24,16
9688,8534,8540,1,5,18,7,7,4,30,21,9,21,15,28
9689,8912,8918,1,5,18,9,6,3,29,21,8,24,12,33
9690,8912,8918,17,15,18,4,4,10,15,33,-18,12,24,16
9691,8912,8918,19,16,18,3,7,8,9,21,-12,13,23,16
9692,8912,8918,37,6,18,9,3,6,34,18,16,21,15,30
9693,8912,8918,49,7,18,6,5,7,26,24,2,17,19,23
9694,8912,8918,12,10,18,6,4,8,26,34,-8,16,20,22
9695,8912,8918,53,13,18,5,4,9,27,37,-10,14,22,19
9696,8912,8918,11,17,18,3,5,10,19,35,-16,11,25,14
9697,8912,8918,20,2,18,12,2,4,40,24,16,26,10,38
9698,8912,8918,41,4,18,9,6,3,33,17,16,24,12,33
9699,8912,8918,56,8,18,6,5,7,25,30,-5,17,19,23
9700,3053,3059,7,16,16,3,3,10,14,31,-17,9,23,12
9701,3053,3059,53,6,16,7,3,6,29,27,2,17,15,24
9702,3053,3059,1,2,16,9,3,4,32,16,16,21,11,30
9703,3074,3094,1,2,19,10,5,4,38,20,18,25,13,35
9704,3074,3094,4,8,19,6,7,6,21,24,-3,19,19,25
9705,3074,3094,7,16,19,3,4,12,16,37,-21,10,28,13
9706,3074,3094,53,9,19,7,3,9,31,36,-5,17,21,24
9707,3074,3094,17,5,19,7,8,4,33,26,7,22,16,29
9708,3074,3094,8,11,19,6,6,7,19,27,-8,18,20,24
9709,3074,3094,49,1,19,12,5,2,39,11,28,29,9,41
9710,3074,3094,37,10,19,6,6,7,26,31,-5,18,20,24
9711,3074,3094,20,7,19,7,4,8,32,32,0,18,20,25
9712,3074,3094,41,13,19,6,3,10,23,33,-10,15,23,21
9713,3074,3094,43,3,19,9,8,2,43,20,23,26,12,35
9714,3074,3094,24,15,19,3,5,11,20,38,-18,11,27,14
9715,3074,3094,28,6,19,6,9,4,27,26,1,21,17,27
9716,3074,3094,52,12,19,6,5,8,22,27,-5,17,21,23
9717,3074,3094,27,4,19,10,3,6,30,23,7,23,15,33
9718,3074,3094,39,14,19,4,7,8,18,27,-9,15,23,19
9719,3109,3115,27,2,22,13,3,6,37,23,14,29,15,42
9720,3109,3115,39,14,22,4,8,10,20,34,-14,16,28,20
9721,3109,3115,28,8,22,7,9,6,32,33,-1,23,21,30
9722,3109,3115,52,12,22,7,6,9,24,29,-5,20,24,27
9723,3109,3115,17,4,22,10,8,4,39,27,12,28,16,38
9724,3109,3115,8,7,22,8,6,8,23,30,-7,22,22,30
9725,3109,3115,43,5,22,9,8,5,47,27,20,26,18,35
9726,3109,3115,24,15,22,4,5,13,22,43,-21,13,31,17
9727,3109,3115,20,10,22,8,4,10,35,37,-2,20,24,28
9728,3109,3115,41,13,22,7,4,11,26,35,-9,18,26,25
9729,3109,3115,49,1,22,14,5,3,45,14,31,33,11,47
9730,3109,3115,37,6,22,8,6,8,30,34,-4,22,22,30
9731,3109,3115,4,9,22,7,9,6,24,26,-2,23,21,30
9732,3109,3115,7,16,22,3,4,15,19,50,-31,10,34,13
9733,3109,3115,53,11,22,8,3,11,34,41,-7,19,25,27
9734,3109,3115,1,3,22,12,6,4,49,23,26,30,14,42
9735,2955,2968,1,3,5,3,0,2,9,6,3,6,4,9
9736,2955,2968,7,10,5,1,2,2,7,10,-3,4,6,5
9737,2955,2968,4,11,5,1,2,2,3,6,-3,4,6,5
9738,2955,2968,53,6,5,2,1,2,7,10,-3,5,5,7
9739,2955,2968,20,15,5,1,1,3,7,12,-5,3,7,4
9740,2955,2968,41,16,5,1,1,3,5,13,-8,3,7,4
9741,2955,2968,49,2,5,4,0,1,13,3,10,8,2,12
9742,2955,2968,37,9,5,1,3,1,12,11,1,5,5,6
9743,2955,2968,8,5,5,2,1,2,7,9,-2,5,5,7
9744,2955,2968,17,8,5,1,3,1,11,8,3,5,5,6
9745,2955,2968,43,4,5,2,2,1,18,7,11,6,4,8
9746,2955,2968,24,14,5,1,1,3,7,11,-4,3,7,4
9747,2955,2968,28,7,5,1,4,0,8,5,3,6,4,7
9748,2955,2968,52,13,5,1,2,2,7,13,-6,4,6,5
9749,2955,2968,27,1,5,4,1,0,10,3,7,9,1,13
9750,2955,2968,39,12,5,1,2,2,4,8,-4,4,6,5
9751,3291,3297,39,3,1,1,0,0,2,0,2,2,0,3
9752,3291,3297,27,7,1,0,1,0,1,1,0,1,1,1
9753,3291,3297,28,5,1,1,0,0,2,1,1,2,0,3
9754,3291,3297,52,7,1,0,1,0,1,1,0,1,1,1
9755,3291,3297,26,11,1,0,0,1,1,2,-1,0,2,0
9756,3291,3297,43,13,1,0,0,1,1,3,-2,0,2,0
9757,3291,3297,37,6,1,1,0,0,1,0,1,2,0,3
9758,3291,3297,5,14,1,0,0,1,0,2,-2,0,2,0
9759,3291,3297,49,16,1,0,0,1,0,3,-3,0,2,0
9760,3291,3297,17,7,1,0,1,0,1,1,0,1,1,1
9761,3291,3297,8,7,1,0,1,0,1,1,0,1,1,1
9762,3291,3297,20,3,1,1,0,0,2,0,2,2,0,3
9763,3291,3297,41,12,1,0,0,1,0,1,-1,0,2,0
9764,3291,3297,4,14,1,0,0,1,0,2,-2,0,2,0
9765,3291,3297,53,1,1,1,0,0,3,0,3,2,0,3
9766,3291,3297,1,2,1,1,0,0,3,1,2,2,0,3
9767,3354,3360,1,2,10,7,1,2,21,13,8,15,5,22
9768,3354,3360,4,3,10,6,2,2,20,9,11,14,6,20
9769,3354,3360,53,4,10,6,2,2,14,4,10,14,6,20
9770,3354,3360,52,8,10,3,4,3,15,20,-5,10,10,13
9771,3354,3360,28,10,10,2,4,4,11,17,-6,8,12,10
9772,3354,3360,26,12,10,2,3,5,10,17,-7,7,13,9
9773,3354,3360,20,7,10,3,5,2,13,17,-4,11,9,14
9774,3354,3360,41,15,10,2,1,7,11,18,-7,5,15,7
9775,3354,3360,17,6,10,4,4,2,11,6,5,12,8,16
9776,3354,3360,8,16,10,1,4,5,6,14,-8,6,14,7
9777,3354,3360,49,1,10,7,2,1,20,6,14,16,4,23
9778,3354,3360,37,5,10,4,4,2,15,10,5,12,8,16
9779,3354,3360,5,13,10,2,3,5,9,20,-11,7,13,9
9780,3354,3360,43,9,10,3,3,4,16,9,7,9,11,12
9781,9318,9324,53,8,28,10,11,7,36,35,1,31,25,41
9782,9318,9324,12,11,28,9,7,12,40,49,-9,25,31,34
9783,9318,9324,27,15,28,7,6,15,32,48,-16,20,36,27
9784,9318,9324,52,12,28,7,9,12,29,47,-18,23,33,30
9785,9318,9324,49,6,28,12,9,7,42,27,15,33,23,45
9786,9318,9324,37,7,28,12,8,8,44,34,10,32,24,44
9787,9318,9324,4,3,28,13,9,6,43,28,15,35,21,48
9788,9318,9324,21,10,28,8,11,9,28,37,-9,27,29,35
9789,9318,9324,43,1,28,18,7,3,68,27,41,43,13,61
9790,9318,9324,57,9,28,10,9,9,47,40,7,29,27,39
9791,9318,9324,24,13,28,5,15,8,28,38,-10,25,31,30
9792,9318,9324,41,4,28,13,7,8,41,32,9,33,23,46
9793,9318,9324,20,5,28,13,6,9,44,27,17,32,24,45
9794,9318,9324,56,14,28,7,6,15,32,43,-11,20,36,27
9795,9318,9324,13,16,28,5,10,13,19,33,-14,20,36,25
9796,9136,9142,20,3,6,3,2,1,11,3,8,8,4,11
9797,9136,9142,13,8,6,2,3,1,4,4,0,7,5,9
9798,9136,9142,41,9,6,2,1,3,11,11,0,5,7,7
9799,9136,9142,56,15,6,1,2,3,7,10,-3,4,8,5
9800,9136,9142,37,4,6,3,2,1,10,8,2,8,4,11
9801,9136,9142,49,12,6,1,4,1,7,8,-1,6,6,7
9802,9136,9142,43,2,6,3,2,1,16,8,8,8,4,11
9803,9136,9142,57,10,6,2,1,3,10,11,-1,5,7,7
9804,9136,9142,24,16,6,0,4,2,3,7,-4,4,8,4
9805,9136,9142,4,6,6,3,2,1,8,7,1,8,4,11
9806,9136,9142,21,14,6,1,3,2,6,10,-4,5,7,6
9807,9136,9142,52,17,6,0,3,3,3,9,-6,3,9,3
9808,9136,9142,27,18,6,0,2,4,4,9,-5,2,10,2
9809,9136,9142,53,5,6,3,2,1,6,4,2,8,4,11
9810,9136,9142,12,11,6,1,4,1,6,5,1,6,6,7
9811,9136,9142,17,7,6,2,3,1,8,8,0,7,5,9
9812,9136,9142,19,13,6,1,3,2,8,12,-4,5,7,6
9813,9136,9142,1,1,6,4,1,1,12,6,6,9,3,13
9814,9507,9513,53,5,3,1,2,0,3,1,2,4,2,5
9815,9507,9513,12,13,3,0,3,0,2,2,0,3,3,3
9816,9507,9513,27,8,3,1,1,1,4,3,1,3,3,4
9817,9507,9513,49,2,3,2,1,0,8,1,7,5,1,7
9818,9507,9513,37,6,3,1,2,0,2,0,2,4,2,5
9819,9507,9513,43,3,3,2,1,0,5,1,4,5,1,7
9820,9507,9513,24,4,3,1,2,0,4,1,3,4,2,5
9821,9507,9513,57,10,3,1,0,2,6,5,1,2,4,3
9822,9507,9513,2,15,3,0,2,1,2,5,-3,2,4,2
9823,9507,9513,4,12,3,1,0,2,3,8,-5,2,4,3
9824,9507,9513,21,13,3,0,3,0,2,2,0,3,3,3
9825,9507,9513,1,1,3,2,1,0,12,2,10,5,1,7
9826,9507,9513,56,7,3,1,2,0,3,2,1,4,2,5
9827,9507,9513,41,9,3,1,1,1,4,5,-1,3,3,4
9828,9507,9513,13,11,3,1,0,2,3,5,-2,2,4,3
9829,9507,9513,20,18,3,0,1,2,1,11,-10,1,5,1
9830,9507,9513,48,16,3,0,1,2,1,5,-4,1,5,1
9831,9507,9513,52,17,3,0,1,2,1,7,-6,1,5,1
9832,9752,9758,56,14,32,8,7,17,34,47,-13,23,41,31
9833,9752,9758,13,17,32,5,8,19,29,62,-33,18,46,23
9834,9752,9758,37,5,32,13,14,5,41,24,17,40,24,53
9835,9752,9758,49,9,32,10,11,11,39,34,5,31,33,41
9836,9752,9758,52,13,32,7,11,14,32,50,-18,25,39,32
9837,9752,9758,48,18,32,4,7,21,20,75,-55,15,49,19
9838,9752,9758,43,1,32,23,7,2,76,25,51,53,11,76
9839,9752,9758,24,2,32,23,7,2,52,13,39,53,11,76
9840,9752,9758,2,11,32,9,12,11,33,41,-8,30,34,39
9841,9752,9758,57,12,32,8,11,13,34,39,-5,27,37,35
9842,9752,9758,41,6,32,14,8,10,43,37,6,36,28,50
9843,9752,9758,20,8,32,12,8,12,41,39,2,32,32,44
9844,9752,9758,21,15,32,7,9,16,36,44,-8,23,41,30
9845,9752,9758,4,16,32,7,9,16,25,48,-23,23,41,30
9846,9752,9758,12,4,32,16,8,8,56,40,16,40,24,56
9847,9752,9758,53,10,32,10,11,11,33,37,-4,31,33,41
9848,9752,9758,1,3,32,17,7,8,63,33,30,41,23,58
9849,9752,9758,27,7,32,13,9,10,45,44,1,35,29,48
9850,9766,9845,1,3,34,19,7,8,70,34,36,45,23,64
9851,9766,9845,21,14,34,8,10,16,43,49,-6,26,42,34
9852,9766,9845,4,16,34,7,9,18,25,50,-25,23,45,30
9853,9766,9845,37,5,34,15,14,5,44,24,20,44,24,59
9854,9766,9845,49,10,34,10,11,13,40,38,2,31,37,41
9855,9766,9845,27,7,34,13,9,12,49,52,-3,35,33,48
9856,9766,9845,12,4,34,18,8,8,59,41,18,44,24,62
9857,9766,9845,53,9,34,11,11,12,35,39,-4,33,35,44
9858,9766,9845,48,18,34,4,7,23,20,82,-62,15,53,19
9859,9766,9845,43,1,34,25,7,2,82,25,57,57,11,82
9860,9766,9845,24,2,34,24,7,3,57,18,39,55,13,79
9861,9024,9030,37,5,33,16,7,10,64,31,33,39,27,55
9862,9024,9030,49,9,33,9,13,11,41,43,-2,31,35,40
9863,9024,9030,4,6,33,14,11,8,61,35,26,39,27,53
9864,9024,9030,21,7,33,12,13,8,42,45,-3,37,29,49
9865,9024,9030,19,11,33,8,14,11,26,37,-11,30,36,38
9866,9024,9030,17,15,33,7,10,16,25,57,-32,24,42,31
9867,8772,8778,4,2,4,2,2,0,11,4,7,6,2,8
9868,8772,8778,21,11,4,1,2,1,4,5,-1,4,4,5
9869,8772,8778,17,14,4,1,0,3,4,7,-3,2,6,3
9870,8772,8778,19,16,4,0,3,1,1,5,-4,3,5,3
9871,8772,8778,12,5,4,2,1,1,6,10,-4,5,3,7
9872,8772,8778,11,8,4,1,2,1,5,3,2,4,4,5
9873,8772,8778,53,12,4,1,1,2,5,8,-3,3,5,4
9874,8772,8778,43,1,4,3,1,0,20,6,14,7,1,10
9875,8772,8778,24,13,4,0,4,0,5,5,0,4,4,4
9876,8772,8778,57,15,4,0,3,1,4,5,-1,3,5,3
9877,8772,8778,2,18,4,0,1,3,4,15,-11,1,7,1
9878,8772,8778,20,6,4,2,0,2,5,6,-1,4,4,6
9879,8772,8778,13,7,4,1,3,0,7,6,1,5,3,6
9880,8772,8778,41,9,4,1,2,1,6,5,1,4,4,5
9881,8772,8778,56,17,4,0,2,2,3,7,-4,2,6,2
9882,8772,8778,1,3,4,2,2,0,6,3,3,6,2,8
9883,8772,8778,37,4,4,2,1,1,8,4,4,5,3,7
9884,8772,8778,49,10,4,1,2,1,7,7,0,4,4,5
9885,9111,9114,27,10,1,0,1,0,0,0,0,1,1,1
9886,9111,9114,1,10,1,0,1,0,0,0,0,1,1,1
9887,9111,9114,43,1,1,1,0,0,4,0,4,2,0,3
9888,9111,9114,57,14,1,0,0,1,1,2,-1,0,2,0
9889,9111,9114,24,14,1,0,0,1,1,2,-1,0,2,0
9890,9111,9114,53,6,1,0,1,0,1,1,0,1,1,1
9891,9111,9114,12,6,1,0,1,0,1,1,0,1,1,1
9892,9111,9114,52,6,1,0,1,0,1,1,0,1,1,1
9893,9111,9114,49,3,1,1,0,0,2,1,1,2,0,3
9894,9111,9114,37,17,1,0,0,1,2,4,-2,0,2,0
9895,9111,9114,13,3,1,1,0,0,2,1,1,2,0,3
9896,9111,9114,41,10,1,0,1,0,0,0,0,1,1,1
9897,9111,9114,20,10,1,0,1,0,0,0,0,1,1,1
9898,9111,9114,56,14,1,0,0,1,1,2,-1,0,2,0
9899,9111,9114,19,3,1,1,0,0,2,1,1,2,0,3
9900,9111,9114,17,6,1,0,1,0,1,1,0,1,1,1
9901,9111,9114,21,2,1,1,0,0,4,2,2,2,0,3
9902,9111,9114,4,18,1,0,0,1,0,4,-4,0,2,0
9903,9332,9338,4,5,30,13,10,7,44,32,12,36,24,49
9904,9332,9338,21,10,30,9,12,9,32,38,-6,30,30,39
9905,9332,9338,43,1,30,20,7,3,73,28,45,47,13,67
9906,9332,9338,57,8,30,12,9,9,52,41,11,33,27,45
9907,9332,9338,24,12,30,6,15,9,31,41,-10,27,33,33
9908,9332,9338,41,3,30,14,7,9,42,34,8,35,25,49
9909,9332,9338,20,6,30,14,6,10,46,30,16,34,26,48
9910,9332,9338,56,15,30,7,6,17,33,49,-16,20,40,27
9911,9332,9338,13,16,30,5,11,14,19,35,-16,21,39,26
9912,9332,9338,19,17,30,5,9,16,20,52,-32,19,41,24
9913,9332,9338,17,18,30,4,10,16,27,55,-28,18,42,22
9914,9332,9338,1,2,30,19,7,4,63,27,36,45,15,64
9915,9332,9338,27,13,30,8,6,16,34,56,-22,22,38,30
9916,9332,9338,49,4,30,13,10,7,51,28,23,36,24,49
9917,9332,9338,37,7,30,13,9,8,46,34,12,35,25,48
9918,9332,9338,53,9,30,10,13,7,38,37,1,33,27,43
9919,9332,9338,12,11,30,9,8,13,42,56,-14,26,34,35
9920,9332,9338,52,14,30,7,9,14,30,50,-20,23,37,30
9921,9143,9149,52,17,7,0,4,3,4,10,-6,4,10,4
9922,9143,9149,53,4,7,3,3,1,7,5,2,9,5,12
9923,9143,9149,12,8,7,2,4,1,8,6,2,8,6,10
9924,9143,9149,27,15,7,1,2,4,6,10,-4,4,10,5
9925,9143,9149,4,3,7,4,2,1,11,7,4,10,4,14
9926,9143,9149,21,14,7,1,3,3,7,12,-5,5,9,6
9927,9143,9149,1,1,7,5,1,1,18,9,9,11,3,16
9928,9143,9149,20,6,7,3,2,2,11,4,7,8,6,11
9929,9143,9149,13,10,7,2,3,2,5,6,-1,7,7,9
9930,9143,9149,41,12,7,2,1,4,12,13,-1,5,9,7
9931,9143,9149,56,16,7,1,2,4,7,13,-6,4,10,5
9932,9143,9149,43,2,7,4,2,1,19,9,10,10,4,14
9933,9143,9149,57,13,7,2,1,4,10,12,-2,5,9,7
9934,9143,9149,24,17,7,0,4,3,4,10,-6,4,10,4
9935,9143,9149,17,5,7,3,3,1,9,8,1,9,5,12
9936,9143,9149,19,11,7,2,3,2,10,13,-3,7,7,9
9937,9143,9149,37,7,7,3,2,2,13,14,-1,8,6,11
9938,9143,9149,49,9,7,2,4,1,8,8,0,8,6,10
9939,9605,9611,1,2,16,10,4,2,37,17,20,24,8,34
9940,9605,9611,43,1,16,12,3,1,39,8,31,27,5,39
9941,9605,9611,24,3,16,10,4,2,27,8,19,24,8,34
9942,9605,9611,53,9,16,5,6,5,16,21,-5,16,16,21
9943,6213,6216,49,5,4,2,1,1,9,7,2,5,3,7
9944,6213,6216,14,18,4,0,1,3,3,8,-5,1,7,1
9945,6213,6216,52,11,4,1,3,0,7,5,2,5,3,6
9946,6213,6216,56,7,4,2,1,1,4,4,0,5,3,7
9947,6213,6216,20,10,4,2,0,2,7,5,2,4,4,6
9948,6213,6216,41,17,4,0,1,3,3,7,-4,1,7,1
9949,6213,6216,22,2,4,3,0,1,8,3,5,6,2,9
9950,6213,6216,43,3,4,2,2,0,9,4,5,6,2,8
9951,6213,6216,40,13,4,1,0,3,4,8,-4,2,6,3
9952,6213,6216,57,16,4,0,2,2,3,9,-6,2,6,2
9953,6213,6216,1,1,4,3,1,0,11,5,6,7,1,10
9954,6213,6216,12,6,4,2,1,1,5,4,1,5,3,7
9955,6213,6216,53,14,4,0,3,1,3,5,-2,3,5,3
9956,6213,6216,27,7,4,2,1,1,4,4,0,5,3,7
9957,6630,6636,27,13,10,4,1,5,11,17,-6,9,11,13
9958,6630,6636,53,4,10,5,2,3,17,8,9,12,8,17
9959,6630,6636,12,8,10,4,3,3,10,10,0,11,9,15
9960,6630,6636,52,10,10,4,2,4,13,15,-2,10,10,14
9961,6630,6636,48,17,10,0,5,5,6,17,-11,5,15,5
9962,6630,6636,1,11,10,3,5,2,12,11,1,11,9,14
9963,6630,6636,43,1,10,7,0,3,26,13,13,14,6,21
9964,6630,6636,22,14,10,3,2,5,8,12,-4,8,12,11
9965,6630,6636,40,16,10,2,3,5,15,18,-3,7,13,9
9966,6630,6636,20,12,10,3,5,2,11,11,0,11,9,14
9967,6630,6636,41,15,10,3,0,7,10,18,-8,6,14,9
9968,6630,6636,56,18,10,0,3,7,3,16,-13,3,17,3
9969,6630,6636,37,3,10,5,3,2,17,8,9,13,7,18
9970,6630,6636,49,7,10,4,3,3,17,13,4,11,9,15
9971,6630,6636,17,2,10,6,1,3,16,12,4,13,7,19
9972,6630,6636,19,5,10,4,5,1,8,5,3,13,7,17
9973,6630,6636,8,9,10,4,3,3,13,14,-1,11,9,15
9974,6630,6636,21,6,10,4,4,2,12,7,5,12,8,16
9975,6833,6839,17,8,33,12,7,14,40,46,-6,31,35,43
9976,6833,6839,19,10,33,10,12,11,40,40,0,32,34,42
9977,6833,6839,8,14,33,8,12,13,33,44,-11,28,38,36
9978,6833,6839,21,7,33,11,12,10,43,40,3,34,32,45
9979,6833,6839,37,1,33,19,11,3,61,22,39,49,17,68
9980,6833,6839,49,4,33,16,10,7,44,29,15,42,24,58
9981,6833,6839,52,5,33,16,7,10,54,40,14,39,27,55
9982,6833,6839,48,13,33,8,13,12,29,40,-11,29,37,37
9983,6833,6839,20,15,33,6,16,11,30,43,-13,28,38,34
9984,6833,6839,41,16,33,9,6,18,46,55,-9,24,42,33
9985,6833,6839,56,18,33,5,11,17,25,56,-31,21,45,26
9986,6833,6839,43,2,33,20,3,10,73,39,34,43,23,63
9987,6833,6839,22,11,33,10,12,11,44,46,-2,32,34,42
9988,6833,6839,40,17,33,8,8,17,43,75,-32,24,42,32
9989,6833,6839,1,6,33,13,10,10,49,48,1,36,30,49
9990,6833,6839,27,9,33,12,7,14,40,47,-7,31,35,43
9991,6833,6839,12,3,33,16,10,7,54,30,24,42,24,58
9992,6833,6839,53,12,33,11,7,15,43,51,-8,29,37,40
9993,6595,6601,53,2,5,3,1,1,9,2,7,7,3,10
9994,6595,6601,12,10,5,2,1,2,3,5,-2,5,5,7
9995,6595,6601,1,14,5,1,2,2,5,7,-2,4,6,5
9996,6595,6601,27,12,5,2,0,3,7,11,-4,4,6,6
9997,6595,6601,17,4,5,3,0,2,8,6,2,6,4,9
9998,6595,6601,19,5,5,2,3,0,4,1,3,7,3,9
9999,6595,6601,8,9,5,2,2,1,4,6,-2,6,4,8
10000,6595,6601,20,8,5,2,2,1,7,7,0,6,4,8
10001,6595,6601,41,11,5,2,0,3,5,8,-3,4,6,6
10002,6595,6601,56,17,5,0,2,3,2,7,-5,2,8,2
10003,6595,6601,37,6,5,2,2,1,10,4,6,6,4,8
10004,6595,6601,49,13,5,1,3,1,6,6,0,5,5,6
10005,6595,6601,52,15,5,1,0,4,3,10,-7,2,8,3
10006,6595,6601,48,16,5,0,3,2,1,7,-6,3,7,3
10007,6595,6601,43,1,5,4,0,1,15,6,9,8,2,12
10008,6595,6601,40,7,5,2,2,1,11,6,5,6,4,8
10009,6595,6601,22,18,5,0,2,3,2,8,-6,2,8,2
10010,6595,6601,21,3,5,3,1,1,7,2,5,7,3,10
10011,6616,6622,21,9,8,3,3,2,10,7,3,9,7,12
10012,6616,6622,19,4,8,3,4,1,7,5,2,10,6,13
10013,6616,6622,8,10,8,3,3,2,8,11,-3,9,7,12
10014,6616,6622,37,7,8,3,3,2,13,6,7,9,7,12
10015,6616,6622,49,8,8,3,3,2,14,11,3,9,7,12
10016,6616,6622,53,2,8,5,1,2,14,3,11,11,5,16
10017,6616,6622,12,11,8,3,2,3,9,10,-1,8,8,11
10018,6616,6622,20,5,8,3,4,1,10,9,1,10,6,13
10019,6616,6622,41,14,8,3,0,5,8,14,-6,6,10,9
10020,6616,6622,56,18,8,0,2,6,3,15,-12,2,14,2
10021,6616,6622,43,1,8,7,0,1,24,8,16,14,2,21
10022,6616,6622,40,15,8,2,3,3,14,12,2,7,9,9
10023,6616,6622,22,16,8,1,2,5,6,12,-6,4,12,5
10024,6434,6440,14,18,32,4,7,21,28,79,-51,15,49,19
10025,6434,6440,21,6,32,13,9,10,44,33,11,35,29,48
10026,6434,6440,17,4,32,19,5,8,62,39,23,43,21,62
10027,6434,6440,8,11,32,12,7,13,35,42,-7,31,33,43
10028,6434,6440,52,9,32,13,6,13,51,46,5,32,32,45
10029,6434,6440,1,1,32,21,6,5,70,46,24,48,16,69
10030,6434,6440,53,8,32,11,14,7,55,39,16,36,28,47
10031,6434,6440,12,12,32,9,9,14,45,44,1,27,37,36
10032,6434,6440,27,13,32,10,5,17,34,54,-20,25,39,35
10033,6238,6240,12,12,9,3,1,5,12,11,1,7,11,10
10034,6238,6240,1,1,9,6,1,2,21,17,4,13,5,19
10035,6238,6240,27,10,9,4,1,4,11,16,-5,9,9,13
10036,6238,6240,52,15,9,2,4,3,13,15,-2,8,10,10
10037,6238,6240,49,2,9,5,2,2,20,13,7,12,6,17
10038,6238,6240,37,3,9,5,1,3,13,9,4,11,7,16
10039,6238,6240,14,18,9,1,1,7,12,26,-14,3,15,4
10040,6238,6240,53,11,9,2,6,1,14,12,2,10,8,12
10041,6238,6240,17,6,9,4,3,2,11,7,4,11,7,15
10042,6238,6240,8,8,9,4,1,4,5,6,-1,9,9,13
10043,6238,6240,21,14,9,2,4,3,10,10,0,8,10,10
10044,6238,6240,56,7,9,4,2,3,12,12,0,10,8,14
10045,6238,6240,20,13,9,3,1,5,13,13,0,7,11,10
10046,6238,6240,41,17,9,2,2,5,11,14,-3,6,12,8
10047,6238,6240,43,4,9,4,3,2,16,7,9,11,7,15
10048,6238,6240,22,5,9,4,3,2,14,10,4,11,7,15
10049,6238,6240,40,9,9,4,1,4,13,15,-2,9,9,13
10050,6238,6240,57,16,9,2,3,4,9,17,-8,7,11,9
10051,6672,6678,43,2,16,9,1,6,39,22,17,19,13,28
10052,6672,6678,22,13,16,4,6,6,20,22,-2,14,18,18
10053,6672,6678,40,15,16,4,4,8,23,36,-13,12,20,16
10054,6672,6678,19,6,16,6,7,3,19,13,6,19,13,25
10055,6672,6678,8,9,16,5,8,3,18,17,1,18,14,23
10056,6672,6678,17,11,16,6,2,8,21,23,-2,14,18,20
10057,6672,6678,21,4,16,6,8,2,20,13,7,20,12,26
10058,6672,6678,37,1,16,9,5,2,30,11,19,23,9,32
10059,6672,6678,49,7,16,6,6,4,22,16,6,18,14,24
10060,6672,6678,20,14,16,3,8,5,13,21,-8,14,18,17
10061,6672,6678,41,16,16,4,3,9,19,28,-9,11,21,15
10062,6672,6678,56,18,16,2,5,9,8,25,-17,9,23,11
10063,6672,6678,12,8,16,6,6,4,19,17,2,18,14,24
10064,6672,6678,53,10,16,6,4,6,22,21,1,16,16,22
10065,6672,6678,52,3,16,7,5,4,23,19,4,19,13,26
10066,6672,6678,48,17,16,2,8,6,11,21,-10,12,20,14
10067,6672,6678,27,12,16,5,3,8,16,24,-8,13,19,18
10068,6672,6678,1,5,16,6,7,3,22,16,6,19,13,25
10069,6679,6727,1,6,17,6,8,3,23,17,6,20,14,26
10070,6679,6727,27,12,17,6,3,8,19,24,-5,15,19,21
10071,6679,6727,52,3,17,8,5,4,24,19,5,21,13,29
10072,6679,6727,48,17,17,2,8,7,11,22,-11,12,22,14
10073,6679,6727,12,4,17,7,6,4,22,18,4,20,14,27
10074,6679,6727,53,10,17,6,5,6,22,21,1,17,17,23
10075,6679,6727,20,14,17,3,9,5,13,21,-8,15,19,18
10076,6679,6727,41,16,17,4,3,10,20,31,-11,11,23,15
10077,6679,6727,56,18,17,2,6,9,9,26,-17,10,24,12
10078,6679,6727,37,1,17,10,5,2,31,11,20,25,9,35
10079,6679,6727,49,8,17,6,6,5,22,17,5,18,16,24
10080,6679,6727,21,5,17,6,9,2,22,15,7,21,13,27
10081,6679,6727,19,7,17,6,7,4,19,14,5,19,15,25
10082,6679,6727,17,9,17,7,2,8,22,23,-1,16,18,23
10083,6679,6727,8,11,17,5,8,4,18,18,0,18,16,23
10084,6679,6727,43,2,17,10,1,6,40,22,18,21,13,31
10085,6679,6727,22,13,17,4,7,6,22,24,-2,15,19,19
10086,6679,6727,40,15,17,4,4,9,23,39,-16,12,22,16
10087,6574,6576,8,1,2,2,0,0,2,0,2,4,0,6
10088,6574,6576,17,7,2,1,0,1,3,3,0,2,2,3
10089,6574,6576,19,13,2,0,2,0,0,0,0,2,2,2
10090,6574,6576,56,13,2,0,2,0,0,0,0,2,2,2
10091,6574,6576,37,2,2,1,1,0,3,0,3,3,1,4
10092,6574,6576,49,3,2,1,1,0,2,1,1,3,1,4
10093,6574,6576,20,3,2,1,1,0,2,1,1,3,1,4
10094,6574,6576,41,9,2,1,0,1,2,2,0,2,2,3
10095,6574,6576,43,7,2,1,0,1,3,3,0,2,2,3
10096,6574,6576,22,16,2,0,1,1,1,3,-2,1,3,1
10097,6574,6576,40,17,2,0,1,1,0,3,-3,1,3,1
10098,6574,6576,53,6,2,1,0,1,3,2,1,2,2,3
10099,6574,6576,12,9,2,1,0,1,2,2,0,2,2,3
10100,6574,6576,48,12,2,0,2,0,1,1,0,2,2,2
10101,6574,6576,52,18,2,0,0,2,0,4,-4,0,4,0
10102,6574,6576,1,15,2,0,1,1,2,3,-1,1,3,1
10103,6574,6576,21,5,2,1,0,1,4,2,2,2,2,3
10104,8638,8652,12,10,32,11,7,14,39,46,-7,29,35,40
10105,8638,8652,53,17,32,6,12,14,40,65,-25,24,40,30
10106,8638,8652,37,1,32,20,7,5,55,32,23,47,17,67
10107,8638,8652,49,4,32,16,6,10,54,41,13,38,26,54
10108,8638,8652,21,9,32,11,10,11,48,43,5,32,32,43
10109,8638,8652,4,12,32,10,8,14,36,40,-4,28,36,38
10110,8638,8652,43,2,32,18,7,7,74,37,37,43,21,61
10111,8638,8652,24,8,32,11,13,8,44,41,3,35,29,46
10112,8638,8652,57,11,32,11,7,14,33,43,-10,29,35,40
10113,8638,8652,13,5,32,15,6,11,58,47,11,36,28,51
10114,8638,8652,20,6,32,13,8,11,49,42,7,34,30,47
10115,8638,8652,56,13,32,10,8,14,34,43,-9,28,36,38
10116,8638,8652,41,15,32,9,8,15,35,48,-13,26,38,35
10117,8638,8652,52,18,32,6,10,16,32,48,-16,22,42,28
10118,8401,8403,52,11,4,1,2,1,2,3,-1,4,4,5
10119,8401,8403,13,5,4,2,1,1,7,4,3,5,3,7
10120,8401,8403,20,12,4,1,1,2,3,4,-1,3,5,4
10121,8401,8403,56,13,4,1,1,2,2,5,-3,3,5,4
10122,8401,8403,41,16,4,0,1,3,5,8,-3,1,7,1
10123,8401,8403,57,7,4,2,1,1,5,3,2,5,3,7
10124,8401,8403,43,9,4,2,1,1,6,5,1,5,3,7
10125,8401,8403,24,15,4,0,3,1,2,4,-2,3,5,3
10126,8401,8403,21,7,4,2,1,1,5,3,2,5,3,7
10127,8401,8403,4,17,4,0,1,3,3,8,-5,1,7,1
10128,8401,8403,37,2,4,3,1,0,7,4,3,7,1,10
10129,8401,8403,49,4,4,2,1,1,6,2,4,5,3,7
10130,8401,8403,19,3,4,2,2,0,9,4,5,6,2,8
10131,8401,8403,17,14,4,1,0,3,5,7,-2,2,6,3
10132,8401,8403,8,18,4,0,0,4,2,10,-8,0,8,0
10133,8401,8403,1,6,4,2,1,1,6,3,3,5,3,7
10134,8401,8403,12,1,4,3,1,0,7,2,5,7,1,10
10135,8401,8403,53,10,4,2,1,1,5,8,-3,5,3,7
10136,8754,8760,1,3,1,1,0,0,2,0,2,2,0,3
10137,8754,8760,19,11,1,0,1,0,0,0,0,1,1,1
10138,8754,8760,17,17,1,0,0,1,0,2,-2,0,2,0
10139,8754,8760,37,2,1,1,0,0,3,1,2,2,0,3
10140,8754,8760,49,4,1,1,0,0,3,2,1,2,0,3
10141,8754,8760,4,5,1,0,1,0,3,3,0,1,1,1
10142,8754,8760,21,7,1,0,1,0,2,2,0,1,1,1
10143,8754,8760,43,1,1,1,0,0,9,2,7,2,0,3
10144,8754,8760,24,9,1,0,1,0,1,1,0,1,1,1
10145,8754,8760,57,11,1,0,1,0,0,0,0,1,1,1
10146,8754,8760,2,18,1,0,0,1,2,9,-7,0,2,0
10147,8754,8760,13,5,1,0,1,0,3,3,0,1,1,1
10148,8754,8760,41,11,1,0,1,0,0,0,0,1,1,1
10149,8754,8760,56,11,1,0,1,0,0,0,0,1,1,1
10150,8754,8760,20,15,1,0,0,1,2,3,-1,0,2,0
10151,8754,8760,11,7,1,0,1,0,2,2,0,1,1,1
10152,8754,8760,12,9,1,0,1,0,1,1,0,1,1,1
10153,8754,8760,53,16,1,0,0,1,1,3,-2,0,2,0
10154,8814,8820,43,1,10,7,3,0,35,10,25,17,3,24
10155,8814,8820,57,8,10,3,5,2,13,11,2,11,9,14
10156,8814,8820,24,15,10,2,5,3,13,15,-2,9,11,11
10157,8814,8820,2,18,10,1,1,8,10,30,-20,3,17,4
10158,8814,8820,20,2,10,6,1,3,21,13,8,13,7,19
10159,8814,8820,41,5,10,4,5,1,19,11,8,13,7,17
10160,8814,8820,13,9,10,3,4,3,14,16,-2,10,10,13
10161,8814,8820,56,11,10,3,3,4,14,13,1,9,11,12
10162,8814,8820,4,3,10,5,3,2,27,14,13,13,7,18
10163,8814,8820,21,10,10,3,4,3,12,15,-3,10,10,13
10164,8814,8820,1,4,10,5,3,2,16,15,1,13,7,18
10165,8814,8820,17,16,10,2,2,6,5,20,-15,6,14,8
10166,8814,8820,19,17,10,0,6,4,3,10,-7,6,14,6
10167,8814,8820,12,7,10,4,2,4,14,20,-6,10,10,14
10168,8814,8820,11,13,10,3,3,4,12,18,-6,9,11,12
10169,8814,8820,53,14,10,3,2,5,15,19,-4,8,12,11
10170,8814,8820,37,6,10,5,1,4,19,10,9,11,9,16
10171,8814,8820,49,12,10,3,3,4,14,16,-2,9,11,12
10172,8992,8995,4,6,28,12,8,8,55,32,23,32,24,44
10173,8992,8995,21,7,28,9,12,7,33,38,-5,30,26,39
10174,8992,8995,1,3,28,14,10,4,52,33,19,38,18,52
10175,8992,8995,37,5,28,14,6,8,51,22,29,34,22,48
10176,8992,8995,49,11,28,7,11,10,34,37,-3,25,31,32
10177,8992,8995,19,12,28,7,11,10,20,31,-11,25,31,32
10178,8992,8995,17,15,28,7,7,14,23,46,-23,21,35,28
10179,8992,8995,43,1,28,22,6,0,82,18,64,50,6,72
10180,8992,8995,57,8,28,10,8,10,30,37,-7,28,28,38
10181,8992,8995,24,10,28,8,9,11,33,40,-7,25,31,33
10182,8992,8995,2,18,28,4,7,17,29,60,-31,15,41,19
10183,8992,8995,20,2,28,18,4,6,55,30,25,40,16,58
10184,8992,8995,41,4,28,13,10,5,49,31,18,36,20,49
10185,9766,9845,57,11,34,9,12,13,37,40,-3,30,38,39
10186,9766,9845,2,12,34,9,12,13,34,47,-13,30,38,39
10187,9766,9845,52,13,34,8,12,14,37,53,-16,28,40,36
10188,9766,9845,41,6,34,14,10,10,44,38,6,38,30,52
10189,9766,9845,20,8,34,13,8,13,45,43,2,34,34,47
10190,9766,9845,56,15,34,8,8,18,37,52,-15,24,44,32
10191,9766,9845,13,17,34,5,10,19,30,63,-33,20,48,25
10192,9906,9912,21,4,11,6,5,0,22,10,12,17,5,23
10193,9906,9912,4,18,11,2,1,8,11,24,-13,5,17,7
10194,9906,9912,24,2,11,7,2,2,15,8,7,16,6,23
10195,9906,9912,43,3,11,6,5,0,23,5,18,17,5,23
10196,9906,9912,22,11,11,4,0,7,14,26,-12,8,14,12
10197,9906,9912,2,13,11,3,1,7,10,20,-10,7,15,10
10198,9906,9912,57,14,11,2,4,5,12,15,-3,8,14,10
10199,9906,9912,28,7,11,5,3,3,12,12,0,13,9,18
10200,9906,9912,52,12,11,3,3,5,11,17,-6,9,13,12
10201,9906,9912,12,8,11,4,4,3,13,12,1,12,10,16
10202,9906,9912,53,10,11,4,1,6,12,16,-4,9,13,13
10203,9906,9912,27,15,11,2,4,5,11,18,-7,8,14,10
10204,9906,9912,49,9,11,4,3,4,19,18,1,11,11,15
10205,9906,9912,37,16,11,2,3,6,12,15,-3,7,15,9
10206,9906,9912,41,5,11,5,5,1,16,9,7,15,7,20
10207,9906,9912,20,6,11,6,1,4,23,14,9,13,9,19
10208,9906,9912,56,17,11,2,3,6,10,20,-10,7,15,9
10209,9906,9912,1,1,11,7,2,2,25,12,13,16,6,23
10210,9850,9856,1,3,2,2,0,0,3,0,3,4,0,6
10211,9850,9856,27,12,2,0,1,1,2,3,-1,1,3,1
10212,9850,9856,53,6,2,1,1,0,1,0,1,3,1,4
10213,9850,9856,12,6,2,1,1,0,1,0,1,3,1,4
10214,9850,9856,21,1,2,2,0,0,8,2,6,4,0,6
10215,9850,9856,4,17,2,0,0,2,1,5,-4,0,4,0
10216,9850,9856,56,14,2,0,1,1,2,5,-3,1,3,1
10217,9850,9856,49,15,2,0,0,2,2,4,-2,0,4,0
10218,9850,9856,37,16,2,0,0,2,0,3,-3,0,4,0
10219,9850,9856,52,4,2,1,1,0,5,2,3,3,1,4
10220,9850,9856,28,10,2,0,2,0,2,2,0,2,2,2
10221,9850,9856,24,5,2,1,1,0,2,1,1,3,1,4
10222,9850,9856,43,6,2,1,1,0,1,0,1,3,1,4
10223,9850,9856,2,9,2,1,0,1,4,6,-2,2,2,3
10224,9850,9856,57,10,2,0,2,0,2,2,0,2,2,2
10225,9850,9856,22,18,2,0,0,2,1,6,-5,0,4,0
10226,9850,9856,41,2,2,2,0,0,6,1,5,4,0,6
10227,9850,9856,20,13,2,0,1,1,1,2,-1,1,3,1
10228,10039,10045,24,1,23,16,3,4,37,18,19,35,11,51
10229,10039,10045,43,6,23,9,8,6,37,21,16,26,20,35
10230,10039,10045,57,10,23,8,5,10,33,35,-2,21,25,29
10231,10039,10045,2,17,23,5,3,15,17,43,-26,13,33,18
10232,10039,10045,22,18,23,4,4,15,23,61,-38,12,34,16
10233,10039,10045,21,2,23,14,7,2,53,22,31,35,11,49
10234,10039,10045,4,12,23,8,3,12,25,38,-13,19,27,27
10235,10039,10045,1,3,23,15,3,5,52,28,24,33,13,48
10236,10039,10045,20,4,23,12,4,7,40,29,11,28,18,40
10237,10039,10045,41,5,23,9,11,3,34,21,13,29,17,38
10238,10039,10045,56,16,23,6,5,12,27,47,-20,17,29,23
10239,10039,10045,28,11,23,7,7,9,18,26,-8,21,25,28
10240,10039,10045,52,13,23,6,9,8,25,29,-4,21,25,27
10241,10039,10045,27,9,23,8,6,9,30,36,-6,22,24,30
10242,10039,10045,12,15,23,6,7,10,28,31,-3,19,27,25
10243,10039,10045,53,7,23,9,4,10,30,29,1,22,24,31
10244,10039,10045,49,8,23,8,6,9,34,32,2,22,24,30
10245,10039,10045,37,14,23,6,7,10,28,25,3,19,27,25
10246,10102,10108,53,12,31,9,6,16,35,43,-8,24,38,33
10247,10102,10108,12,13,31,8,8,15,34,43,-9,24,38,32
10248,10102,10108,27,8,31,10,9,12,35,44,-9,29,33,39
10249,10102,10108,28,11,31,9,9,13,24,34,-10,27,35,36
10250,10102,10108,52,14,31,7,11,13,30,45,-15,25,37,32
10251,10102,10108,1,1,31,22,4,5,70,32,38,48,14,70
10252,10102,10108,41,5,31,13,14,4,47,26,21,40,22,53
10253,10102,10108,20,6,31,14,6,11,47,42,5,34,28,48
10254,10102,10108,56,10,31,10,8,13,39,52,-13,28,34,38
10255,10102,10108,49,9,31,10,8,13,43,44,-1,28,34,38
10256,10102,10108,37,16,31,7,10,14,31,34,-3,24,38,31
10257,10102,10108,21,3,31,18,9,4,68,35,33,45,17,63
10258,10102,10108,4,15,31,8,7,16,31,50,-19,23,39,31
10259,10102,10108,22,17,31,8,6,17,28,71,-43,22,40,30
10260,10102,10108,2,18,31,7,6,18,20,51,-31,20,42,27
10261,10102,10108,24,2,31,20,5,6,45,22,23,45,17,65
10262,10102,10108,43,4,31,16,9,6,61,24,37,41,21,57
10263,10102,10108,57,7,31,12,7,12,46,42,4,31,31,43
10264,6616,6622,17,3,8,4,1,3,10,10,0,9,7,13
10265,6616,6622,52,12,8,3,1,4,10,14,-4,7,9,10
10266,6616,6622,48,17,8,0,4,4,4,14,-10,4,12,4
10267,6616,6622,27,6,8,4,0,4,10,13,-3,8,8,12
10268,6616,6622,1,13,8,2,4,2,9,9,0,8,8,10
10269,6934,6937,1,6,1,1,0,0,1,0,1,2,0,3
10270,6934,6937,27,3,1,1,0,0,2,0,2,2,0,3
10271,6934,6937,59,7,1,0,1,0,1,1,0,1,1,1
10272,6934,6937,20,1,1,1,0,0,3,0,3,2,0,3
10273,6934,6937,41,16,1,0,0,1,0,2,-2,0,2,0
10274,6934,6937,21,15,1,0,0,1,0,1,-1,0,2,0
10275,6934,6937,48,7,1,0,1,0,1,1,0,1,1,1
10276,6934,6937,52,17,1,0,0,1,0,3,-3,0,2,0
10277,6934,6937,57,4,1,1,0,0,2,1,1,2,0,3
10278,6934,6937,43,13,1,0,0,1,1,2,-1,0,2,0
10279,6934,6937,22,17,1,0,0,1,0,3,-3,0,2,0
10280,6934,6937,12,4,1,1,0,0,2,1,1,2,0,3
10281,6934,6937,53,7,1,0,1,0,1,1,0,1,1,1
10282,6934,6937,37,1,1,1,0,0,3,0,3,2,0,3
10283,6934,6937,49,7,1,0,1,0,1,1,0,1,1,1
10284,6934,6937,8,7,1,0,1,0,1,1,0,1,1,1
10285,6934,6937,19,7,1,0,1,0,1,1,0,1,1,1
10286,6934,6937,17,13,1,0,0,1,1,2,-1,0,2,0
10287,7169,7175,21,13,31,9,8,14,39,41,-2,26,36,35
10288,7169,7175,17,6,31,16,4,11,62,40,22,36,26,52
10289,7169,7175,19,7,31,12,8,11,44,39,5,32,30,44
10290,7169,7175,8,15,31,8,7,16,30,48,-18,23,39,31
10291,7169,7175,49,2,31,19,7,5,75,29,46,45,17,64
10292,7169,7175,37,9,31,11,10,10,36,38,-2,32,30,43
10293,7169,7175,41,8,31,12,7,12,47,42,5,31,31,43
10294,7169,7175,20,12,31,9,11,11,31,39,-8,29,33,38
10295,7169,7175,43,5,31,16,5,10,60,31,29,37,25,53
10296,7169,7175,57,10,31,12,6,13,47,53,-6,30,32,42
10297,7169,7175,22,11,31,10,11,10,32,58,-26,31,31,41
10298,7169,7175,27,17,31,7,5,19,19,63,-44,19,43,26
10299,7169,7175,59,18,31,2,5,24,18,82,-64,9,53,11
10300,7169,7175,12,4,31,17,5,9,54,26,28,39,23,56
10301,7169,7175,53,14,31,8,10,13,35,45,-10,26,36,34
10302,7169,7175,52,3,31,17,9,5,50,26,24,43,19,60
10303,7169,7175,48,16,31,6,11,14,36,54,-18,23,39,29
10304,7169,7175,1,1,31,21,5,5,68,29,39,47,15,68
10305,7456,7462,1,6,20,9,3,8,40,30,10,21,19,30
10306,7456,7462,12,4,20,10,4,6,39,21,18,24,16,34
10307,7456,7462,53,18,20,3,4,13,17,33,-16,10,30,13
10308,7456,7462,43,1,20,16,2,2,39,12,27,34,6,50
10309,7456,7462,22,7,20,9,2,9,25,30,-5,20,20,29
10310,7456,7462,57,13,20,6,5,9,31,39,-8,17,23,23
10311,7456,7462,20,10,20,7,6,7,24,25,-1,20,20,27
10312,7456,7462,56,12,20,7,4,9,24,31,-7,18,22,25
10313,7456,7462,41,14,20,5,4,11,30,32,-2,14,26,19
10314,7456,7462,37,2,20,13,4,3,35,15,20,30,10,43
10315,7456,7462,49,3,20,11,5,4,39,24,15,27,13,38
10316,7456,7462,52,5,20,10,3,7,30,29,1,23,17,33
10317,7456,7462,48,15,20,4,7,9,20,45,-25,15,25,19
10318,7456,7462,17,8,20,7,8,5,34,26,8,22,18,29
10319,7456,7462,8,16,20,5,3,12,26,44,-18,13,27,18
10320,7456,7462,19,17,20,5,2,13,33,51,-18,12,28,17
10321,7456,7462,21,9,20,7,7,6,27,31,-4,21,19,28
10322,7456,7462,4,11,20,7,5,8,34,29,5,19,21,26
10323,7561,7658,4,9,34,12,8,14,49,49,0,32,36,44
10324,7561,7658,21,10,34,11,11,12,42,53,-11,33,35,44
10325,7561,7658,52,7,34,14,7,13,49,50,-1,35,33,49
10326,7561,7658,48,18,34,5,9,20,29,90,-61,19,49,24
10327,7561,7658,43,1,34,26,5,3,83,24,59,57,11,83
10328,7561,7658,22,5,34,16,6,12,46,43,3,38,30,54
10329,7561,7658,57,14,34,11,7,16,51,68,-17,29,39,40
10330,7561,7658,49,3,34,18,6,10,65,45,20,42,26,60
10331,7561,7658,37,4,34,16,9,9,48,31,17,41,27,57
10332,7561,7658,20,11,34,11,10,13,40,47,-7,32,36,43
10333,7561,7658,41,12,34,11,9,14,53,44,9,31,37,42
10334,7561,7658,56,13,34,11,8,15,42,55,-13,30,38,41
10335,7561,7658,1,6,34,16,5,13,74,56,18,37,31,53
10336,7561,7658,12,2,34,20,6,8,74,36,38,46,22,66
10337,7561,7658,53,15,34,10,6,18,42,55,-13,26,42,36
10338,7561,7658,17,8,34,12,11,11,58,49,9,35,33,47
10339,7561,7658,19,16,34,10,5,19,54,77,-23,25,43,35
10340,7561,7658,8,17,34,8,8,18,35,62,-27,24,44,32
10341,7897,7903,1,16,31,8,8,15,37,45,-8,24,38,32
10342,7897,7903,49,2,31,16,10,5,54,27,27,42,20,58
10343,6574,6576,27,9,2,1,0,1,2,2,0,2,2,3
10344,6581,6594,27,9,4,2,0,2,7,10,-3,4,4,6
10345,6581,6594,53,6,4,2,1,1,6,2,4,5,3,7
10346,6581,6594,12,13,4,1,1,2,2,5,-3,3,5,4
10347,6581,6594,21,3,4,3,0,1,7,2,5,6,2,9
10348,6581,6594,1,12,4,1,1,2,4,6,-2,3,5,4
10349,6581,6594,52,14,4,1,0,3,2,6,-4,2,6,3
10350,6581,6594,48,18,4,0,2,2,1,7,-6,2,6,2
10351,6581,6594,43,1,4,3,0,1,12,6,6,6,2,9
10352,6581,6594,40,10,4,1,2,1,7,5,2,4,4,5
10353,6581,6594,22,16,4,0,2,2,2,5,-3,2,6,2
10354,6581,6594,37,5,4,2,1,1,9,3,6,5,3,7
10355,6581,6594,49,11,4,1,2,1,4,4,0,4,4,5
10356,6581,6594,20,7,4,2,1,1,5,5,0,5,3,7
10357,6581,6594,41,15,4,1,0,3,3,8,-5,2,6,3
10358,6581,6594,56,16,4,0,2,2,2,5,-3,2,6,2
10359,6581,6594,17,2,4,3,0,1,8,3,5,6,2,9
10360,6581,6594,19,4,4,2,2,0,3,0,3,6,2,8
10361,6581,6594,8,8,4,2,1,1,3,5,-2,5,3,7
10362,6987,6993,20,11,10,2,6,2,9,11,-2,10,10,12
10363,6987,6993,41,13,10,2,3,5,12,18,-6,7,13,9
10364,6987,6993,57,4,10,6,2,2,18,13,5,14,6,20
10365,6987,6993,43,7,10,5,1,4,22,14,8,11,9,16
10366,6987,6993,22,10,10,3,3,4,10,15,-5,9,11,12
10367,6987,6993,52,3,10,6,3,1,13,7,6,15,5,21
10368,6987,6993,48,14,10,1,6,3,12,15,-3,8,12,9
10369,6987,6993,49,6,10,5,3,2,22,14,8,13,7,18
10370,6987,6993,37,8,10,3,4,3,12,14,-2,10,10,13
10371,6987,6993,17,9,10,4,0,6,18,18,0,8,12,12
10372,6987,6993,19,17,10,1,4,5,9,18,-9,6,14,7
10373,6987,6993,8,18,10,1,2,7,10,15,-5,4,16,5
10374,6987,6993,21,16,10,1,4,5,7,11,-4,6,14,7
10375,6987,6993,12,1,10,7,2,1,16,5,11,16,4,23
10376,6987,6993,53,5,10,5,5,0,13,8,5,15,5,20
10377,6987,6993,27,12,10,3,1,6,6,17,-11,7,13,10
10378,6987,6993,59,15,10,2,2,6,8,18,-10,6,14,8
10379,6987,6993,1,2,10,7,1,2,20,6,14,15,5,22
10380,7372,7378,1,7,11,5,2,4,20,16,4,12,10,17
10381,7372,7378,21,13,11,3,4,4,12,22,-10,10,12,13
10382,7372,7378,4,14,11,3,3,5,10,15,-5,9,13,12
10383,7372,7378,19,12,11,4,1,6,20,25,-5,9,13,13
10384,7372,7378,8,16,11,2,3,6,13,25,-12,7,15,9
10385,7372,7378,52,5,11,6,2,3,16,15,1,14,8,20
10386,7372,7378,48,10,11,4,3,4,14,18,-4,11,11,15
10387,7372,7378,37,2,11,7,2,2,21,9,12,16,6,23
10388,7372,7378,49,4,11,6,3,2,27,15,12,15,7,21
10389,7372,7378,43,1,11,9,1,1,30,9,21,19,3,28
10390,7372,7378,22,9,11,5,0,6,16,18,-2,10,12,15
10391,7372,7378,57,15,11,3,2,6,18,27,-9,8,14,11
10392,7372,7378,12,3,11,7,1,3,20,9,11,15,7,22
10393,7372,7378,53,17,11,2,1,8,11,22,-11,5,17,7
10394,7372,7378,56,6,11,6,1,4,19,15,4,13,9,19
10395,7372,7378,20,11,11,4,2,5,16,17,-1,10,12,14
10396,7372,7378,41,18,11,1,1,9,12,22,-10,3,19,4
10397,7372,7378,17,8,11,4,4,3,20,16,4,12,10,16
10398,7435,7441,21,7,17,7,5,5,26,29,-3,19,15,26
10399,7435,7441,4,12,17,6,4,7,27,23,4,16,18,22
10400,7435,7441,20,8,17,7,3,7,23,24,-1,17,17,24
10401,7435,7441,56,9,17,7,3,7,24,26,-2,17,17,24
10402,7435,7441,41,16,17,3,3,11,21,29,-8,9,25,12
10403,7435,7441,43,1,17,14,1,2,36,12,24,29,5,43
10404,7435,7441,22,11,17,7,2,8,21,23,-2,16,18,23
10405,7435,7441,57,13,17,6,4,7,27,33,-6,16,18,22
10406,7435,7441,12,4,17,9,2,6,27,18,9,20,14,29
10407,7435,7441,53,18,17,3,2,12,14,29,-15,8,26,11
10408,7435,7441,37,2,17,12,3,2,32,11,21,27,7,39
10409,7435,7441,49,3,17,9,5,3,35,21,14,23,11,32
10410,7435,7441,52,6,17,8,2,7,24,27,-3,18,16,26
10411,7435,7441,48,14,17,4,6,7,18,30,-12,14,20,18
10412,7435,7441,17,10,17,6,6,5,30,24,6,18,16,24
10413,7435,7441,19,15,17,5,2,10,29,41,-12,12,22,17
10414,7435,7441,8,17,17,3,3,11,19,41,-22,9,25,12
10415,7435,7441,1,5,17,8,2,7,35,27,8,18,16,26
10416,7533,7539,1,5,30,15,4,11,68,47,21,34,26,49
10417,7533,7539,12,2,30,17,6,7,63,32,31,40,20,57
10418,7533,7539,53,16,30,8,6,16,33,47,-14,22,38,30
10419,7533,7539,17,9,30,10,11,9,53,45,8,31,29,41
10420,7533,7539,19,15,30,9,4,17,46,67,-21,22,38,31
10421,7533,7539,8,17,30,7,7,16,33,57,-24,21,39,28
10422,7533,7539,4,8,30,11,8,11,45,41,4,30,30,41
10423,3354,3360,39,11,10,2,4,4,6,12,-6,8,12,10
10424,3354,3360,27,14,10,2,2,6,10,16,-6,6,14,8
10425,3361,3367,27,11,11,3,2,6,11,16,-5,8,14,11
10426,3361,3367,39,12,11,2,5,4,8,14,-6,9,13,11
10427,3361,3367,49,1,11,7,3,1,21,7,14,17,5,24
10428,3361,3367,37,6,11,5,4,2,16,10,6,14,8,19
10429,3361,3367,5,16,11,2,3,6,9,21,-12,7,15,9
10430,3361,3367,17,5,11,5,4,2,14,7,7,14,8,19
10431,3361,3367,8,14,11,2,4,5,8,14,-6,8,14,10
10432,3361,3367,20,7,11,3,5,3,13,19,-6,11,11,14
10433,3361,3367,41,13,11,3,1,7,15,18,-3,7,15,10
10434,3361,3367,26,15,11,2,3,6,10,21,-11,7,15,9
10435,3361,3367,43,8,11,3,4,4,18,11,7,10,12,13
10436,3361,3367,28,9,11,3,4,4,12,17,-5,10,12,13
10437,3361,3367,52,10,11,3,4,4,15,21,-6,10,12,13
10438,3361,3367,53,4,11,6,2,3,14,5,9,14,8,20
10439,3361,3367,4,3,11,6,2,3,21,12,9,14,8,20
10440,3361,3367,1,2,11,7,2,2,22,14,8,16,6,23
10441,3410,3416,1,2,17,11,2,4,34,21,13,24,10,35
10442,3410,3416,4,3,17,10,3,4,30,17,13,23,11,33
10443,3410,3416,53,5,17,8,4,5,21,12,9,20,14,28
10444,3410,3416,52,9,17,5,5,7,21,29,-8,15,19,20
10445,3410,3416,28,11,17,5,4,8,25,30,-5,14,20,19
10446,3410,3416,43,8,17,7,5,5,35,16,19,19,15,26
10447,3410,3416,26,15,17,3,4,10,16,38,-22,10,24,13
10448,3410,3416,20,10,17,5,5,7,18,33,-15,15,19,20
10449,3410,3416,41,14,17,3,4,10,18,27,-9,10,24,13
10450,3410,3416,17,6,17,7,6,4,23,15,8,20,14,27
10451,3410,3416,8,16,17,2,6,9,16,27,-11,10,24,12
10452,3410,3416,49,1,17,11,4,2,33,13,20,26,8,37
10453,3410,3416,37,4,17,8,5,4,23,18,5,21,13,29
10454,3410,3416,5,13,17,4,5,8,18,31,-13,13,21,17
10455,3410,3416,27,7,17,8,2,7,26,21,5,18,16,26
10456,3410,3416,39,12,17,4,6,7,16,25,-9,14,20,18
10457,3522,3654,27,8,30,13,3,14,42,43,-1,29,31,42
10458,3522,3654,39,14,30,6,10,14,26,45,-19,22,38,28
10459,3522,3654,49,1,30,22,5,3,64,24,40,49,11,71
10460,3522,3654,37,5,30,14,8,8,45,29,16,36,24,50
10461,3522,3654,5,16,30,4,7,19,24,66,-42,15,45,19
10462,3522,3654,17,7,30,12,8,10,39,42,-3,32,28,44
10463,3522,3654,8,15,30,4,10,16,27,49,-22,18,42,22
10464,3522,3654,43,4,30,15,6,9,64,29,35,36,24,51
10465,3522,3654,26,13,30,8,7,15,29,50,-21,23,37,31
10466,3522,3654,20,10,30,8,9,13,35,51,-16,25,35,33
10467,3522,3654,41,11,30,8,7,15,34,44,-10,23,37,31
10468,3522,3654,53,6,30,14,7,9,42,26,16,35,25,49
10469,3522,3654,52,9,30,10,10,10,36,41,-5,30,30,40
10470,3522,3654,28,12,30,8,7,15,36,57,-21,23,37,31
10471,3522,3654,4,3,30,16,7,7,49,35,14,39,21,55
10472,3522,3654,1,2,30,20,5,5,75,36,39,45,15,65
10473,3319,3325,1,2,5,4,0,1,9,8,1,8,2,12
10474,3319,3325,4,6,5,3,1,1,10,7,3,7,3,10
10475,3319,3325,53,5,5,3,1,1,8,3,5,7,3,10
10476,3319,3325,20,9,5,1,3,1,7,11,-4,5,5,6
10477,3319,3325,41,15,5,1,0,4,6,7,-1,2,8,3
10478,3319,3325,17,8,5,2,2,1,6,2,4,6,4,8
10479,3319,3325,8,12,5,1,1,3,4,9,-5,3,7,4
10480,3319,3325,49,1,5,4,0,1,8,5,3,8,2,12
10481,3319,3325,37,4,5,3,1,1,11,6,5,7,3,10
10482,3319,3325,5,14,5,1,1,3,4,12,-8,3,7,4
10483,3319,3325,52,7,5,2,2,1,12,7,5,6,4,8
10484,3319,3325,28,12,5,1,1,3,4,9,-5,3,7,4
10485,3319,3325,43,3,5,3,1,1,15,5,10,7,3,10
10486,3319,3325,26,11,5,1,1,3,5,9,-4,3,7,4
10487,3319,3325,39,10,5,1,2,2,4,7,-3,4,6,5
10488,3319,3325,27,16,5,0,1,4,4,10,-6,1,9,1
10489,3781,3787,39,11,16,5,4,7,20,24,-4,14,18,19
10490,3781,3787,27,15,16,2,4,10,16,33,-17,8,24,10
10491,3781,3787,52,9,16,5,6,5,20,20,0,16,16,21
10492,3781,3787,28,10,16,5,5,6,21,25,-4,15,17,20
10493,3781,3787,36,14,16,2,8,6,13,22,-9,12,20,14
10494,3781,3787,49,1,16,11,4,1,35,11,24,26,6,37
10495,3781,3787,37,6,16,6,5,5,14,15,-1,17,15,23
10496,3781,3787,20,7,16,5,8,3,19,11,8,18,14,23
10497,3781,3787,43,2,16,11,1,4,32,15,17,23,9,34
10498,3781,3787,26,12,16,4,5,7,14,22,-8,13,19,17
10499,3781,3787,41,13,16,4,5,7,10,20,-10,13,19,17
10500,3781,3787,21,8,16,6,3,7,18,20,-2,15,17,21
10501,3781,3787,4,16,16,2,3,11,12,30,-18,7,25,9
10502,10326,10332,24,1,18,13,4,1,34,13,21,30,6,43
10503,10326,10332,43,2,18,13,3,2,44,16,28,29,7,42
10504,10326,10332,57,17,18,3,4,11,18,30,-12,10,26,13
10505,10326,10332,22,18,18,2,6,10,10,37,-27,10,26,12
10506,10326,10332,41,3,18,10,6,2,39,14,25,26,10,36
10507,10326,10332,56,7,18,7,5,6,31,25,6,19,17,26
10508,10326,10332,20,8,18,7,3,8,26,28,-2,17,19,24
10509,10326,10332,1,4,18,10,4,4,39,19,20,24,12,34
10510,10326,10332,27,11,18,4,7,7,17,29,-12,15,21,19
10511,10326,10332,17,16,18,4,5,9,13,28,-15,13,23,17
10512,10326,10332,28,5,18,9,4,5,23,23,0,22,14,31
10513,10326,10332,52,12,18,5,3,10,16,29,-13,13,23,18
10514,10326,10332,54,15,18,4,5,9,22,32,-10,13,23,17
10515,10326,10332,49,9,18,6,6,6,25,26,-1,18,18,24
10516,10326,10332,37,14,18,4,5,9,19,26,-7,13,23,17
10517,10326,10332,21,6,18,8,7,3,34,24,10,23,13,31
10518,10326,10332,12,10,18,5,5,8,23,26,-3,15,21,20
10519,10326,10332,53,13,18,4,6,8,20,28,-8,14,22,18
10520,10403,10409,21,5,23,11,8,4,44,27,17,30,16,41
10521,10403,10409,41,3,23,12,8,3,47,16,31,32,14,44
10522,10403,10409,20,7,23,10,3,10,37,35,2,23,23,33
10523,10403,10409,56,9,23,7,10,6,38,32,6,24,22,31
10524,10403,10409,49,6,23,10,6,7,33,29,4,26,20,36
10525,10403,10409,37,10,23,8,5,10,26,31,-5,21,25,29
10526,10403,10409,28,8,23,9,6,8,25,32,-7,24,22,33
10527,10403,10409,54,12,23,6,5,12,25,41,-16,17,29,23
10528,10403,10409,52,16,23,6,3,14,20,43,-23,15,31,21
10529,10403,10409,12,13,23,5,8,10,27,34,-7,18,28,23
10530,10403,10409,53,15,23,5,7,11,26,39,-13,17,29,22
10531,10403,10409,17,11,23,6,6,11,16,34,-18,18,28,24
10532,10403,10409,27,14,23,4,11,8,19,34,-15,19,27,23
10533,10403,10409,1,4,23,11,8,4,44,23,21,30,16,41
10534,10403,10409,24,1,23,18,4,1,49,14,35,40,6,58
10535,10403,10409,43,2,23,15,6,2,57,22,35,36,10,51
10536,10403,10409,57,17,23,4,5,14,22,36,-14,13,33,17
10537,10403,10409,22,18,23,2,7,14,14,47,-33,11,35,13
10538,10417,10423,24,1,25,19,5,1,50,14,36,43,7,62
10539,10417,10423,43,2,25,16,6,3,62,25,37,38,12,54
10540,10417,10423,57,17,25,5,6,14,25,37,-12,16,34,21
10541,10417,10423,22,18,25,2,8,15,15,49,-34,12,38,14
10542,10417,10423,1,5,25,12,8,5,48,29,19,32,18,44
10543,10417,10423,27,13,25,5,11,9,22,39,-17,21,29,26
10544,10417,10423,17,11,25,7,6,12,18,37,-19,20,30,27
10545,10417,10423,12,12,25,6,8,11,32,41,-9,20,30,26
10546,10417,10423,53,16,25,5,8,12,27,42,-15,18,32,23
10547,10417,10423,28,7,25,10,6,9,32,37,-5,26,24,36
10548,10417,10423,52,14,25,7,3,15,23,47,-24,17,33,24
10549,10417,10423,54,15,25,6,5,14,26,47,-21,17,33,23
10550,10417,10423,49,6,25,12,6,7,38,30,8,30,20,42
10551,10417,10423,37,10,25,9,5,11,31,34,-3,23,27,32
10552,10417,10423,41,3,25,13,8,4,49,17,32,34,16,47
10553,10417,10423,20,8,25,10,4,11,39,38,1,24,26,34
10554,10417,10423,56,9,25,7,12,6,38,32,6,26,24,33
10555,10417,10423,21,4,25,12,9,4,48,28,20,33,17,45
10556,10669,10675,21,5,13,6,5,2,26,13,13,17,9,23
10557,10669,10675,4,7,13,5,4,4,16,15,1,14,12,19
10558,10669,10675,49,6,13,5,5,3,18,12,6,15,11,20
10559,10669,10675,37,9,13,5,3,5,16,21,-5,13,13,18
10560,10669,10675,27,12,13,5,1,7,15,16,-1,11,15,16
10561,10669,10675,12,8,13,5,4,4,16,18,-2,14,12,19
10562,10669,10675,53,16,13,2,5,6,9,22,-13,9,17,11
10563,10669,10675,28,17,13,1,5,7,7,22,-15,7,19,8
10564,10669,10675,54,18,13,1,3,9,10,24,-14,5,21,6
10565,10669,10675,17,13,13,4,4,5,15,23,-8,12,14,16
10566,10669,10675,1,2,13,8,3,2,23,13,10,19,7,27
10567,10669,10675,43,1,13,8,3,2,28,7,21,19,7,27
10568,10669,10675,24,3,13,7,6,0,24,4,20,20,6,27
10569,10669,10675,57,4,13,7,3,3,19,13,6,17,9,24
10570,10669,10675,56,9,13,5,3,5,16,21,-5,13,13,18
10571,10669,10675,35,11,13,5,1,7,19,20,-1,11,15,16
10572,10669,10675,41,14,13,4,2,7,11,13,-2,10,16,14
10573,10669,10675,20,15,13,3,2,8,14,25,-11,8,18,11
10574,10781,10787,35,10,25,9,3,13,31,39,-8,21,29,30
10575,10781,10787,56,12,25,7,7,11,28,38,-10,21,29,28
10576,10781,10787,41,14,25,6,9,10,22,30,-8,21,29,27
10577,10781,10787,20,18,25,4,7,14,24,51,-27,15,35,19
10578,10781,10787,37,16,25,5,4,16,19,48,-29,14,36,19
10579,10781,10787,49,5,25,11,8,6,37,23,14,30,20,41
10580,7897,7903,37,6,31,13,9,9,39,27,12,35,27,48
10581,7897,7903,52,10,31,11,5,15,38,41,-3,27,35,38
10582,7897,7903,3,15,31,9,8,14,33,51,-18,26,36,35
10583,7897,7903,12,5,31,14,10,7,51,30,21,38,24,52
10584,7897,7903,56,7,31,13,9,9,38,32,6,35,27,48
10585,7897,7903,20,9,31,10,9,12,29,30,-1,29,33,39
10586,7897,7903,41,14,31,9,8,14,34,45,-11,26,36,35
10587,7897,7903,43,1,31,17,7,7,51,30,21,41,21,58
10588,7897,7903,22,12,31,9,9,13,23,42,-19,27,35,36
10589,7897,7903,57,13,31,9,8,14,52,55,-3,26,36,35
10590,7897,7903,24,18,31,6,5,20,27,57,-30,17,45,23
10591,7897,7903,21,3,31,16,8,7,43,21,22,40,22,56
10592,7897,7903,4,4,31,14,12,5,35,19,16,40,22,54
10593,7897,7903,17,8,31,13,7,11,43,46,-3,33,29,46
10594,7897,7903,19,11,31,10,8,13,38,48,-10,28,34,38
10595,7897,7903,8,17,31,8,8,15,27,46,-19,24,38,32
10596,8079,8085,19,7,10,4,4,2,12,10,2,12,8,16
10597,8079,8085,17,9,10,4,2,4,10,15,-5,10,10,14
10598,8079,8085,21,6,10,5,2,3,13,11,2,12,8,17
10599,8079,8085,4,10,10,3,5,2,13,11,2,11,9,14
10600,8079,8085,56,11,10,3,4,3,10,11,-1,10,10,13
10601,8079,8085,20,13,10,3,1,6,9,14,-5,7,13,10
10602,8079,8085,41,14,10,2,4,4,7,19,-12,8,12,10
10603,8079,8085,13,15,10,1,6,3,10,14,-4,8,12,9
10604,8079,8085,43,5,10,5,2,3,17,13,4,12,8,17
10605,8079,8085,57,17,10,1,3,6,13,18,-5,5,15,6
10606,8079,8085,22,18,10,1,3,6,9,18,-9,5,15,6
10607,8079,8085,49,2,10,6,1,3,27,13,14,13,7,19
10608,8079,8085,37,3,10,5,4,1,23,6,17,14,6,19
10609,8079,8085,52,12,10,3,3,4,12,14,-2,9,11,12
10610,8079,8085,3,16,10,2,2,6,12,19,-7,6,14,8
10611,8079,8085,12,4,10,5,3,2,13,9,4,13,7,18
10612,8079,8085,53,8,10,4,3,3,17,18,-1,11,9,15
10613,8079,8085,1,1,10,6,2,2,15,9,6,14,6,20
10614,8198,8204,1,4,22,11,6,5,36,24,12,28,16,39
10615,8198,8204,17,11,22,7,4,11,21,33,-12,18,26,25
10616,8198,8204,19,5,22,10,7,5,36,27,9,27,17,37
10617,8198,8204,12,6,22,10,6,6,29,21,8,26,18,36
10618,8198,8204,53,13,22,6,7,9,29,41,-12,19,25,25
10619,8198,8204,52,9,22,7,9,6,24,21,3,23,21,30
10620,8198,8204,3,18,22,3,5,14,24,45,-21,11,33,14
10621,8198,8204,49,3,22,12,6,4,50,25,25,30,14,42
10622,8198,8204,37,7,22,9,8,5,46,22,24,26,18,35
10623,8198,8204,43,1,22,13,6,3,48,24,24,32,12,45
10624,8198,8204,57,12,22,6,7,9,26,32,-6,19,25,25
10625,8198,8204,22,17,22,3,6,13,22,36,-14,12,32,15
10626,8198,8204,21,2,22,13,4,5,34,22,12,30,14,43
10627,8198,8204,4,8,22,8,9,5,32,28,4,25,19,33
10628,8198,8204,56,10,22,7,9,6,25,27,-2,23,21,30
10629,8198,8204,41,14,22,4,9,9,18,40,-22,17,27,21
10630,8198,8204,20,15,22,5,5,12,26,36,-10,15,29,20
10631,8198,8204,13,16,22,2,11,9,23,45,-22,15,29,17
10632,8247,8253,56,10,27,8,9,10,32,37,-5,25,29,33
10633,8247,8253,41,14,27,6,10,11,24,44,-20,22,32,28
10634,8247,8253,20,15,27,6,6,15,30,44,-14,18,36,24
10635,8247,8253,13,16,27,3,11,13,27,58,-31,17,37,20
10636,8247,8253,21,3,27,16,5,6,43,26,17,37,17,53
10637,8247,8253,4,6,27,12,10,5,43,32,11,34,20,46
10638,8247,8253,22,18,27,3,9,15,26,48,-22,15,39,18
10639,8247,8253,43,1,27,16,7,4,60,29,31,39,15,55
10640,8247,8253,57,13,27,6,10,11,31,40,-9,22,32,28
10641,8247,8253,52,9,27,9,10,8,29,26,3,28,26,37
10642,8247,8253,3,17,27,4,6,17,27,54,-27,14,40,18
10643,8247,8253,12,8,27,12,7,8,37,25,12,31,23,43
10644,8247,8253,53,11,27,8,7,12,37,47,-10,23,31,31
10645,8247,8253,49,2,27,16,6,5,60,30,30,38,16,54
10646,8247,8253,37,7,27,12,9,6,57,30,27,33,21,45
10647,8247,8253,1,4,27,13,8,6,45,34,11,34,20,47
10648,8247,8253,19,5,27,13,8,6,42,32,10,34,20,47
10649,8247,8253,17,12,27,8,6,13,26,40,-14,22,32,30
10650,8387,8396,1,4,2,1,1,0,3,2,1,3,1,4
10651,8387,8396,12,3,2,1,1,0,5,2,3,3,1,4
10652,8387,8396,53,4,2,1,1,0,3,2,1,3,1,4
10653,8387,8396,52,14,2,0,1,1,0,3,-3,1,3,1
10654,8387,8396,43,9,2,1,0,1,3,3,0,2,2,3
10655,8387,8396,57,10,2,1,0,1,1,1,0,2,2,3
10656,8387,8396,24,12,2,0,2,0,2,2,0,2,2,2
10657,8387,8396,49,1,2,2,0,0,5,0,5,4,0,6
10658,8387,8396,37,4,2,1,1,0,3,2,1,3,1,4
10659,9605,9611,41,7,16,8,4,4,23,15,8,20,12,28
10660,9605,9611,20,10,16,6,2,8,21,27,-6,14,18,20
10661,9605,9611,13,13,16,4,3,9,17,27,-10,11,21,15
10662,9605,9611,56,16,16,3,3,10,16,26,-10,9,23,12
10663,9605,9611,37,5,16,7,9,0,22,10,12,23,9,30
10664,9605,9611,49,8,16,6,5,5,24,15,9,17,15,23
10665,9605,9611,4,14,16,4,2,10,12,30,-18,10,22,14
10666,9605,9611,21,17,16,2,4,10,15,28,-13,8,24,10
10667,9605,9611,27,6,16,9,2,5,22,19,3,20,12,29
10668,9605,9611,12,4,16,9,5,2,25,16,9,23,9,32
10669,9605,9611,52,15,16,3,4,9,16,30,-14,10,22,13
10670,9605,9611,48,18,16,1,4,11,7,37,-30,6,26,7
10671,9605,9611,2,11,16,5,4,7,18,24,-6,14,18,19
10672,9605,9611,57,12,16,4,4,8,21,20,1,12,20,16
10673,9703,9709,52,16,25,4,9,12,23,40,-17,17,33,21
10674,9703,9709,48,18,25,4,6,15,16,57,-41,14,36,18
10675,9703,9709,12,5,25,12,8,5,38,29,9,32,18,44
10676,9703,9709,53,9,25,8,9,8,24,26,-2,25,25,33
10677,9703,9709,27,6,25,11,6,8,35,31,4,28,22,39
10678,9703,9709,21,14,25,5,7,13,25,36,-11,17,33,22
10679,9703,9709,4,15,25,5,7,13,20,41,-21,17,33,22
10680,9703,9709,1,3,25,15,6,4,49,21,28,36,14,51
10681,9703,9709,37,4,25,11,12,2,34,18,16,34,16,45
10682,9703,9709,49,10,25,8,8,9,31,23,8,24,26,32
10683,9703,9709,41,7,25,11,5,9,31,27,4,27,23,38
10684,9703,9709,20,8,25,10,5,10,33,34,-1,25,25,35
10685,9703,9709,56,13,25,6,5,14,27,39,-12,17,33,23
10686,9703,9709,13,17,25,4,6,15,23,48,-25,14,36,18
10687,9703,9709,43,1,25,18,5,2,63,21,42,41,9,59
10688,9703,9709,24,2,25,18,5,2,41,10,31,41,9,59
10689,9703,9709,57,11,25,7,7,11,29,28,1,21,29,28
10690,9703,9709,2,12,25,6,8,11,24,37,-13,20,30,26
10691,9717,9723,43,1,27,19,6,2,66,23,43,44,10,63
10692,9717,9723,24,2,27,18,7,2,42,11,31,43,11,61
10693,9717,9723,37,5,27,11,13,3,35,20,15,35,19,46
10694,9717,9723,49,10,27,8,9,10,33,26,7,25,29,33
10695,9717,9723,41,6,27,12,6,9,36,31,5,30,24,42
10696,9717,9723,20,9,27,11,5,11,39,36,3,27,27,38
10697,9717,9723,56,13,27,7,6,14,31,40,-9,20,34,27
10698,9717,9723,13,17,27,5,6,16,26,53,-27,16,38,21
10699,9717,9723,2,11,27,8,8,11,27,38,-11,24,30,32
10700,9717,9723,57,12,27,7,8,12,29,33,-4,22,32,29
10701,9717,9723,1,3,27,15,7,5,52,25,27,37,17,52
10702,9717,9723,4,14,27,6,7,14,22,43,-21,19,35,25
10703,9717,9723,21,16,27,5,8,14,28,40,-12,18,36,23
10704,9717,9723,27,7,27,12,6,9,39,35,4,30,24,42
10705,9717,9723,12,4,27,13,8,6,43,32,11,34,20,47
10706,9717,9723,53,8,27,10,9,8,28,26,2,29,25,39
10707,9717,9723,52,15,27,5,9,13,26,45,-19,19,35,24
10708,9717,9723,48,18,27,4,6,17,17,62,-45,14,40,18
10709,9535,9541,12,7,7,2,4,1,7,7,0,8,6,10
10710,9535,9541,53,8,7,2,4,1,6,8,-2,8,6,10
10711,9535,9541,27,13,7,2,2,3,8,13,-5,6,8,8
10712,9535,9541,52,12,7,2,2,3,9,11,-2,6,8,8
10713,9535,9541,48,18,7,0,2,5,3,19,-16,2,12,2
10714,9535,9541,20,6,7,3,1,3,8,15,-7,7,7,10
10715,9535,9541,41,9,7,2,3,2,9,9,0,7,7,9
10716,9535,9541,13,10,7,2,3,2,8,9,-1,7,7,9
10717,9535,9541,56,11,7,2,2,3,12,9,3,6,8,8
10718,9535,9541,49,3,7,4,2,1,13,3,10,10,4,14
10719,9535,9541,37,5,7,3,4,0,12,4,8,10,4,13
10720,9535,9541,4,15,7,2,1,4,5,14,-9,5,9,7
10721,9535,9541,21,17,7,0,3,4,3,9,-6,3,11,3
10722,9535,9541,43,2,7,5,1,1,20,4,16,11,3,16
10723,9535,9541,24,4,7,4,2,1,11,4,7,10,4,14
10724,9535,9541,2,13,7,2,2,3,8,13,-5,6,8,8
10725,9535,9541,57,16,7,1,0,6,8,12,-4,2,12,3
10726,9535,9541,1,1,7,5,2,0,19,6,13,12,2,17
10727,10032,10038,1,2,22,15,3,4,52,26,26,33,11,48
10728,10032,10038,24,1,22,16,2,4,37,18,19,34,10,50
10729,10032,10038,43,6,22,9,8,5,36,19,17,26,18,35
10730,10032,10038,57,10,22,8,4,10,31,33,-2,20,24,28
10731,10032,10038,22,17,22,4,4,14,21,57,-36,12,32,16
10732,10032,10038,2,18,22,4,3,15,15,42,-27,11,33,15
10733,10032,10038,21,3,22,13,7,2,51,22,29,33,11,46
10734,10032,10038,4,14,22,7,3,12,21,36,-15,17,27,24
10735,10032,10038,20,4,22,12,4,6,40,26,14,28,16,40
10736,10032,10038,41,5,22,9,10,3,34,21,13,28,16,37
10737,10032,10038,56,16,22,5,5,12,25,47,-22,15,29,20
10738,8992,8995,13,13,28,8,7,13,35,51,-16,23,33,31
10739,8992,8995,56,14,28,7,8,13,35,54,-19,22,34,29
10740,8992,8995,12,9,28,9,8,11,46,49,-3,26,30,35
10741,8992,8995,53,16,28,6,6,16,34,56,-22,18,38,24
10742,8992,8995,11,17,28,4,8,16,30,61,-31,16,40,20
10743,8779,8785,20,4,5,3,0,2,9,8,1,6,4,9
10744,8779,8785,43,1,5,3,2,0,20,6,14,8,2,11
10745,8779,8785,41,5,5,2,2,1,8,5,3,6,4,8
10746,8779,8785,13,11,5,1,3,1,7,8,-1,5,5,6
10747,8779,8785,56,12,5,1,2,2,7,8,-1,4,6,5
10748,8779,8785,24,9,5,1,4,0,10,5,5,6,4,7
10749,8779,8785,57,15,5,0,4,1,4,5,-1,4,6,4
10750,8779,8785,2,18,5,0,1,4,5,17,-12,1,9,1
10751,8779,8785,37,3,5,3,1,1,10,4,6,7,3,10
10752,8779,8785,49,6,5,2,2,1,9,8,1,6,4,8
10753,8779,8785,4,2,5,3,2,0,15,5,10,8,2,11
10754,8779,8785,21,13,5,1,2,2,6,9,-3,4,6,5
10755,8779,8785,1,7,5,2,2,1,7,7,0,6,4,8
10756,8779,8785,19,16,5,0,4,1,1,5,-4,4,6,4
10757,8779,8785,17,17,5,1,0,4,4,12,-8,2,8,3
10758,8779,8785,12,8,5,2,1,2,6,12,-6,5,5,7
10759,8779,8785,11,10,5,1,3,1,5,3,2,5,5,6
10760,8779,8785,53,14,5,1,1,3,6,12,-6,3,7,4
10761,8800,8806,12,6,8,4,1,3,13,16,-3,9,7,13
10762,8800,8806,11,12,8,2,3,3,10,11,-1,7,9,9
10763,8800,8806,53,14,8,2,2,4,9,16,-7,6,10,8
10764,8800,8806,37,4,8,4,1,3,15,9,6,9,7,13
10765,8800,8806,49,13,8,2,3,3,12,14,-2,7,9,9
10766,8800,8806,19,16,8,0,6,2,3,8,-5,6,10,6
10767,8800,8806,17,18,8,1,1,6,4,20,-16,3,13,4
10768,8800,8806,1,2,8,5,2,1,14,9,5,12,4,17
10769,8800,8806,4,3,8,4,3,1,20,9,11,11,5,15
10770,8800,8806,21,9,8,2,4,2,10,10,0,8,8,10
10771,8800,8806,43,1,8,5,3,0,26,7,19,13,3,18
10772,8800,8806,57,10,8,2,4,2,9,10,-1,8,8,10
10773,8800,8806,24,15,8,1,5,2,12,9,3,7,9,8
10774,8800,8806,2,17,8,1,1,6,7,22,-15,3,13,4
10775,8800,8806,20,5,8,4,1,3,13,12,1,9,7,13
10776,8800,8806,41,7,8,3,4,1,15,9,6,10,6,13
10777,8800,8806,13,8,8,3,3,2,11,11,0,9,7,12
10778,8800,8806,56,11,8,2,3,3,11,12,-1,7,9,9
10779,9241,9261,43,2,20,12,6,2,48,21,27,30,10,42
10780,9241,9261,57,8,20,8,5,7,36,30,6,21,19,29
10781,9241,9261,24,12,20,4,10,6,19,28,-9,18,22,22
10782,9241,9261,20,6,20,9,4,7,33,22,11,22,18,31
10783,9241,9261,41,7,20,9,4,7,28,25,3,22,18,31
10784,9241,9261,13,13,20,4,8,8,14,21,-7,16,24,20
10785,9241,9261,56,16,20,4,5,11,19,32,-13,13,27,17
10786,9241,9261,52,17,20,3,7,10,17,33,-16,13,27,16
10787,9241,9261,4,3,20,11,4,5,34,18,16,26,14,37
10788,9241,9261,21,9,20,7,7,6,23,26,-3,21,19,28
10789,9241,9261,37,4,20,10,4,6,33,28,5,24,16,34
10790,9241,9261,49,10,20,6,8,6,25,22,3,20,20,26
10791,9241,9261,1,1,20,15,3,2,45,17,28,33,7,48
10792,9241,9261,27,14,20,5,3,12,24,34,-10,13,27,18
10793,9241,9261,17,15,20,4,6,10,19,34,-15,14,26,18
10794,9241,9261,19,18,20,3,6,11,16,40,-24,12,28,15
10795,9241,9261,53,5,20,9,7,4,32,25,7,25,15,34
10796,9241,9261,12,11,20,6,5,9,26,35,-9,17,23,23
10797,9346,9352,53,8,32,11,13,8,41,40,1,35,29,46
10798,9346,9352,12,13,32,9,8,15,45,63,-18,26,38,35
10799,9346,9352,49,3,32,14,11,7,55,29,26,39,25,53
10800,9346,9352,37,5,32,14,9,9,49,37,12,37,27,51
10801,9346,9352,27,12,32,10,6,16,40,58,-18,26,38,36
10802,9346,9352,52,14,32,8,9,15,34,54,-20,25,39,33
10803,9346,9352,19,17,32,6,9,17,23,55,-32,21,43,27
10804,9346,9352,17,18,32,5,10,17,29,59,-30,20,44,25
10805,9346,9352,1,2,32,20,8,4,68,31,37,48,16,68
10806,9346,9352,4,4,32,14,10,8,48,37,11,38,26,52
10807,9346,9352,21,10,32,10,13,9,35,40,-5,33,31,43
10808,9346,9352,13,16,32,6,11,15,21,37,-16,23,41,29
10809,9346,9352,43,1,32,21,8,3,79,31,48,50,14,71
10810,9346,9352,57,9,32,12,9,11,53,44,9,33,31,45
10811,9346,9352,24,11,32,7,16,9,34,43,-9,30,34,37
10812,9346,9352,41,6,32,14,8,10,42,35,7,36,28,50
10813,9346,9352,20,7,32,14,6,12,47,34,13,34,30,48
10814,9346,9352,56,15,32,7,8,17,35,51,-16,22,42,29
10815,9157,9163,20,4,9,4,3,2,15,5,10,11,7,15
10816,9157,9163,41,7,9,4,1,4,14,13,1,9,9,13
10817,9157,9163,13,12,9,2,5,2,7,8,-1,9,9,11
10818,10781,10787,1,1,25,18,5,2,54,19,35,41,9,59
10819,10781,10787,21,4,25,12,9,4,49,22,27,33,17,45
10820,10781,10787,4,7,25,9,10,6,31,26,5,28,22,37
10821,10781,10787,43,2,25,18,4,3,62,10,52,40,10,58
10822,10781,10787,24,3,25,13,11,1,46,9,37,37,13,50
10823,10781,10787,57,6,25,10,7,8,39,30,9,27,23,37
10824,10781,10787,17,11,25,8,4,13,30,51,-21,20,30,28
10825,10781,10787,28,15,25,6,7,12,19,37,-18,19,31,25
10826,10781,10787,54,17,25,4,7,14,20,41,-21,15,35,19
10827,10781,10787,12,8,25,9,7,9,27,44,-17,25,25,34
10828,10781,10787,53,13,25,7,6,12,24,42,-18,20,30,27
10829,10781,10787,27,9,25,8,7,10,35,37,-2,23,27,31
10830,10599,10605,49,8,4,1,3,0,6,2,4,5,3,6
10831,10599,10605,37,9,4,1,3,0,6,3,3,5,3,6
10832,10599,10605,56,4,4,2,1,1,10,6,4,5,3,7
10833,10599,10605,20,5,4,2,1,1,7,8,-1,5,3,7
10834,10599,10605,41,13,4,1,1,2,2,2,0,3,5,4
10835,10599,10605,35,15,4,1,0,3,3,6,-3,2,6,3
10836,10599,10605,53,12,4,1,2,1,1,4,-3,4,4,5
10837,10599,10605,12,14,4,1,1,2,6,9,-3,3,5,4
10838,10599,10605,27,6,4,2,0,2,7,5,2,4,4,6
10839,10599,10605,24,2,4,3,1,0,8,2,6,7,1,10
10840,10599,10605,57,3,4,3,0,1,6,3,3,6,2,9
10841,10599,10605,28,16,4,0,2,2,2,6,-4,2,6,2
10842,10599,10605,54,18,4,0,0,4,4,10,-6,0,8,0
10843,10599,10605,17,17,4,0,2,2,1,10,-9,2,6,2
10844,10599,10605,1,10,4,1,2,1,7,6,1,4,4,5
10845,10599,10605,4,7,4,2,0,2,6,9,-3,4,4,6
10846,10599,10605,21,11,4,1,2,1,4,4,0,4,4,5
10847,10599,10605,43,1,4,3,1,0,12,3,9,7,1,10
10848,11166,11172,4,2,28,18,7,3,59,28,31,43,13,61
10849,11166,11172,21,7,28,9,12,7,44,34,10,30,26,39
10850,11166,11172,1,4,28,15,9,4,49,21,28,39,17,54
10851,11166,11172,17,14,28,5,9,14,16,37,-21,19,37,24
10852,11166,11172,52,13,28,6,8,14,24,40,-16,20,36,26
10853,11166,11172,28,17,28,4,10,14,20,40,-20,18,38,22
10854,11166,11172,43,1,28,19,6,3,67,19,48,44,12,63
10855,11166,11172,24,3,28,16,8,4,47,23,24,40,16,56
10856,11166,11172,57,11,28,9,6,13,36,55,-19,24,32,33
10857,11166,11172,22,16,28,5,8,15,24,61,-37,18,38,23
10858,11166,11172,27,10,28,7,14,7,27,27,0,28,28,35
10859,11166,11172,12,9,28,9,8,11,35,35,0,26,30,35
10860,11166,11172,53,18,28,5,5,18,29,55,-26,15,41,20
10861,11166,11172,35,6,28,14,6,8,49,35,14,34,22,48
10862,11166,11172,41,8,28,9,9,10,34,35,-1,27,29,36
10863,11166,11172,20,12,28,7,11,10,29,37,-8,25,31,32
10864,11166,11172,56,15,28,6,5,17,30,48,-18,17,39,23
10865,11166,11172,49,5,28,14,9,5,44,33,11,37,19,51
10866,10970,10976,12,17,5,1,0,4,3,8,-5,2,8,3
10867,10970,10976,53,18,5,0,3,2,6,15,-9,3,7,3
10868,10970,10976,4,2,5,4,1,0,13,5,8,9,1,13
10869,10970,10976,21,6,5,2,1,2,6,8,-2,5,5,7
10870,10970,10976,49,1,5,4,1,0,15,4,11,9,1,13
10871,10970,10976,28,13,5,1,2,2,5,8,-3,4,6,5
10872,10970,10976,52,15,5,1,1,3,5,7,-2,3,7,4
10873,10970,10976,17,16,5,1,1,3,4,8,-4,3,7,4
10874,10970,10976,27,4,5,3,1,1,9,4,5,7,3,10
10875,10970,10976,1,3,5,4,1,0,7,1,6,9,1,13
10876,10970,10976,57,7,5,2,1,2,5,8,-3,5,5,7
10877,10970,10976,22,8,5,2,1,2,4,8,-4,5,5,7
10878,10970,10976,24,11,5,1,2,2,9,11,-2,4,6,5
10879,10970,10976,43,12,5,1,2,2,4,6,-2,4,6,5
10880,10970,10976,20,5,5,2,2,1,8,3,5,6,4,8
10881,10970,10976,56,9,5,2,0,3,7,6,1,4,6,6
10882,10970,10976,35,10,5,1,3,1,10,8,2,5,5,6
10883,10970,10976,41,14,5,1,1,3,6,8,-2,3,7,4
10884,11523,11529,35,9,26,9,10,7,35,31,4,28,24,37
10885,11523,11529,20,11,26,9,5,12,38,42,-4,23,29,32
10886,11523,11529,41,15,26,5,10,11,25,34,-9,20,32,25
10887,11523,11529,56,17,26,5,7,14,27,57,-30,17,35,22
10888,11523,11529,1,2,26,14,10,2,46,17,29,38,14,52
10889,11523,11529,27,13,26,6,8,12,21,32,-11,20,32,26
10890,11523,11529,17,7,26,11,6,9,37,36,1,28,24,39
10891,11523,11529,52,12,26,8,6,12,28,36,-8,22,30,30
10892,11523,11529,43,1,26,17,6,3,48,13,35,40,12,57
10893,11523,11529,24,4,26,14,7,5,38,17,21,35,17,49
10894,11523,11529,57,8,26,9,11,6,44,39,5,29,23,38
10895,11523,11529,22,16,26,5,8,13,19,35,-16,18,34,23
10896,11523,11529,34,18,26,2,5,19,11,52,-41,9,43,11
10897,11523,11529,49,3,26,13,11,2,43,19,24,37,15,50
10898,8387,8396,21,8,2,1,1,0,1,0,1,3,1,4
10899,8387,8396,4,16,2,0,0,2,1,4,-3,0,4,0
10900,8387,8396,19,11,2,0,2,0,3,3,0,2,2,2
10901,8387,8396,8,17,2,0,0,2,1,5,-4,0,4,0
10902,8387,8396,17,18,2,0,0,2,0,4,-4,0,4,0
10903,8387,8396,13,2,2,2,0,0,4,0,4,4,0,6
10904,8387,8396,56,7,2,1,1,0,2,1,1,3,1,4
10905,8387,8396,20,13,2,0,1,1,1,2,-1,1,3,1
10906,8387,8396,41,15,2,0,0,2,1,3,-2,0,4,0
10907,8548,8554,19,9,20,7,5,8,29,31,-2,19,21,26
10908,8548,8554,17,13,20,6,3,11,25,35,-10,15,25,21
10909,8548,8554,8,15,20,5,4,11,20,42,-22,14,26,19
10910,8548,8554,13,2,20,12,4,4,41,20,21,28,12,40
10911,8548,8554,20,6,20,8,5,7,30,26,4,21,19,29
10912,8548,8554,56,11,20,6,7,7,22,26,-4,19,21,25
10913,8548,8554,41,12,20,6,5,9,20,27,-7,17,23,23
10914,8548,8554,43,3,20,10,6,4,45,27,18,26,14,36
10915,8548,8554,57,7,20,8,4,8,22,20,2,20,20,28
10916,8548,8554,24,8,20,6,10,4,23,24,-1,22,18,28
10917,8548,8554,12,14,20,5,5,10,20,30,-10,15,25,20
10918,8548,8554,53,16,20,3,9,8,24,41,-17,15,25,18
10919,8548,8554,52,17,20,3,8,9,20,29,-9,14,26,17
10920,8548,8554,37,1,20,15,4,1,41,20,21,34,6,49
10921,8548,8554,49,4,20,10,5,5,32,21,11,25,15,35
10922,8548,8554,21,10,20,6,8,6,30,26,4,20,20,26
10923,8548,8554,4,18,20,4,4,12,20,31,-11,12,28,16
10924,8548,8554,1,5,20,8,8,4,35,23,12,24,16,32
10925,8397,8400,1,8,3,1,1,1,3,3,0,3,3,4
10926,8397,8400,12,2,3,2,1,0,6,2,4,5,1,7
10927,8397,8400,53,12,3,1,1,1,3,7,-4,3,3,4
10928,8397,8400,43,7,3,1,1,1,5,5,0,3,3,4
10929,8397,8400,57,8,3,1,1,1,3,3,0,3,3,4
10930,8397,8400,24,14,3,0,3,0,2,2,0,3,3,3
10931,8397,8400,13,2,3,2,1,0,6,2,4,5,1,7
10932,8397,8400,56,11,3,1,1,1,2,4,-2,3,3,4
10933,8397,8400,41,15,3,0,1,2,3,5,-2,1,5,1
10934,8397,8400,20,16,3,0,1,2,1,3,-2,1,5,1
10935,8397,8400,49,1,3,2,1,0,5,0,5,5,1,7
10936,8397,8400,37,5,3,2,1,0,4,2,2,5,1,7
10937,8397,8400,52,10,3,1,1,1,2,3,-1,3,3,4
10938,8397,8400,19,6,3,1,2,0,6,3,3,4,2,5
10939,8397,8400,17,13,3,1,0,2,5,4,1,2,4,3
10940,8397,8400,8,18,3,0,0,3,1,7,-6,0,6,0
10941,8397,8400,21,4,3,2,1,0,5,2,3,5,1,7
10942,8397,8400,4,17,3,0,0,3,3,8,-5,0,6,0
10943,8653,8659,21,9,33,11,11,11,48,43,5,33,33,44
10944,8653,8659,4,13,33,10,8,15,36,41,-5,28,38,38
10945,8653,8659,13,5,33,15,7,11,60,49,11,37,29,52
10946,8653,8659,20,6,33,13,9,11,49,42,7,35,31,48
10947,8653,8659,19,8,33,13,7,13,44,48,-4,33,33,46
10948,8653,8659,17,14,33,10,8,15,39,56,-17,28,38,38
10949,8653,8659,8,16,33,8,7,18,31,62,-31,23,43,31
10950,8653,8659,52,18,33,6,11,16,32,48,-16,23,43,29
10951,8653,8659,12,10,33,12,7,14,41,47,-6,31,35,43
10952,8653,8659,53,17,33,6,12,15,41,69,-28,24,42,30
10953,8653,8659,24,7,33,11,14,8,44,41,3,36,30,47
10954,8653,8659,57,11,33,11,7,15,33,45,-12,29,37,40
10955,8653,8659,43,2,33,19,7,7,78,38,40,45,21,64
10956,8653,8659,56,12,33,10,9,14,34,43,-9,29,37,39
10957,8653,8659,41,15,33,9,9,15,37,50,-13,27,39,36
10958,8653,8659,37,1,33,21,7,5,57,32,25,49,17,70
10959,8653,8659,49,4,33,17,6,10,55,41,14,40,26,57
10960,8653,8659,1,3,33,17,10,6,72,36,36,44,22,61
10961,8660,8753,1,3,34,17,10,7,73,39,34,44,24,61
10962,8660,8753,37,1,34,22,7,5,59,33,26,51,17,73
10963,8660,8753,49,4,34,17,6,11,55,44,11,40,28,57
10964,8660,8753,13,5,34,15,8,11,62,51,11,38,30,53
10965,8660,8753,20,7,34,13,9,12,50,44,6,35,33,48
10966,8660,8753,41,12,34,10,9,15,40,51,-11,29,39,39
10967,8660,8753,56,13,34,10,9,15,34,45,-11,29,39,39
10968,8660,8753,43,2,34,20,7,7,80,39,41,47,21,67
10969,8660,8753,24,6,34,12,14,8,47,43,4,38,30,50
10970,8660,8753,57,11,34,12,7,15,36,46,-10,31,37,43
10971,8660,8753,12,10,34,12,7,15,43,50,-7,31,37,43
10972,8660,8753,53,16,34,7,12,15,43,69,-26,26,42,33
10973,8660,8753,52,17,34,7,11,16,35,48,-13,25,43,32
10974,8660,8753,19,9,34,13,7,14,45,50,-5,33,35,46
10975,8660,8753,17,14,34,10,9,15,41,58,-17,29,39,39
10976,8660,8753,8,18,34,8,7,19,32,65,-33,23,45,31
10977,8660,8753,21,8,34,12,11,11,50,44,6,35,33,47
10978,4572,4578,1,1,23,14,7,2,42,19,23,35,11,49
10979,4621,4627,39,15,29,4,10,15,16,37,-21,18,40,22
10980,4621,4627,17,9,29,10,10,9,42,42,0,30,28,40
10981,4621,4627,8,12,29,8,10,11,28,37,-9,26,32,34
10982,4621,4627,1,1,29,17,10,2,52,25,27,44,14,61
10983,4621,4627,53,2,29,14,7,8,39,32,7,35,23,49
10984,4621,4627,49,3,29,12,13,4,44,24,20,37,21,49
10985,4621,4627,41,10,29,9,10,10,32,33,-1,28,30,37
10986,4621,4627,21,6,29,13,5,11,43,36,7,31,27,44
10987,4621,4627,24,5,29,10,15,4,36,27,9,35,23,45
10988,4621,4627,43,7,29,11,10,8,45,30,15,32,26,43
10989,4621,4627,57,11,29,9,9,11,32,43,-11,27,31,36
10990,4621,4627,26,16,29,2,7,20,18,55,-37,11,47,13
10991,4621,4627,52,4,29,10,16,3,44,18,26,36,22,46
10992,4621,4627,48,8,29,11,9,9,27,26,1,31,27,42
10993,4621,4627,28,13,29,6,12,11,29,39,-10,24,34,30
10994,4621,4627,36,14,29,7,5,17,28,51,-23,19,39,26
10995,4425,4431,43,2,6,4,1,1,10,6,4,9,3,13
10996,4425,4431,24,8,6,2,2,2,7,7,0,6,6,8
10997,4425,4431,57,10,6,2,2,2,5,6,-1,6,6,8
10998,4425,4431,26,12,6,1,3,2,3,4,-1,5,7,6
10999,4425,4431,41,9,6,2,2,2,5,5,0,6,6,8
11000,4425,4431,49,4,6,3,2,1,6,3,3,8,4,11
11001,4425,4431,17,3,6,3,2,1,8,5,3,8,4,11
11002,4425,4431,52,11,6,1,4,1,3,3,0,6,6,7
11003,4425,4431,48,13,6,1,3,2,4,6,-2,5,7,6
11004,4425,4431,28,14,6,1,1,4,2,6,-4,3,9,4
11005,4425,4431,36,16,6,0,1,5,6,13,-7,1,11,1
11006,4425,4431,53,6,6,3,0,3,10,8,2,6,6,9
11007,4425,4431,8,7,6,2,3,1,7,7,0,7,5,9
11008,4425,4431,21,5,6,3,1,2,8,4,4,7,5,10
11009,4425,4431,39,15,6,0,3,3,2,8,-6,3,9,3
11010,4425,4431,1,1,6,4,2,0,11,6,5,10,2,14
11011,4446,4452,1,1,9,6,2,1,20,8,12,14,4,20
11012,4446,4452,39,14,9,1,4,4,5,13,-8,6,12,7
11013,4446,4452,21,7,9,4,1,4,11,8,3,9,9,13
11014,4446,4452,48,10,9,3,3,3,7,7,0,9,9,12
11015,4446,4452,52,12,9,2,6,1,7,4,3,10,8,12
11016,4446,4452,28,15,9,1,3,5,4,9,-5,5,13,6
11017,4446,4452,36,16,9,0,2,7,8,22,-14,2,16,2
11018,4446,4452,53,3,9,5,1,3,14,10,4,11,7,16
11019,4446,4452,49,4,9,4,3,2,10,7,3,11,7,15
11020,4446,4452,41,11,9,3,3,3,6,7,-1,9,9,12
11021,4446,4452,43,2,9,5,1,3,14,8,6,11,7,16
11022,4446,4452,57,6,9,4,2,3,8,12,-4,10,8,14
11023,4446,4452,24,8,9,3,4,2,14,11,3,10,8,13
11024,4446,4452,26,13,9,1,4,4,4,7,-3,6,12,7
11025,4446,4452,17,5,9,4,3,2,12,11,1,11,7,15
11026,4446,4452,8,9,9,3,4,2,9,9,0,10,8,13
11027,4789,4795,43,1,7,4,1,2,16,10,6,9,5,13
11028,4789,4795,24,5,7,3,3,1,10,7,3,9,5,12
11029,4789,4795,57,8,7,2,3,2,11,10,1,7,7,9
11030,4789,4795,52,3,7,3,4,0,15,6,9,10,4,13
11031,4789,4795,48,11,7,2,2,3,8,14,-6,6,8,8
11032,4789,4795,28,13,7,1,4,2,7,9,-2,6,8,7
11033,4789,4795,41,6,7,3,2,2,15,10,5,8,6,11
11034,4789,4795,20,10,7,2,3,2,10,15,-5,7,7,9
11035,4789,4795,49,2,7,4,1,2,10,7,3,9,5,13
11036,4789,4795,37,4,7,3,3,1,10,6,4,9,5,12
11037,4789,4795,21,14,7,1,3,3,4,8,-4,5,9,6
11038,4789,4795,53,16,7,0,4,3,7,13,-6,4,10,4
11039,4789,4795,36,15,7,1,2,4,10,13,-3,4,10,5
11040,4789,4795,17,9,7,2,3,2,9,12,-3,7,7,9
11041,4789,4795,8,12,7,2,1,4,5,12,-7,5,9,7
11042,4789,4795,1,7,7,2,3,2,12,7,5,7,7,9
11043,5195,5201,1,3,15,7,5,3,27,15,12,19,11,26
11044,5195,5201,27,10,15,5,5,5,15,21,-6,15,15,20
11045,5195,5201,18,12,15,4,7,4,17,24,-7,15,15,19
11046,5195,5201,21,5,15,7,4,4,22,16,6,18,12,25
11047,5195,5201,8,17,15,4,3,8,14,22,-8,11,19,15
11048,5195,5201,17,6,15,7,3,5,23,18,5,17,13,24
11049,5195,5201,52,1,15,8,7,0,36,15,21,23,7,31
11050,5195,5201,53,4,15,7,4,4,23,16,7,18,12,25
11051,5195,5201,12,11,15,5,4,6,22,28,-6,14,16,19
11052,5195,5201,20,14,15,3,7,5,16,17,-1,13,17,16
11053,5195,5201,41,18,15,3,5,7,14,19,-5,11,19,14
11054,5195,5201,49,8,15,6,4,5,24,19,5,16,14,22
11055,5195,5201,5,13,15,4,6,5,27,30,-3,14,16,18
11056,5195,5201,37,15,15,3,7,5,13,14,-1,13,17,16
11057,5195,5201,48,16,15,3,7,5,11,14,-3,13,17,16
11058,5195,5201,36,19,15,1,6,8,9,31,-22,8,22,9
11059,10032,10038,27,7,22,8,6,8,29,34,-5,22,22,30
11060,10032,10038,49,8,22,8,5,9,34,32,2,21,23,29
11061,10032,10038,37,15,22,5,7,10,25,25,0,17,27,22
11062,10032,10038,53,9,22,8,4,10,28,28,0,20,24,28
11063,10032,10038,12,13,22,6,7,9,28,29,-1,19,25,25
11064,10032,10038,28,11,22,7,6,9,18,26,-8,20,24,27
11065,10032,10038,52,12,22,6,8,8,23,27,-4,20,24,26
11066,9857,9859,52,3,3,2,1,0,8,4,4,5,1,7
11067,9857,9859,43,6,3,1,2,0,2,1,1,4,2,5
11068,9857,9859,56,15,3,0,2,1,3,6,-3,2,4,2
11069,9857,9859,41,2,3,2,1,0,8,3,5,5,1,7
11070,9857,9859,53,8,3,1,1,1,2,2,0,3,3,4
11071,9857,9859,49,11,3,1,0,2,4,4,0,2,4,3
11072,9857,9859,37,16,3,0,1,2,2,5,-3,1,5,1
11073,9857,9859,21,1,3,3,0,0,11,2,9,6,0,9
11074,9857,9859,27,16,3,0,1,2,2,5,-3,1,5,1
11075,9857,9859,12,5,3,2,1,0,2,0,2,5,1,7
11076,9857,9859,1,4,3,2,1,0,4,1,3,5,1,7
11077,9857,9859,20,7,3,1,1,1,3,3,0,3,3,4
11078,9857,9859,28,13,3,0,2,1,3,4,-1,2,4,2
11079,9857,9859,2,9,3,1,1,1,5,7,-2,3,3,4
11080,9857,9859,24,10,3,1,1,1,2,4,-2,3,3,4
11081,9857,9859,22,12,3,1,0,2,3,7,-4,2,4,3
11082,9857,9859,4,18,3,0,0,3,3,8,-5,0,6,0
11083,9857,9859,57,14,3,0,2,1,2,3,-1,2,4,2
11084,9885,9891,24,1,8,6,1,1,11,4,7,13,3,19
11085,9885,9891,43,2,8,5,3,0,15,2,13,13,3,18
11086,9885,9891,22,11,8,3,0,5,8,19,-11,6,10,9
11087,9885,9891,2,14,8,2,1,5,8,15,-7,5,11,7
11088,9885,9891,57,16,8,1,3,4,8,12,-4,5,11,6
11089,9885,9891,21,5,8,4,4,0,18,8,10,12,4,16
11090,9885,9891,4,17,8,1,0,7,8,17,-9,2,14,3
11091,9885,9891,1,3,8,5,2,1,15,8,7,12,4,17
11092,9885,9891,53,6,8,4,1,3,11,11,0,9,7,13
11093,9885,9891,12,8,8,3,3,2,10,9,1,9,7,12
11094,9885,9891,27,15,8,1,3,4,8,11,-3,5,11,6
11095,9885,9891,49,10,8,3,2,3,15,14,1,8,8,11
11096,9885,9891,37,13,8,2,1,5,10,12,-2,5,11,7
11097,9885,9891,20,4,8,5,1,2,19,10,9,11,5,16
11098,9885,9891,41,7,8,3,4,1,13,8,5,10,6,13
11099,9885,9891,56,18,8,0,3,5,7,18,-11,3,13,3
11100,9885,9891,28,9,8,3,3,2,8,9,-1,9,7,12
11101,9885,9891,52,12,8,2,3,3,9,14,-5,7,9,9
11102,10291,10304,28,6,14,6,4,4,17,19,-2,16,12,22
11103,10291,10304,52,11,14,5,2,7,12,19,-7,12,16,17
11104,10291,10304,54,15,14,3,3,8,17,24,-7,9,19,12
11105,10291,10304,53,12,14,3,4,7,17,24,-7,10,18,13
11106,10291,10304,21,5,14,7,4,3,28,19,9,18,10,25
11107,10291,10304,1,4,14,8,3,3,30,14,16,19,9,27
11108,10291,10304,12,10,14,5,3,6,19,18,1,13,15,18
11109,10291,10304,27,16,14,2,5,7,11,26,-15,9,19,11
11110,10291,10304,17,13,14,3,4,7,10,22,-12,10,18,13
11111,10291,10304,57,17,14,2,4,8,13,22,-9,8,20,10
11112,10291,10304,22,18,14,1,6,7,7,26,-19,8,20,9
11113,10291,10304,24,1,14,11,3,0,29,9,20,25,3,36
11114,10291,10304,43,2,14,10,2,2,31,12,19,22,6,32
11115,10291,10304,41,3,14,8,5,1,28,10,18,21,7,29
11116,10291,10304,56,7,14,6,3,5,26,22,4,15,13,21
11117,10291,10304,20,8,14,6,2,6,21,24,-3,14,14,20
11118,10291,10304,49,9,14,5,4,5,18,18,0,14,14,19
11119,10291,10304,37,14,14,3,3,8,15,21,-6,9,19,12
11120,10375,10381,41,4,20,10,7,3,40,16,24,27,13,37
11121,10375,10381,24,1,20,15,4,1,40,13,27,34,6,49
11122,10375,10381,43,2,20,15,3,2,52,17,35,33,7,48
11123,10375,10381,49,9,20,7,6,7,28,27,1,20,20,27
11124,10375,10381,27,12,20,4,9,7,19,31,-12,17,23,21
11125,10375,10381,12,10,20,5,7,8,25,28,-3,17,23,22
11126,10375,10381,53,11,20,5,6,9,21,29,-8,16,24,21
11127,10375,10381,17,15,20,5,5,10,14,31,-17,15,25,20
11128,10375,10381,1,3,20,11,5,4,41,20,21,27,13,38
11129,10375,10381,21,5,20,9,8,3,38,25,13,26,14,35
11130,10375,10381,37,13,20,5,5,10,21,30,-9,15,25,20
11131,10375,10381,57,17,20,4,4,12,21,33,-12,12,28,16
11132,10375,10381,22,18,20,2,7,11,11,40,-29,11,29,13
11133,10375,10381,28,6,20,9,4,7,23,26,-3,22,18,31
11134,10375,10381,54,14,20,5,5,10,24,36,-12,15,25,20
11135,10375,10381,52,16,20,5,3,12,17,37,-20,13,27,18
11136,10375,10381,56,7,20,7,7,6,33,27,6,21,19,28
11137,10375,10381,20,8,20,8,3,9,30,32,-2,19,21,27
11138,10459,10472,41,3,32,16,11,5,57,20,37,43,21,59
11139,8912,8918,13,12,18,5,6,7,21,28,-7,16,20,21
11140,8912,8918,4,3,18,10,4,4,41,21,20,24,12,34
11141,8912,8918,21,9,18,5,8,5,19,26,-7,18,18,23
11142,8912,8918,43,1,18,14,4,0,60,16,44,32,4,46
11143,8912,8918,24,11,18,5,6,7,24,31,-7,16,20,21
11144,8912,8918,57,14,18,4,6,8,17,26,-9,14,22,18
11145,8912,8918,2,18,18,3,3,12,21,44,-23,9,27,12
11146,8940,8946,43,1,20,15,5,0,67,17,50,35,5,50
11147,8940,8946,57,10,20,6,6,8,22,27,-5,18,22,24
11148,8940,8946,24,13,20,5,7,8,25,33,-8,17,23,22
11149,8940,8946,2,18,20,3,4,13,22,47,-25,10,30,13
11150,8940,8946,4,4,20,10,5,5,42,23,19,25,15,35
11151,8940,8946,21,7,20,6,9,5,22,28,-6,21,19,27
11152,8940,8946,20,2,20,14,2,4,47,24,23,30,10,44
11153,8940,8946,41,3,20,10,7,3,36,19,17,27,13,37
11154,8940,8946,13,11,20,6,6,8,25,34,-9,18,22,24
11155,8940,8946,56,12,20,6,5,9,25,36,-11,17,23,23
11156,8940,8946,12,8,20,7,4,9,31,37,-6,18,22,25
11157,8940,8946,53,14,20,5,5,10,27,41,-14,15,25,20
11158,8940,8946,11,17,20,3,7,10,20,36,-16,13,27,16
11159,8940,8946,37,5,20,10,4,6,37,18,19,24,16,34
11160,8940,8946,49,9,20,6,7,7,27,25,2,19,21,25
11161,8940,8946,19,15,20,4,7,9,13,27,-14,15,25,19
11162,8940,8946,17,16,20,4,5,11,16,37,-21,13,27,17
11163,8940,8946,1,6,20,9,7,4,31,26,5,25,15,34
11164,8996,9009,1,3,29,15,10,4,57,37,20,40,18,55
11165,8996,9009,37,5,29,14,6,9,55,27,28,34,24,48
11166,8996,9009,49,13,29,7,11,11,34,40,-6,25,33,32
11167,8996,9009,12,9,29,9,8,12,46,50,-4,26,32,35
11168,8996,9009,53,16,29,7,6,16,35,56,-21,20,38,27
11169,8996,9009,11,17,29,5,8,16,32,62,-30,18,40,23
11170,8996,9009,4,6,29,12,9,8,56,33,23,33,25,45
11171,8996,9009,21,7,29,9,13,7,34,39,-5,31,27,40
11172,8996,9009,20,2,29,18,5,6,56,31,25,41,17,59
11173,8996,9009,41,4,29,14,10,5,52,31,21,38,20,52
11174,8996,9009,13,11,29,9,7,13,38,51,-13,25,33,34
11175,8996,9009,56,14,29,7,8,14,35,57,-22,22,36,29
11176,8996,9009,19,10,29,8,11,10,22,31,-9,27,31,35
11177,8996,9009,17,15,29,7,7,15,23,48,-25,21,37,28
11178,8996,9009,43,1,29,22,7,0,83,19,64,51,7,73
11179,8996,9009,57,8,29,10,8,11,31,39,-8,28,30,38
11180,8996,9009,24,12,29,8,9,12,33,43,-10,25,33,33
11181,8996,9009,2,18,29,5,7,17,32,60,-28,17,41,22
11182,9213,9219,20,4,16,8,4,4,29,12,17,20,12,28
11183,9213,9219,41,8,16,7,2,7,24,23,1,16,16,23
11184,9213,9219,13,11,16,4,6,6,12,16,-4,14,18,18
11185,9213,9219,56,18,16,2,5,9,13,27,-14,9,23,11
11186,9213,9219,57,7,16,7,4,5,26,23,3,18,14,25
11187,9213,9219,24,13,16,3,8,5,17,25,-8,14,18,17
11188,9213,9219,21,10,16,5,5,6,17,23,-6,15,17,20
11189,9213,9219,52,16,16,3,5,8,16,30,-14,11,21,14
11190,9213,9219,4,3,16,9,3,4,26,14,12,21,11,30
11191,9213,9219,53,5,16,7,6,3,27,22,5,20,12,27
11192,9213,9219,12,14,16,4,4,8,18,28,-10,12,20,16
11193,9213,9219,49,9,16,6,5,5,23,19,4,17,15,23
11194,9213,9219,43,2,16,9,5,2,37,16,21,23,9,32
11195,9213,9219,17,12,16,4,5,7,17,23,-6,13,19,17
11196,9213,9219,19,17,16,3,4,9,15,35,-20,10,22,13
11197,9213,9219,37,6,16,8,2,6,27,25,2,18,14,26
11198,9213,9219,27,15,16,4,3,9,18,25,-7,11,21,15
11199,9213,9219,1,1,16,12,2,2,39,15,24,26,6,38
11200,9129,9135,1,3,5,3,1,1,11,6,5,7,3,10
11201,9129,9135,17,11,5,1,3,1,7,8,-1,5,5,6
11202,9129,9135,19,13,5,1,2,2,6,10,-4,4,6,5
11203,9129,9135,27,18,5,0,2,3,4,8,-4,2,8,2
11204,9129,9135,37,4,5,3,1,1,9,7,2,7,3,10
11205,9129,9135,49,12,5,1,3,1,5,6,-1,5,5,6
11206,9129,9135,53,1,5,3,2,0,6,1,5,8,2,11
11207,9129,9135,12,9,5,1,3,1,4,3,1,5,5,6
11208,9129,9135,52,16,5,0,3,2,3,8,-5,3,7,3
11209,9129,9135,4,5,5,3,1,1,8,7,1,7,3,10
11210,9129,9135,21,10,5,1,3,1,6,6,0,5,5,6
11211,9129,9135,43,2,5,3,1,1,15,7,8,7,3,10
11212,9129,9135,57,8,5,2,1,2,10,10,0,5,5,7
11213,9129,9135,24,15,5,0,3,2,1,5,-4,3,7,3
11214,9129,9135,20,6,5,2,2,1,7,3,4,6,4,8
11215,9129,9135,13,7,5,2,2,1,4,4,0,6,4,8
11216,9129,9135,41,14,5,1,1,3,8,11,-3,3,7,4
11217,9129,9135,56,17,5,0,2,3,6,10,-4,2,8,2
11218,9157,9163,56,16,9,1,3,5,8,15,-7,5,13,6
11219,9157,9163,37,6,9,4,2,3,16,17,-1,10,8,14
11220,9157,9163,49,10,9,3,4,2,9,9,0,10,8,13
11221,9157,9163,43,2,9,5,3,1,20,9,11,13,5,18
11222,9157,9163,57,8,9,4,1,4,14,14,0,9,9,13
11223,9157,9163,24,18,9,0,5,4,4,15,-11,5,13,5
11224,9157,9163,17,11,9,3,4,2,9,10,-1,10,8,13
11225,9157,9163,19,13,9,2,3,4,11,18,-7,7,11,9
11226,9157,9163,1,1,9,7,1,1,25,9,16,15,3,22
11227,9157,9163,52,15,9,1,4,4,8,16,-8,6,12,7
11228,9157,9163,27,17,9,1,2,6,8,15,-7,4,14,5
11229,9157,9163,4,3,9,5,2,2,15,8,7,12,6,17
11230,9157,9163,21,14,9,1,4,4,7,14,-7,6,12,7
11231,9157,9163,53,5,9,4,3,2,12,9,3,11,7,15
11232,9157,9163,12,9,9,3,4,2,12,10,2,10,8,13
11233,9598,9604,12,5,15,8,5,2,22,16,6,21,9,29
11234,9598,9604,53,9,15,5,6,4,16,18,-2,16,14,21
11235,9598,9604,2,11,15,5,3,7,16,22,-6,13,17,18
11236,9598,9604,57,12,15,4,3,8,20,19,1,11,19,15
11237,9598,9604,52,16,15,3,3,9,15,29,-14,9,21,12
11238,9598,9604,48,18,15,1,3,11,6,36,-30,5,25,6
11239,9598,9604,27,4,15,9,2,4,22,17,5,20,10,29
11240,9598,9604,1,2,15,10,3,2,35,15,20,23,7,33
11241,9598,9604,37,6,15,6,9,0,20,9,11,21,9,27
11242,9598,9604,49,8,15,6,5,4,23,13,10,17,13,23
11243,9598,9604,4,14,15,4,2,9,12,27,-15,10,20,14
11244,9598,9604,21,17,15,1,4,10,12,28,-16,6,24,7
11245,9598,9604,41,7,15,7,4,4,22,15,7,18,12,25
11246,9598,9604,20,10,15,6,1,8,20,26,-6,13,17,19
11247,9598,9604,13,13,15,4,3,8,17,26,-9,11,19,15
11248,9598,9604,56,15,15,3,3,9,16,23,-7,9,21,12
11249,9598,9604,43,1,15,11,3,1,36,8,28,25,5,36
11250,9598,9604,24,3,15,9,4,2,25,8,17,22,8,31
11251,9682,9688,56,17,22,4,4,14,23,38,-15,12,32,16
11252,9682,9688,52,15,22,4,7,11,23,38,-15,15,29,19
11253,9682,9688,48,18,22,4,4,14,16,52,-36,12,32,16
11254,9682,9688,41,6,22,10,5,7,28,21,7,25,19,35
11255,9682,9688,20,9,22,8,4,10,28,32,-4,20,24,28
11256,9682,9688,13,16,22,4,5,13,23,42,-19,13,31,17
11257,9682,9688,37,4,22,10,12,0,33,14,19,32,12,42
11258,9682,9688,49,8,22,8,6,8,29,20,9,22,22,30
11259,9682,9688,43,1,22,16,5,1,56,13,43,37,7,53
11260,9682,9688,24,2,22,15,5,2,34,9,25,35,9,50
11261,9682,9688,2,11,22,6,8,8,23,30,-7,20,24,26
11262,9682,9688,57,12,22,5,7,10,24,24,0,17,27,22
11263,9682,9688,1,3,22,13,5,4,42,21,21,31,13,44
11264,9682,9688,27,7,22,10,4,8,28,29,-1,24,20,34
11265,9682,9688,4,13,22,5,5,12,17,37,-20,15,29,20
11266,9682,9688,21,14,22,4,7,11,24,34,-10,15,29,19
11267,9682,9688,12,5,22,11,8,3,32,23,9,30,14,41
11268,9682,9688,53,10,22,6,9,7,18,24,-6,21,23,27
11269,9696,9702,12,5,24,11,8,5,36,29,7,30,18,41
11270,9696,9702,53,10,24,7,9,8,22,25,-3,23,25,30
11271,9696,9702,4,13,24,5,7,12,19,39,-20,17,31,22
11272,9696,9702,21,16,24,4,7,13,24,36,-12,15,33,19
11273,9696,9702,27,7,24,10,6,8,30,31,-1,26,22,36
11274,9696,9702,52,14,24,4,9,11,23,38,-15,17,31,21
11275,9696,9702,48,18,24,4,6,14,16,52,-36,14,34,18
11276,9696,9702,1,3,24,14,6,4,44,21,23,34,14,48
11277,9696,9702,43,1,24,17,5,2,60,20,40,39,9,56
11278,9696,9702,24,2,24,17,5,2,38,9,29,39,9,56
11279,9696,9702,57,11,24,7,7,10,28,25,3,21,27,28
11280,9696,9702,2,12,24,6,8,10,23,34,-11,20,28,26
11281,9696,9702,37,4,24,11,12,1,34,16,18,34,14,45
11282,9696,9702,49,9,24,8,8,8,31,22,9,24,24,32
11283,9696,9702,41,6,24,11,5,8,30,24,6,27,21,38
11284,9696,9702,20,8,24,9,5,10,30,33,-3,23,25,32
11285,9696,9702,56,15,24,5,5,14,25,39,-14,15,33,20
11286,9696,9702,13,17,24,4,6,14,23,43,-20,14,34,18
11287,9738,9744,41,7,30,12,8,10,37,33,4,32,28,44
11288,9738,9744,20,8,30,11,7,12,40,39,1,29,31,40
11289,9738,9744,56,13,30,8,6,16,34,44,-10,22,38,30
11290,9738,9744,13,17,30,5,8,17,28,58,-30,18,42,23
11291,9738,9744,37,5,30,13,14,3,40,21,19,40,20,53
11292,9738,9744,49,10,30,8,11,11,36,33,3,27,33,35
11293,9738,9744,43,1,30,22,6,2,73,23,50,50,10,72
11294,9738,9744,24,2,30,21,7,2,48,11,37,49,11,70
11295,9738,9744,2,11,30,8,11,11,29,40,-11,27,33,35
11296,9738,9744,57,12,30,7,10,13,31,37,-6,24,36,31
11297,11523,11529,37,14,26,5,10,11,31,38,-7,20,32,25
11298,11523,11529,21,5,26,13,3,10,35,33,2,29,23,42
11299,11523,11529,4,6,26,12,6,8,42,36,6,30,22,42
11300,11523,11529,12,10,26,8,9,9,34,35,-1,25,27,33
11301,11796,11816,6,18,17,2,2,13,15,44,-29,6,28,8
11302,11796,11816,49,2,17,11,3,3,35,19,16,25,9,36
11303,11796,11816,37,11,17,7,4,6,19,22,-3,18,16,25
11304,11796,11816,14,15,17,4,2,11,28,50,-22,10,24,14
11305,11796,11816,20,4,17,8,4,5,44,25,19,20,14,28
11306,11796,11816,41,13,17,6,3,8,25,37,-12,15,19,21
11307,11796,11816,35,17,17,3,3,11,21,40,-19,9,25,12
11308,11796,11816,27,7,17,8,3,6,30,25,5,19,15,27
11309,11796,11816,12,16,17,3,4,10,18,31,-13,10,24,13
11310,11796,11816,52,8,17,6,8,3,27,18,9,20,14,26
11311,11796,11816,43,1,17,13,3,1,38,12,26,29,5,42
11312,11796,11816,24,3,17,10,0,7,29,22,7,20,14,30
11313,11796,11816,57,12,17,6,4,7,40,39,1,16,18,22
11314,11796,11816,22,14,17,4,6,7,18,17,1,14,20,18
11315,11796,11816,17,10,17,7,4,6,27,25,2,18,16,25
11316,11796,11816,1,6,17,8,4,5,20,14,6,20,14,28
11317,11796,11816,4,5,17,8,4,5,27,19,8,20,14,28
11318,11796,11816,21,9,17,8,1,8,29,31,-2,17,17,25
11319,11915,11921,52,11,30,10,11,9,38,33,5,31,29,41
11320,11915,11921,17,9,30,12,6,12,41,42,-1,30,30,42
11321,11915,11921,12,17,30,4,9,17,27,52,-25,17,43,21
11322,11915,11921,1,5,30,14,7,9,42,30,12,35,25,49
11323,11915,11921,43,1,30,23,6,1,71,21,50,52,8,75
11324,11915,11921,24,4,30,15,5,10,45,32,13,35,25,50
11325,11915,11921,22,12,30,8,11,11,34,37,-3,27,33,35
11326,11915,11921,57,15,30,8,9,13,59,66,-7,25,35,33
11327,11915,11921,27,8,30,12,8,10,46,43,3,32,28,44
11328,11915,11921,49,2,30,15,9,6,55,35,20,39,21,54
11329,11915,11921,37,7,30,14,6,10,43,36,7,34,26,48
11330,11915,11921,14,18,30,5,5,20,35,87,-52,15,45,20
11331,11915,11921,20,3,30,15,7,8,69,41,28,37,23,52
11332,11915,11921,35,13,30,9,7,14,49,58,-9,25,35,34
11333,11915,11921,41,14,30,9,7,14,40,60,-20,25,35,34
11334,11915,11921,6,16,30,6,4,20,35,72,-37,16,44,22
11335,11915,11921,21,6,30,14,6,10,53,41,12,34,26,48
11336,11915,11921,4,10,30,11,9,10,42,38,4,31,29,42
11337,11712,11718,4,5,8,4,2,2,14,6,8,10,6,14
11338,11712,11718,21,6,8,4,1,3,16,16,0,9,7,13
11339,11712,11718,20,10,8,3,2,3,16,14,2,8,8,11
11340,11712,11718,35,11,8,3,1,4,15,16,-1,7,9,10
11341,11712,11718,41,14,8,2,2,4,11,20,-9,6,10,8
11342,11712,11718,6,17,8,1,1,6,6,22,-16,3,13,4
11343,11712,11718,49,2,8,6,1,1,16,8,8,13,3,19
11344,11712,11718,37,7,8,4,1,3,8,10,-2,9,7,13
11345,11712,11718,14,12,8,3,0,5,15,21,-6,6,10,9
11346,11712,11718,52,15,8,1,5,2,8,9,-1,7,9,8
11347,11712,11718,43,1,8,6,1,1,23,10,13,13,3,19
11348,11712,11718,24,8,8,4,0,4,14,12,2,8,8,12
11349,11712,11718,22,13,8,2,3,3,9,8,1,7,9,9
11350,11712,11718,57,18,8,0,3,5,13,23,-10,3,13,3
11351,11712,11718,27,4,8,5,0,3,21,14,7,10,6,15
11352,11712,11718,12,16,8,2,1,5,7,15,-8,5,11,7
11353,11712,11718,17,9,8,3,3,2,14,8,6,9,7,12
11354,11712,11718,1,3,8,5,1,2,12,6,6,11,5,16
11355,12083,12096,1,2,10,5,4,1,16,8,8,14,6,19
11356,12083,12096,17,17,10,1,5,4,7,13,-6,7,13,8
11357,12083,12096,27,4,10,5,2,3,14,9,5,12,8,17
11358,12083,12096,43,1,10,8,1,1,31,14,17,17,3,25
11359,12083,12096,24,9,10,3,5,2,13,9,4,11,9,14
11360,12083,12096,57,13,10,2,4,4,15,19,-4,8,12,10
11361,12083,12096,22,18,10,0,3,7,12,26,-14,3,17,3
11362,12083,12096,52,15,10,2,2,6,11,20,-9,6,14,8
11363,12083,12096,6,5,10,5,2,3,17,15,2,12,8,17
11364,12083,12096,13,7,10,4,3,3,16,8,8,11,9,15
11365,12083,12096,35,10,10,3,3,4,13,16,-3,9,11,12
11366,12083,12096,41,14,10,1,6,3,9,16,-7,8,12,9
11367,12083,12096,20,16,10,2,2,6,12,22,-10,6,14,8
11368,12083,12096,21,3,10,5,3,2,13,11,2,13,7,18
11369,12083,12096,9,6,10,4,5,1,14,9,5,13,7,17
11370,12083,12096,4,11,10,2,6,2,14,15,-1,10,10,12
11371,12083,12096,49,8,10,4,2,4,10,6,4,10,10,14
11372,12083,12096,37,12,10,2,6,2,11,12,-1,10,10,12
11373,12307,12404,49,6,34,13,12,9,43,22,21,38,30,51
11374,12307,12404,37,9,34,11,11,12,42,40,2,33,35,44
11375,12307,12404,13,4,34,15,13,6,50,27,23,43,25,58
11376,10459,10472,56,8,32,9,15,8,50,41,9,33,31,42
11377,10459,10472,20,9,32,11,7,14,47,48,-1,29,35,40
11378,10459,10472,28,7,32,12,10,10,38,42,-4,34,30,46
11379,10459,10472,52,12,32,10,5,17,32,53,-21,25,39,35
11380,10459,10472,54,14,32,9,7,16,33,52,-19,25,39,34
11381,10459,10472,12,15,32,8,10,14,40,53,-13,26,38,34
11382,10459,10472,53,16,32,8,9,15,39,56,-17,25,39,33
11383,10459,10472,49,6,32,14,8,10,43,37,6,36,28,50
11384,10459,10472,37,10,32,10,8,14,37,45,-8,28,36,38
11385,10459,10472,27,17,32,6,15,11,28,46,-18,27,37,33
11386,10459,10472,1,4,32,15,9,8,62,41,21,39,25,54
11387,10459,10472,21,5,32,14,10,8,56,38,18,38,26,52
11388,10459,10472,24,1,32,23,7,2,58,16,42,53,11,76
11389,10459,10472,43,2,32,20,9,3,75,32,43,49,15,69
11390,10459,10472,57,13,32,9,7,16,37,49,-12,25,39,34
11391,10459,10472,22,18,32,2,10,20,20,66,-46,14,50,16
11392,10459,10472,17,11,32,10,7,15,28,45,-17,27,37,37
11393,10221,10223,17,13,4,0,2,2,4,9,-5,2,6,2
11394,10221,10223,41,3,4,3,1,0,9,1,8,7,1,10
11395,10221,10223,20,7,4,3,1,0,7,3,4,7,1,10
11396,10221,10223,56,11,4,0,3,1,4,5,-1,3,5,3
11397,10221,10223,49,8,4,2,0,2,3,4,-1,4,4,6
11398,10221,10223,37,12,4,0,2,2,5,7,-2,2,6,2
11399,10221,10223,1,2,4,3,1,0,12,4,8,7,1,10
11400,10221,10223,12,9,4,1,2,1,4,2,2,4,4,5
11401,10221,10223,53,15,4,0,1,3,2,10,-8,1,7,1
11402,10221,10223,27,14,4,0,2,2,1,9,-8,2,6,2
11403,10221,10223,21,4,4,3,1,0,10,3,7,7,1,10
11404,10221,10223,43,1,4,4,0,0,15,4,11,8,0,12
11405,10221,10223,24,5,4,3,1,0,8,1,7,7,1,10
11406,10221,10223,57,10,4,1,1,2,5,8,-3,3,5,4
11407,10221,10223,22,16,4,0,1,3,1,9,-8,1,7,1
11408,10221,10223,28,6,4,3,1,0,8,2,6,7,1,10
11409,10221,10223,54,17,4,0,0,4,4,12,-8,0,8,0
11410,10221,10223,52,18,4,0,0,4,0,9,-9,0,8,0
11411,10676,10682,28,17,14,2,5,7,9,23,-14,9,19,11
11412,10676,10682,54,18,14,2,3,9,11,24,-13,7,21,9
11413,10676,10682,27,13,14,5,2,7,17,18,-1,12,16,17
11414,10676,10682,21,5,14,6,6,2,27,14,13,18,10,24
11415,10676,10682,4,7,14,5,4,5,17,17,0,14,14,19
11416,10676,10682,12,8,14,5,4,5,17,21,-4,14,14,19
11417,10676,10682,49,6,14,5,6,3,18,12,6,16,12,21
11418,10676,10682,37,11,14,5,3,6,16,22,-6,13,15,18
11419,10676,10682,53,16,14,2,6,6,9,22,-13,10,18,12
11420,10676,10682,17,10,14,5,4,5,18,24,-6,14,14,19
11421,10676,10682,56,9,14,5,4,5,16,21,-5,14,14,19
11422,10676,10682,35,12,14,5,2,7,20,21,-1,12,16,17
11423,10676,10682,41,14,14,4,3,7,12,14,-2,11,17,15
11424,10676,10682,20,15,14,3,3,8,16,27,-11,9,19,12
11425,10676,10682,43,1,14,8,4,2,28,7,21,20,8,28
11426,10676,10682,24,3,14,7,7,0,24,4,20,21,7,28
11427,10676,10682,57,4,14,7,4,3,20,14,6,18,10,25
11428,10676,10682,1,2,14,8,4,2,23,13,10,20,8,28
11429,10739,10745,1,1,19,13,4,2,37,16,21,30,8,43
11430,10739,10745,43,2,19,12,4,3,39,8,31,28,10,40
11431,10739,10745,24,4,19,9,10,0,32,5,27,28,10,37
11432,10739,10745,57,5,19,9,5,5,29,20,9,23,15,32
11433,10739,10745,21,3,19,10,7,2,41,18,23,27,11,37
11434,10739,10745,4,8,19,6,7,6,21,20,1,19,19,25
11435,10739,10745,49,6,19,7,7,5,26,20,6,21,17,28
11436,10739,10745,37,13,19,5,4,10,18,33,-15,14,24,19
11437,10739,10745,35,11,19,7,2,10,24,29,-5,16,22,23
11438,10739,10745,56,12,19,5,7,7,16,26,-10,17,21,22
11439,10739,10745,41,14,19,4,7,8,14,17,-3,15,23,19
11440,10739,10745,20,17,19,3,5,11,19,40,-21,11,27,14
11441,10739,10745,12,9,19,6,7,6,21,28,-7,19,19,25
11442,10739,10745,53,15,19,4,6,9,16,31,-15,14,24,18
11443,10739,10745,17,7,19,7,4,8,24,36,-12,18,20,25
11444,10739,10745,27,10,19,6,6,7,24,24,0,18,20,24
11445,10739,10745,28,16,19,3,7,9,14,30,-16,13,25,16
11446,10739,10745,54,18,19,2,7,10,12,26,-14,11,27,13
11447,10746,10752,28,15,20,4,7,9,17,30,-13,15,25,19
11448,10746,10752,54,18,20,2,7,11,12,29,-17,11,29,13
11449,10746,10752,24,4,20,9,10,1,32,8,24,28,12,37
11450,10746,10752,12,9,20,7,7,6,24,29,-5,21,19,28
11451,10746,10752,53,16,20,4,6,10,17,34,-17,14,26,18
11452,10746,10752,27,10,20,6,6,8,25,27,-2,18,22,24
11453,10746,10752,35,11,20,7,2,11,24,30,-6,16,24,23
11454,10746,10752,41,12,20,5,7,8,17,18,-1,17,23,22
11455,8660,8753,4,15,34,10,8,16,37,43,-6,28,40,38
11456,8422,8428,21,4,8,4,2,2,13,6,7,10,6,14
11457,8422,8428,4,14,8,2,1,5,10,13,-3,5,11,7
11458,8422,8428,19,11,8,2,3,3,13,13,0,7,9,9
11459,8422,8428,17,15,8,2,0,6,9,16,-7,4,12,6
11460,8422,8428,8,17,8,1,2,5,8,16,-8,4,12,5
11461,8422,8428,43,3,8,4,2,2,16,9,7,10,6,14
11462,8422,8428,57,8,8,4,1,3,9,7,2,9,7,13
11463,8422,8428,24,9,8,3,4,1,12,9,3,10,6,13
11464,8422,8428,37,1,8,6,2,0,13,7,6,14,2,20
11465,8422,8428,49,5,8,4,2,2,13,7,6,10,6,14
11466,8422,8428,13,2,8,5,2,1,15,6,9,12,4,17
11467,8422,8428,20,6,8,4,2,2,10,6,4,10,6,14
11468,8422,8428,56,13,8,2,2,4,8,12,-4,6,10,8
11469,8422,8428,41,18,8,0,2,6,6,18,-12,2,14,2
11470,8422,8428,12,7,8,4,2,2,11,8,3,10,6,14
11471,8422,8428,53,12,8,2,3,3,11,18,-7,7,9,9
11472,8422,8428,52,16,8,1,3,4,8,13,-5,5,11,6
11473,8422,8428,1,10,8,3,3,2,11,12,-1,9,7,12
11474,8761,8764,1,6,2,1,1,0,2,0,2,3,1,4
11475,8761,8764,37,2,2,2,0,0,6,1,5,4,0,6
11476,8761,8764,49,7,2,1,1,0,4,3,1,3,1,4
11477,8761,8764,43,1,2,2,0,0,16,3,13,4,0,6
11478,8761,8764,57,9,2,0,2,0,2,2,0,2,2,2
11479,8761,8764,24,9,2,0,2,0,2,2,0,2,2,2
11480,8761,8764,2,18,2,0,0,2,3,13,-10,0,4,0
11481,8761,8764,11,4,2,1,1,0,5,2,3,3,1,4
11482,8761,8764,53,13,2,0,1,1,3,5,-2,1,3,1
11483,8761,8764,12,15,2,0,1,1,2,8,-6,1,3,1
11484,8761,8764,19,12,2,0,2,0,1,1,0,2,2,2
11485,8761,8764,17,17,2,0,0,2,1,5,-4,0,4,0
11486,8761,8764,4,3,2,1,1,0,7,4,3,3,1,4
11487,8761,8764,21,9,2,0,2,0,2,2,0,2,2,2
11488,8761,8764,41,5,2,1,1,0,3,1,2,3,1,4
11489,8761,8764,13,8,2,0,2,0,4,4,0,2,2,2
11490,8761,8764,56,14,2,0,1,1,0,3,-3,1,3,1
11491,8761,8764,20,16,2,0,0,2,2,6,-4,0,4,0
11492,9010,9016,4,6,30,12,10,8,57,34,23,34,26,46
11493,9010,9016,19,12,30,8,11,11,23,34,-11,27,33,35
11494,9010,9016,17,15,30,7,8,15,23,48,-25,22,38,29
11495,9010,9016,43,1,30,23,7,0,88,19,69,53,7,76
11496,9010,9016,57,8,30,10,8,12,31,41,-10,28,32,38
11497,9010,9016,24,13,30,8,9,13,33,48,-15,25,35,33
11498,9010,9016,2,18,30,5,8,17,34,62,-28,18,42,23
11499,9010,9016,20,2,30,18,6,6,57,32,25,42,18,60
11500,9010,9016,41,4,30,15,10,5,54,31,23,40,20,55
11501,9010,9016,13,10,30,9,8,13,40,53,-13,26,34,35
11502,9010,9016,56,14,30,7,9,14,36,58,-22,23,37,30
11503,9010,9016,37,5,30,14,6,10,55,29,26,34,26,48
11504,9010,9016,49,11,30,8,11,11,35,40,-5,27,33,35
11505,9010,9016,21,7,30,10,13,7,37,40,-3,33,27,43
11506,9010,9016,12,9,30,9,9,12,47,51,-4,27,33,36
11507,9010,9016,53,16,30,7,6,17,35,57,-22,20,40,27
11508,9010,9016,11,17,30,5,9,16,32,62,-30,19,41,24
11509,9010,9016,1,3,30,16,10,4,59,37,22,42,18,58
11510,9206,9212,1,1,15,11,2,2,36,13,23,24,6,35
11511,9206,9212,53,4,15,7,5,3,26,21,5,19,11,26
11512,9206,9212,12,16,15,3,4,8,16,28,-12,10,20,13
11513,9206,9212,27,14,15,4,2,9,17,24,-7,10,20,14
11514,9206,9212,4,3,15,9,3,3,24,11,13,21,9,30
11515,9206,9212,21,12,15,4,5,6,16,23,-7,13,17,17
11516,9206,9212,37,8,15,7,2,6,25,25,0,16,14,23
11517,9206,9212,49,9,15,5,5,5,19,19,0,15,15,20
11518,9206,9212,20,5,15,7,4,4,26,10,16,18,12,25
11519,9206,9212,41,7,15,7,2,6,24,19,5,16,14,23
11520,9206,9212,13,10,15,4,6,5,12,14,-2,14,16,18
11521,9206,9212,56,18,15,2,5,8,13,25,-12,9,21,11
11522,9206,9212,43,2,15,9,4,2,36,15,21,22,8,31
11523,9206,9212,57,6,15,7,3,5,24,21,3,17,13,24
11524,9206,9212,52,15,15,3,5,7,16,29,-13,11,19,14
11525,9206,9212,17,11,15,4,5,6,15,20,-5,13,17,17
11526,9206,9212,19,17,15,3,3,9,14,34,-20,9,21,12
11527,9206,9212,24,13,15,3,7,5,15,23,-8,13,17,16
11528,9227,9233,4,3,18,10,4,4,29,15,14,24,12,34
11529,9227,9233,21,10,18,6,6,6,19,24,-5,18,18,24
11530,9227,9233,20,5,18,9,4,5,31,14,17,22,14,31
11531,9227,9233,41,7,18,8,3,7,27,25,2,19,17,27
11532,9227,9233,13,11,18,4,8,6,13,17,-4,16,20,20
11533,9227,9233,56,17,18,3,5,10,16,30,-14,11,25,14
11534,9227,9233,52,16,18,3,6,9,16,31,-15,12,24,15
11535,5195,5201,43,2,15,7,7,1,29,8,21,21,9,28
11536,5195,5201,57,7,15,6,6,3,18,17,1,18,12,24
11537,5195,5201,24,9,15,5,6,4,12,10,2,16,14,21
11538,5195,5201,22,20,15,1,5,9,14,32,-18,7,23,8
11539,5237,5243,43,3,19,9,8,2,35,13,22,26,12,35
11540,5237,5243,57,7,19,7,8,4,23,21,2,22,16,29
11541,5237,5243,24,12,19,5,8,6,12,16,-4,18,20,23
11542,5237,5243,22,20,19,1,7,11,16,39,-23,9,29,10
11543,5237,5243,49,4,19,10,4,5,32,19,13,24,14,34
11544,5237,5243,5,11,19,5,8,6,34,35,-1,18,20,23
11545,5237,5243,37,14,19,4,8,7,15,18,-3,16,22,20
11546,5237,5243,20,15,19,4,7,8,17,23,-6,15,23,19
11547,5237,5243,41,17,19,4,6,9,17,24,-7,14,24,18
11548,5237,5243,21,2,19,10,5,4,33,19,14,25,13,35
11549,5237,5243,53,5,19,10,4,5,30,17,13,24,14,34
11550,5237,5243,12,9,19,7,5,7,27,32,-5,19,19,26
11551,5237,5243,52,1,19,12,7,0,49,18,31,31,7,43
11552,5237,5243,48,16,19,3,10,6,14,18,-4,16,22,19
11553,5237,5243,36,19,19,2,6,11,11,37,-26,10,28,12
11554,5237,5243,17,8,19,8,3,8,26,28,-2,19,19,27
11555,5237,5243,8,18,19,4,6,9,17,28,-11,14,24,18
11556,5237,5243,1,6,19,9,6,4,36,19,17,24,14,33
11557,5237,5243,27,10,19,6,6,7,21,30,-9,18,20,24
11558,5237,5243,18,13,19,5,8,6,20,31,-11,18,20,23
11559,5338,5341,27,13,34,9,11,14,33,54,-21,29,39,38
11560,5338,5341,52,1,34,21,11,2,79,32,47,53,15,74
11561,5338,5341,48,16,34,7,15,12,29,41,-12,29,39,36
11562,5338,5341,36,18,34,8,7,19,29,61,-32,23,45,31
11563,5338,5341,1,5,34,17,10,7,65,29,36,44,24,61
11564,5338,5341,18,19,34,6,11,17,26,65,-39,23,45,29
11565,5338,5341,17,7,34,17,5,12,46,42,4,39,29,56
11566,5338,5341,8,14,34,9,10,15,41,53,-12,28,40,37
11567,5338,5341,53,6,34,17,8,9,51,32,19,42,26,59
11568,5338,5341,12,8,34,13,10,11,47,47,0,36,32,49
11569,5338,5341,21,3,34,18,8,8,63,29,34,44,24,62
11570,5338,5341,20,9,34,11,11,12,40,39,1,33,35,44
11571,5338,5341,41,11,34,12,7,15,43,49,-6,31,37,43
11572,5338,5341,49,4,34,18,7,9,58,34,24,43,25,61
11573,5338,5341,37,12,34,9,12,13,25,37,-12,30,38,39
11574,5338,5341,5,17,34,7,11,16,50,72,-22,25,43,32
11575,5338,5341,43,2,34,19,11,4,67,19,48,49,19,68
11576,5338,5341,57,10,34,11,11,12,35,40,-5,33,35,44
11577,5338,5341,24,15,34,9,9,16,23,37,-14,27,41,36
11578,5338,5341,22,20,34,4,11,19,26,64,-38,19,49,23
11579,5524,5530,43,8,10,4,4,2,16,11,5,12,8,16
11580,5524,5530,57,12,10,2,4,4,13,13,0,8,12,10
11581,5524,5530,24,14,10,1,5,4,12,16,-4,7,13,8
11582,5524,5530,40,16,11,1,5,5,11,18,-7,7,15,8
11583,5524,5530,17,5,11,6,1,4,23,15,8,13,9,19
11584,5524,5530,8,19,10,2,1,7,8,25,-17,5,15,7
11585,5524,5530,37,7,11,4,4,3,12,6,6,12,10,16
11586,5524,5530,49,10,11,4,4,3,11,9,2,12,10,16
11587,5524,5530,5,13,10,1,6,3,10,12,-2,8,12,9
11588,5524,5530,20,1,10,5,5,0,17,6,11,15,5,20
11589,5524,5530,41,11,11,4,2,5,18,22,-4,10,12,14
11590,5524,5530,12,2,11,7,1,3,21,13,8,15,7,22
11591,5524,5530,53,9,10,5,2,3,18,16,2,12,8,17
11592,5524,5530,52,3,10,6,2,2,21,11,10,14,6,20
11593,5524,5530,48,17,10,1,5,4,6,13,-7,7,13,8
11594,5524,5530,54,18,10,3,1,6,7,20,-13,7,13,10
11595,5524,5530,21,4,11,5,4,2,15,15,0,14,8,19
11596,5524,5530,1,6,10,5,3,2,18,11,7,13,7,18
11597,5524,5530,27,15,11,2,3,6,11,16,-5,7,15,9
11598,5573,5579,27,18,15,2,4,9,16,24,-8,8,22,10
11599,5573,5579,1,1,15,10,3,2,32,14,18,23,7,33
11600,5573,5579,21,9,16,6,5,5,20,24,-4,17,15,23
11601,5573,5579,37,2,16,7,6,3,19,6,13,20,12,27
11602,5573,5579,49,7,15,7,5,3,22,16,6,19,11,26
11603,5573,5579,5,15,15,2,7,6,14,20,-6,11,19,13
11604,5573,5579,12,6,16,9,2,5,29,20,9,20,12,29
11605,5573,5579,53,11,15,5,5,5,22,25,-3,15,15,20
11606,5573,5579,52,3,15,8,4,3,27,15,12,20,10,28
11607,5573,5579,54,16,15,4,2,9,9,25,-16,10,20,14
11608,5573,5579,48,19,15,1,6,8,9,26,-17,8,22,9
11609,5573,5579,20,5,15,7,6,2,22,12,10,20,10,27
11610,5573,5579,41,13,15,4,4,7,23,31,-8,12,18,16
11611,5573,5579,17,8,15,7,3,5,29,20,9,17,13,24
11612,5573,5579,8,17,15,4,2,9,11,29,-18,10,20,14
11613,5573,5579,43,4,15,8,4,3,27,17,10,20,10,28
11614,7533,7539,21,10,30,10,10,10,38,46,-8,30,30,40
11615,7533,7539,52,7,30,12,6,12,41,43,-2,30,30,42
11616,7533,7539,48,18,30,5,9,16,26,72,-46,19,41,24
11617,7533,7539,37,3,30,16,7,7,47,28,19,39,21,55
11618,7533,7539,49,4,30,16,5,9,57,41,16,37,23,53
11619,7533,7539,43,1,30,22,5,3,68,21,47,49,11,71
11620,7533,7539,22,6,30,14,5,11,41,39,2,33,27,47
11621,7533,7539,57,14,30,9,6,15,43,60,-17,24,36,33
11622,7533,7539,20,11,30,9,10,11,35,38,-3,28,32,37
11623,7533,7539,41,12,30,9,8,13,43,39,4,26,34,35
11624,7533,7539,56,13,30,9,7,14,35,52,-17,25,35,34
11625,7659,7665,20,9,1,0,1,0,1,1,0,1,1,1
11626,7659,7665,56,17,1,0,0,1,0,2,-2,0,2,0
11627,7659,7665,41,18,1,0,0,1,1,4,-3,0,2,0
11628,7659,7665,22,2,1,1,0,0,3,1,2,2,0,3
11629,7659,7665,57,7,1,0,1,0,2,2,0,1,1,1
11630,7659,7665,43,9,1,0,1,0,1,1,0,1,1,1
11631,7659,7665,24,13,1,0,0,1,1,2,-1,0,2,0
11632,7659,7665,3,5,1,1,0,0,2,1,1,2,0,3
11633,7659,7665,52,13,1,0,0,1,1,2,-1,0,2,0
11634,7659,7665,37,4,1,1,0,0,2,0,2,2,0,3
11635,7659,7665,49,7,1,0,1,0,2,2,0,1,1,1
11636,7659,7665,21,9,1,0,1,0,1,1,0,1,1,1
11637,7659,7665,4,15,1,0,0,1,1,3,-2,0,2,0
11638,7659,7665,17,2,1,1,0,0,3,1,2,2,0,3
11639,7659,7665,8,5,1,1,0,0,2,1,1,2,0,3
11640,7659,7665,19,15,1,0,0,1,1,3,-2,0,2,0
11641,7659,7665,12,9,1,0,1,0,1,1,0,1,1,1
11642,7659,7665,1,1,1,1,0,0,4,1,3,2,0,3
11643,7743,7749,12,7,13,6,2,5,15,13,2,14,12,20
11644,7743,7749,1,17,13,2,3,8,16,24,-8,7,19,9
11645,7743,7749,17,3,13,8,3,2,20,13,7,19,7,27
11646,7743,7749,8,12,13,4,3,6,12,18,-6,11,15,15
11647,7743,7749,19,14,13,3,4,6,15,24,-9,10,16,13
11648,7743,7749,4,1,13,8,4,1,21,9,12,20,6,28
11649,7743,7749,21,6,13,6,4,3,18,11,7,16,10,22
11650,7743,7749,49,4,13,7,5,1,21,8,13,19,7,26
11651,7743,7749,37,9,13,4,6,3,11,10,1,14,12,18
11652,7743,7749,52,8,13,6,1,6,19,20,-1,13,13,19
11653,7743,7749,3,13,13,3,4,6,15,20,-5,10,16,13
11654,7743,7749,43,2,13,8,3,2,25,13,12,19,7,27
11655,7743,7749,22,15,13,3,4,6,9,19,-10,10,16,13
11656,7743,7749,57,16,13,3,3,7,19,26,-7,9,17,12
11657,7743,7749,24,18,13,0,4,9,9,21,-12,4,22,4
11658,7743,7749,20,11,13,4,3,6,11,11,0,11,15,15
11659,7743,7749,56,5,13,7,2,4,18,16,2,16,10,23
11660,7743,7749,41,10,13,4,4,5,15,13,2,12,14,16
11661,7799,7805,56,5,18,10,2,6,27,24,3,22,14,32
11662,7799,7805,20,10,18,6,5,7,21,19,2,17,19,23
11663,7799,7805,41,14,18,5,4,9,21,28,-7,14,22,19
11664,7799,7805,43,1,18,11,3,4,32,20,12,25,11,36
11665,7799,7805,57,15,18,5,3,10,27,32,-5,13,23,18
11666,7799,7805,22,16,18,4,5,9,12,26,-14,13,23,17
11667,7799,7805,24,18,18,2,4,12,16,27,-11,8,28,10
11668,7799,7805,49,3,18,10,5,3,27,16,11,25,11,35
11669,7799,7805,37,7,18,7,7,4,22,15,7,21,15,28
11670,7799,7805,52,8,18,8,2,8,27,25,2,18,18,26
11671,7799,7805,3,13,18,5,5,8,22,31,-9,15,21,20
11672,7799,7805,4,2,18,10,5,3,28,14,14,25,11,35
11673,7799,7805,21,4,18,10,4,4,27,13,14,24,12,34
11674,7799,7805,17,6,18,9,4,5,26,23,3,22,14,31
11675,7799,7805,19,11,18,6,5,7,22,31,-9,17,19,23
11676,7799,7805,8,12,18,6,4,8,20,26,-6,16,20,22
11677,7799,7805,12,9,18,7,5,6,21,18,3,19,17,26
11678,7799,7805,1,17,18,3,4,11,21,31,-10,10,26,13
11679,7855,7861,1,17,25,5,7,13,32,42,-10,17,33,22
11680,7855,7861,17,5,25,12,5,8,36,35,1,29,21,41
11681,7855,7861,19,11,25,8,7,10,33,41,-8,23,27,31
11682,7855,7861,8,15,25,6,7,12,24,38,-14,19,31,25
11683,7855,7861,52,9,25,10,4,11,33,30,3,24,26,34
11684,7855,7861,3,16,25,6,7,12,27,47,-20,19,31,25
11685,7855,7861,49,2,25,13,9,3,40,21,19,35,15,48
11686,7855,7861,37,8,25,10,9,6,31,20,11,29,21,39
11687,7855,7861,43,1,25,14,7,4,43,24,19,35,15,49
11688,7855,7861,22,13,25,7,7,11,18,30,-12,21,29,28
11689,7855,7861,57,14,25,6,7,12,38,47,-9,19,31,25
11690,7855,7861,24,18,25,5,4,16,23,42,-19,14,36,19
11691,7855,7861,12,6,25,11,8,6,40,27,13,30,20,41
11692,7855,7861,56,7,25,11,7,7,30,27,3,29,21,40
11693,7855,7861,20,10,25,8,8,9,25,23,2,24,26,32
11694,12307,12404,35,10,34,11,10,13,49,48,1,32,36,43
11695,12307,12404,6,11,34,10,10,14,42,50,-8,30,38,40
11696,12307,12404,41,13,34,9,11,14,40,59,-19,29,39,38
11697,12307,12404,20,17,34,6,7,21,32,62,-30,19,49,25
11698,12307,12404,21,5,34,14,13,7,44,38,6,41,27,55
11699,12307,12404,9,7,34,10,16,8,45,41,4,36,32,46
11700,12307,12404,4,15,34,7,13,14,43,57,-14,27,41,34
11701,12307,12404,52,16,34,7,11,16,32,49,-17,25,43,32
11702,12307,12404,43,1,34,24,7,3,79,31,48,55,13,79
11703,12307,12404,24,8,34,10,15,9,40,40,0,35,33,45
11704,12307,12404,57,12,34,9,11,14,52,63,-11,29,39,38
11705,12307,12404,22,18,34,4,10,20,38,79,-41,18,50,22
11706,12307,12404,27,3,34,18,5,11,61,49,12,41,27,59
11707,12307,12404,1,2,34,20,13,1,54,19,35,53,15,73
11708,12307,12404,17,14,34,7,14,13,30,42,-12,28,40,35
11709,12496,12502,17,5,12,6,2,4,24,18,6,14,10,20
11710,12496,12502,1,3,12,6,3,3,25,12,13,15,9,21
11711,12496,12502,52,10,12,3,7,2,13,13,0,13,11,16
11712,12496,12502,28,14,12,3,4,5,12,18,-6,10,14,13
11713,12496,12502,27,15,12,3,4,5,9,15,-6,10,14,13
11714,12496,12502,43,1,12,8,2,2,27,15,12,18,6,26
11715,12496,12502,24,4,12,6,3,3,16,12,4,15,9,21
11716,12496,12502,34,9,12,4,4,4,21,24,-3,12,12,16
11717,12496,12502,57,12,12,4,2,6,12,19,-7,10,14,14
11718,12496,12502,4,7,12,5,3,4,20,19,1,13,11,18
11719,12496,12502,21,11,12,4,3,5,21,21,0,11,13,15
11720,12496,12502,9,17,12,3,2,7,14,25,-11,8,16,11
11721,12496,12502,13,6,12,5,4,3,20,14,6,14,10,19
11722,12496,12502,35,13,12,3,4,5,21,17,4,10,14,13
11723,12496,12502,6,16,12,3,2,7,11,18,-7,8,16,11
11724,12496,12502,41,18,12,1,4,7,16,27,-11,6,18,7
11725,12496,12502,49,2,12,8,2,2,20,9,11,18,6,26
11726,12496,12502,37,8,12,5,1,6,17,23,-6,11,13,16
11727,12601,12607,49,2,25,17,5,3,40,18,22,39,11,56
11728,12601,12607,37,13,25,7,9,9,30,35,-5,23,27,30
11729,12601,12607,35,6,25,9,9,7,43,28,15,27,23,36
11730,12601,12607,6,7,25,9,7,9,30,31,-1,25,25,34
11731,12601,12607,13,10,25,8,8,9,38,34,4,24,26,32
11732,12601,12607,41,18,25,3,6,16,25,53,-28,12,38,15
11733,12601,12607,21,14,25,8,5,12,35,40,-5,21,29,29
11734,12601,12607,4,15,25,7,6,12,28,42,-14,20,30,27
11735,12601,12607,9,17,25,3,8,14,25,57,-32,14,36,17
11736,12601,12607,28,8,25,8,10,7,27,29,-2,26,24,34
11737,12601,12607,52,11,25,8,8,9,30,31,-1,24,26,32
11738,12601,12607,43,1,25,18,5,2,66,24,42,41,9,59
11739,12601,12607,34,4,25,11,5,9,51,50,1,27,23,38
11740,12601,12607,24,12,25,8,6,11,26,34,-8,22,28,30
11741,12601,12607,57,16,25,6,6,13,31,44,-13,18,32,24
11742,12601,12607,1,3,25,15,5,5,54,23,31,35,15,50
11743,12601,12607,27,9,25,8,9,8,24,30,-6,25,25,33
11744,12601,12607,17,5,25,10,7,8,39,39,0,27,23,37
11745,12629,12635,17,6,28,11,7,10,40,44,-4,29,27,40
11746,12629,12635,27,10,28,9,9,10,26,34,-8,27,29,36
11747,12629,12635,1,3,28,17,6,5,60,26,34,40,16,57
11748,12629,12635,43,1,28,19,6,3,70,27,43,44,12,63
11749,12629,12635,34,4,28,12,7,9,55,53,2,31,25,43
11750,12629,12635,24,12,28,9,8,11,32,36,-4,26,30,35
11751,12629,12635,57,16,28,7,7,14,33,46,-13,21,35,28
11752,12629,12635,28,11,28,8,12,8,28,31,-3,28,28,36
11753,12629,12635,52,13,28,8,10,10,30,32,-2,26,30,34
11754,12629,12635,4,8,28,10,6,12,35,42,-7,26,30,36
11755,12629,12635,21,15,28,8,6,14,38,46,-8,22,34,30
11756,12629,12635,9,18,28,3,8,17,26,67,-41,14,42,17
11757,12629,12635,35,5,28,10,11,7,46,30,16,31,25,41
11758,12629,12635,6,7,28,10,8,10,33,33,0,28,28,38
11759,12629,12635,13,9,28,9,9,10,43,39,4,27,29,36
11760,12629,12635,41,17,28,4,6,18,28,56,-28,14,42,18
11761,12629,12635,49,2,28,19,6,3,44,19,25,44,12,63
11762,12629,12635,37,14,28,8,10,10,32,38,-6,26,30,34
11763,12643,12656,49,1,30,19,8,3,44,19,25,46,14,65
11764,12643,12656,37,13,30,9,11,10,35,38,-3,29,31,38
11765,12643,12656,35,5,30,11,11,8,50,32,18,33,27,44
11766,12643,12656,6,6,30,11,8,11,37,35,2,30,30,41
11767,12643,12656,13,11,30,10,9,11,46,41,5,29,31,39
11768,12643,12656,41,18,30,4,7,19,29,60,-31,15,45,19
11769,12643,12656,4,8,30,11,7,12,37,43,-6,29,31,40
11770,12643,12656,21,16,30,8,6,16,38,49,-11,22,38,30
11771,12643,12656,9,17,30,4,8,18,29,72,-43,16,44,20
11772,5573,5579,57,10,15,4,7,4,21,18,3,15,15,19
11773,5573,5579,40,12,15,2,8,5,15,20,-5,12,18,14
11774,5573,5579,24,14,15,2,7,6,17,22,-5,11,19,13
11775,5580,5586,43,4,16,9,4,3,31,19,12,22,10,31
11776,5580,5586,57,11,16,4,8,4,22,19,3,16,16,20
11777,5580,5586,40,13,16,2,9,5,16,21,-5,13,19,15
11778,5580,5586,24,15,16,2,7,7,19,26,-7,11,21,13
11779,5580,5586,17,7,16,8,3,5,31,20,11,19,13,27
11780,5580,5586,8,14,16,5,2,9,13,29,-16,12,20,17
11781,5580,5586,20,6,16,7,6,3,24,15,9,20,12,27
11782,5580,5586,41,12,16,5,4,7,26,33,-7,14,18,19
11783,5580,5586,52,2,16,9,4,3,30,15,15,22,10,31
11784,5580,5586,12,3,17,10,2,5,33,20,13,22,12,32
11785,5580,5586,53,9,16,6,5,5,26,27,-1,17,15,23
11786,5580,5586,37,5,17,7,6,4,19,8,11,20,14,27
11787,5580,5586,49,8,16,7,5,4,22,19,3,19,13,26
11788,5580,5586,5,16,16,2,7,7,14,22,-8,11,21,13
11789,5580,5586,21,10,16,6,5,5,20,24,-4,17,15,23
11790,5580,5586,1,1,16,11,3,2,35,14,21,25,7,36
11791,5580,5586,54,17,16,4,2,10,9,28,-19,10,22,14
11792,5580,5586,48,19,16,1,6,9,11,30,-19,8,24,9
11793,5580,5586,27,18,16,2,4,10,16,28,-12,8,24,10
11794,5622,5628,27,17,21,4,5,12,25,41,-16,13,29,17
11795,5622,5628,17,9,21,10,3,8,40,30,10,23,19,33
11796,5622,5628,8,15,21,5,5,11,16,35,-19,15,27,20
11797,5622,5628,21,8,21,9,6,6,26,28,-2,24,18,33
11798,5622,5628,37,5,21,9,8,4,25,11,14,26,16,35
11799,5622,5628,49,7,21,9,6,6,30,25,5,24,18,33
11800,5622,5628,5,13,21,4,9,8,25,31,-6,17,25,21
11801,5622,5628,52,3,20,11,5,4,37,20,17,27,13,38
11802,5622,5628,48,18,21,2,8,11,15,37,-22,12,30,14
11803,5622,5628,54,19,20,4,3,13,11,38,-27,11,29,15
11804,5622,5628,12,4,21,12,2,7,41,25,16,26,16,38
11805,5622,5628,53,10,21,8,7,6,33,33,0,23,19,31
11806,5622,5628,20,6,21,9,7,5,41,24,17,25,17,34
11807,5622,5628,41,12,21,7,7,7,34,36,-2,21,21,28
11808,5622,5628,43,2,20,12,4,4,42,24,18,28,12,40
11809,5622,5628,57,11,21,6,9,6,30,31,-1,21,21,27
11810,5622,5628,24,14,21,4,8,9,24,32,-8,16,26,20
11811,5622,5628,40,16,21,2,10,9,17,33,-16,14,28,16
11812,5622,5628,1,1,21,13,4,4,44,22,22,30,12,43
11813,5695,5698,1,1,32,21,6,5,71,28,43,48,16,69
11814,5695,5698,24,13,32,9,9,14,41,53,-12,27,37,36
11815,5695,5698,40,15,31,5,14,12,35,53,-18,24,38,29
11816,5695,5698,37,7,31,12,13,6,32,20,12,37,25,49
11817,5695,5698,49,9,31,13,8,10,47,41,6,34,28,47
11818,5695,5698,20,6,31,13,11,7,50,33,17,37,25,50
11819,5695,5698,21,11,31,10,11,10,31,41,-10,31,31,41
11820,5695,5698,43,3,31,16,8,7,57,34,23,40,22,56
11821,5695,5698,57,10,32,9,13,10,40,42,-2,31,33,40
11822,5695,5698,41,12,31,10,9,12,49,54,-5,29,33,39
11823,5695,5698,12,2,32,19,4,9,57,31,26,42,22,61
11824,5695,5698,53,5,31,15,8,8,53,45,8,38,24,53
11825,5695,5698,52,4,31,14,10,7,47,26,21,38,24,52
11826,5695,5698,48,18,32,4,10,18,20,52,-32,18,46,22
11827,5695,5698,54,19,31,4,6,21,17,58,-41,14,48,18
11828,5695,5698,5,14,31,9,9,13,36,50,-14,27,35,36
11829,5695,5698,17,8,31,14,8,9,55,37,18,36,26,50
11830,5695,5698,8,16,31,7,8,16,25,48,-23,22,40,29
11831,5695,5698,27,17,31,7,7,17,43,60,-17,21,41,28
11832,5482,5488,27,18,5,0,1,4,2,9,-7,1,9,1
11833,5482,5488,1,7,4,2,1,1,7,4,3,5,3,7
11834,5482,5488,52,2,5,4,0,1,12,4,8,8,2,12
11835,5482,5488,48,12,4,1,2,1,5,5,0,4,4,5
11836,5482,5488,54,16,5,1,1,3,3,11,-8,3,7,4
11837,5482,5488,21,1,5,4,1,0,11,3,8,9,1,13
11838,5482,5488,20,4,4,3,1,0,10,1,9,7,1,10
11839,5482,5488,41,11,5,2,1,2,7,9,-2,5,5,7
11840,5482,5488,12,3,5,4,0,1,13,6,7,8,2,12
11841,5482,5488,53,9,5,2,1,2,8,9,-1,5,5,7
11842,5482,5488,17,5,5,3,1,1,9,3,6,7,3,10
11843,5482,5488,8,19,4,0,1,3,1,11,-10,1,7,1
11844,5482,5488,37,6,5,1,4,0,3,2,1,6,4,7
11845,5482,5488,5,8,5,1,3,1,5,5,0,5,5,6
11846,5482,5488,49,10,5,2,1,2,3,4,-1,5,5,7
11847,5482,5488,40,13,5,0,3,2,2,4,-2,3,7,3
11848,5482,5488,57,14,5,0,3,2,5,8,-3,3,7,3
11849,5482,5488,43,14,5,0,3,2,5,8,-3,3,7,3
11850,5482,5488,24,17,4,0,2,2,0,5,-5,2,6,2
11851,9738,9744,1,3,30,17,7,6,62,28,34,41,19,58
11852,9738,9744,27,6,30,13,7,10,43,42,1,33,27,46
11853,9738,9744,52,14,30,6,11,13,29,47,-18,23,37,29
11854,9738,9744,48,18,30,4,7,19,17,70,-53,15,45,19
11855,9738,9744,21,15,30,6,9,15,34,43,-9,21,39,27
11856,9738,9744,4,16,30,6,9,15,24,47,-23,21,39,27
11857,9738,9744,12,4,30,15,8,7,51,37,14,38,22,53
11858,9738,9744,53,9,30,10,10,10,31,34,-3,30,30,40
11859,9745,9751,12,4,31,15,8,8,52,39,13,38,24,53
11860,9745,9751,53,9,31,10,11,10,32,35,-3,31,31,41
11861,9745,9751,4,15,31,7,9,15,25,47,-22,23,39,30
11862,9745,9751,21,16,31,6,9,16,34,44,-10,21,41,27
11863,9745,9751,52,13,31,7,11,13,31,48,-17,25,37,32
11864,9745,9751,48,18,31,4,7,20,17,71,-54,15,47,19
11865,9745,9751,27,7,31,13,8,10,44,43,1,34,28,47
11866,9745,9751,1,3,31,17,7,7,62,29,33,41,21,58
11867,9745,9751,43,1,31,22,7,2,75,25,50,51,11,73
11868,9745,9751,24,2,31,22,7,2,50,12,38,51,11,73
11869,9745,9751,2,11,31,9,11,11,32,40,-8,29,33,38
11870,9745,9751,57,12,31,7,11,13,33,39,-6,25,37,32
11871,9745,9751,37,5,31,13,14,4,41,23,18,40,22,53
11872,9745,9751,49,10,31,9,11,11,37,33,4,29,33,38
11873,9745,9751,41,6,31,13,8,10,39,34,5,34,28,47
11874,9745,9751,20,8,31,12,7,12,41,39,2,31,31,43
11875,9745,9751,56,14,31,8,6,17,34,47,-13,22,40,30
11876,9745,9751,13,17,31,5,8,18,29,60,-31,18,44,23
11877,10116,10122,41,5,33,13,16,4,48,27,21,42,24,55
11878,10116,10122,20,6,33,15,7,11,49,43,6,37,29,52
11879,10116,10122,56,9,33,11,8,14,40,54,-14,30,36,41
11880,10116,10122,49,11,33,10,8,15,43,49,-6,28,38,38
11881,10116,10122,37,14,33,8,10,15,35,37,-2,26,40,34
11882,10116,10122,21,3,33,20,9,4,73,37,36,49,17,69
11883,10116,10122,1,1,33,23,5,5,74,33,41,51,15,74
11884,10116,10122,27,8,33,11,9,13,38,47,-9,31,35,42
11885,10116,10122,28,10,33,10,9,14,29,37,-8,29,37,39
11886,10116,10122,52,16,33,7,12,14,31,47,-16,26,40,33
11887,10116,10122,4,17,33,8,8,17,33,59,-26,24,42,32
11888,10116,10122,53,12,33,10,7,16,38,45,-7,27,39,37
11889,10116,10122,12,13,33,9,8,16,42,45,-3,26,40,35
11890,10116,10122,24,2,33,21,6,6,49,23,26,48,18,69
11891,10116,10122,43,4,33,17,9,7,63,27,36,43,23,60
11892,10116,10122,57,7,33,12,8,13,48,45,3,32,34,44
11893,10116,10122,22,15,33,9,6,18,30,74,-44,24,42,33
11894,10116,10122,2,18,33,7,7,19,21,55,-34,21,45,28
11895,10382,10395,24,1,21,16,4,1,43,13,30,36,6,52
11896,10382,10395,43,2,21,15,4,2,55,20,35,34,8,49
11897,10382,10395,57,17,21,4,4,13,21,34,-13,12,30,16
11898,10382,10395,22,18,21,2,7,12,12,43,-31,11,31,13
11899,10382,10395,21,5,21,9,8,4,38,26,12,26,16,35
11900,10382,10395,28,6,21,9,5,7,23,26,-3,23,19,32
11901,10382,10395,52,14,21,6,3,12,18,37,-19,15,27,21
11902,10382,10395,54,15,21,5,5,11,24,39,-15,15,27,20
11903,10382,10395,27,13,21,4,10,7,19,31,-12,18,24,22
11904,10382,10395,1,4,21,11,6,4,42,21,21,28,14,39
11905,10382,10395,17,16,21,5,5,11,14,33,-19,15,27,20
11906,10382,10395,12,11,21,5,7,9,25,31,-6,17,25,22
11907,10382,10395,53,12,21,5,7,9,24,32,-8,17,25,22
11908,10382,10395,49,8,21,8,6,7,29,27,2,22,20,30
11909,10382,10395,37,10,21,6,5,10,23,30,-7,17,25,23
11910,10382,10395,41,3,21,11,7,3,43,16,27,29,13,40
11911,10382,10395,20,7,21,9,3,9,33,33,0,21,21,30
11912,10382,10395,56,9,21,7,8,6,34,28,6,22,20,29
11913,10574,10577,56,4,1,1,0,0,3,1,2,2,0,3
11914,10574,10577,41,14,1,0,0,1,0,1,-1,0,2,0
11915,10574,10577,35,15,1,0,0,1,1,3,-2,0,2,0
11916,10574,10577,20,18,1,0,0,1,0,6,-6,0,2,0
11917,10574,10577,49,6,1,0,1,0,1,1,0,1,1,1
11918,10574,10577,21,10,1,0,1,0,0,0,0,1,1,1
11919,10574,10577,4,16,1,0,0,1,0,3,-3,0,2,0
11920,10574,10577,43,1,1,1,0,0,6,0,6,2,0,3
11921,10574,10577,24,2,1,1,0,0,3,0,3,2,0,3
11922,10574,10577,57,5,1,1,0,0,1,0,1,2,0,3
11923,10574,10577,17,10,1,0,1,0,0,0,0,1,1,1
11924,10574,10577,1,6,1,0,1,0,1,1,0,1,1,1
11925,10574,10577,28,6,1,0,1,0,1,1,0,1,1,1
11926,10574,10577,54,16,1,0,0,1,0,3,-3,0,2,0
11927,10574,10577,27,2,1,1,0,0,3,0,3,2,0,3
11928,10574,10577,37,6,1,0,1,0,1,1,0,1,1,1
11929,10574,10577,53,10,1,0,1,0,0,0,0,1,1,1
11930,9150,9156,20,3,8,4,2,2,14,4,10,10,6,14
11931,9150,9156,41,9,8,3,1,4,13,13,0,7,9,10
11932,9150,9156,13,12,8,2,4,2,6,7,-1,8,8,10
11933,9150,9156,56,16,8,1,3,4,8,14,-6,5,11,6
11934,9150,9156,43,2,8,4,3,1,19,9,10,11,5,15
11935,9150,9156,57,10,8,3,1,4,13,14,-1,7,9,10
11936,9150,9156,24,18,8,0,4,4,4,15,-11,4,12,4
11937,9150,9156,4,4,8,4,2,2,11,8,3,10,6,14
11938,9150,9156,21,15,8,1,4,3,7,12,-5,6,10,7
11939,9150,9156,52,14,8,1,4,3,8,12,-4,6,10,7
11940,9150,9156,53,7,8,3,3,2,9,8,1,9,7,12
11941,9150,9156,12,11,8,2,4,2,8,9,-1,8,8,10
11942,9150,9156,37,5,8,4,2,2,15,14,1,10,6,14
11943,9150,9156,49,6,8,3,4,1,9,8,1,10,6,13
11944,9150,9156,27,17,8,1,2,5,8,14,-6,4,12,5
11945,9150,9156,17,8,8,3,3,2,9,10,-1,9,7,12
11946,9150,9156,19,13,8,2,3,3,10,14,-4,7,9,9
11947,9150,9156,1,1,8,6,1,1,23,9,14,13,3,19
11948,9577,9583,27,3,12,7,2,3,17,13,4,16,8,23
11949,9577,9583,52,16,12,2,3,7,12,24,-12,7,17,9
11950,9577,9583,48,18,12,0,3,9,4,28,-24,3,21,3
11951,9577,9583,1,2,12,8,3,1,31,10,21,19,5,27
11952,9577,9583,12,4,12,6,5,1,16,11,5,17,7,23
11953,9577,9583,53,11,12,3,6,3,10,15,-5,12,12,15
11954,9577,9583,4,12,12,4,1,7,11,22,-11,9,15,13
11955,9577,9583,21,17,12,0,3,9,7,24,-17,3,21,3
11956,9577,9583,43,1,12,10,1,1,32,6,26,21,3,31
11957,9577,9583,24,6,12,6,4,2,18,7,11,16,8,22
11958,9577,9583,2,10,12,4,3,5,12,18,-6,11,13,15
11959,9577,9583,57,14,12,3,2,7,16,16,0,8,16,11
11960,9577,9583,49,5,12,6,4,2,21,9,12,16,8,22
11961,9577,9583,37,7,12,5,7,0,17,7,10,17,7,22
11962,9577,9583,41,8,12,5,4,3,18,14,4,14,10,19
11963,9577,9583,13,9,12,4,3,5,14,17,-3,11,13,15
11964,9577,9583,56,13,12,3,3,6,16,17,-1,9,15,12
11965,9577,9583,20,15,12,3,1,8,11,25,-14,7,17,10
11966,9661,9674,37,4,20,10,10,0,30,11,19,30,10,40
11967,9661,9674,49,9,20,7,6,7,26,18,8,20,20,27
11968,9661,9674,52,16,20,4,5,11,20,35,-15,13,27,17
11969,9661,9674,48,18,20,2,4,14,8,51,-43,8,32,10
11970,9661,9674,4,13,20,5,4,11,16,33,-17,14,26,19
11971,9661,9674,21,14,20,4,6,10,24,33,-9,14,26,18
11972,9661,9674,43,1,20,14,5,1,53,13,40,33,7,47
11973,9661,9674,24,2,20,13,5,2,32,9,23,31,9,44
11974,9661,9674,2,10,20,6,6,8,22,29,-7,18,22,24
11975,9661,9674,57,12,20,5,6,9,24,23,1,16,24,21
11976,9661,9674,41,6,20,10,4,6,27,19,8,24,16,34
11977,9661,9674,20,8,20,8,3,9,27,30,-3,19,21,27
11978,9661,9674,13,15,20,4,5,11,22,35,-13,13,27,17
11979,9661,9674,56,17,20,3,4,13,19,34,-15,10,30,13
11980,9661,9674,27,7,20,10,3,7,27,26,1,23,17,33
11981,9661,9674,12,5,20,10,7,3,30,22,8,27,13,37
11982,9661,9674,53,11,20,5,8,7,17,24,-7,18,22,23
11983,9661,9674,1,3,20,12,5,3,41,20,21,29,11,41
11984,9675,9681,1,3,21,13,5,3,42,20,22,31,11,44
11985,9675,9681,12,5,21,11,7,3,31,22,9,29,13,40
11986,9675,9681,53,10,21,6,8,7,18,24,-6,20,22,26
11987,9675,9681,27,7,21,10,3,8,27,28,-1,23,19,33
11988,9675,9681,41,6,21,10,4,7,27,20,7,24,18,34
11989,9675,9681,20,8,21,8,4,9,28,31,-3,20,22,28
11990,9675,9681,52,15,21,4,6,11,22,37,-15,14,28,18
11991,9675,9681,48,18,21,3,4,14,12,51,-39,10,32,13
11992,9675,9681,43,1,21,15,5,1,55,13,42,35,7,50
11993,9675,9681,24,2,21,14,5,2,33,9,24,33,9,47
11994,9675,9681,2,11,21,6,7,8,23,30,-7,19,23,25
11995,9675,9681,57,12,21,5,6,10,24,24,0,16,26,21
11996,9675,9681,4,13,21,5,4,12,16,36,-20,14,28,19
11997,9675,9681,21,14,21,4,6,11,24,34,-10,14,28,18
11998,9675,9681,37,4,21,10,11,0,32,13,19,31,11,41
11999,9675,9681,49,9,21,7,6,8,26,19,7,20,22,27
12000,9675,9681,13,16,21,4,5,12,22,39,-17,13,29,17
12001,9675,9681,56,17,21,4,4,13,22,34,-12,12,30,16
12002,9759,9765,41,6,33,14,9,10,43,37,6,37,29,51
12003,9759,9765,20,8,33,12,8,13,41,41,0,32,34,44
12004,9759,9765,56,15,33,8,7,18,36,51,-15,23,43,31
12005,9759,9765,13,17,33,5,9,19,29,62,-33,19,47,24
12006,9759,9765,12,4,33,17,8,8,57,40,17,42,24,59
12007,9759,9765,53,10,33,10,11,12,33,38,-5,31,35,41
12008,9759,9765,21,14,33,8,9,16,40,46,-6,25,41,33
12009,10746,10752,56,13,20,5,7,8,16,29,-13,17,23,22
12010,10746,10752,20,17,20,3,5,12,19,43,-24,11,29,14
12011,10746,10752,49,6,20,8,7,5,27,20,7,23,17,31
12012,10746,10752,37,14,20,5,4,11,18,34,-16,14,26,19
12013,10746,10752,21,3,20,10,8,2,42,19,23,28,12,38
12014,10746,10752,4,8,20,7,7,6,22,20,2,21,19,28
12015,10746,10752,43,2,20,13,4,3,42,8,34,30,10,43
12016,10746,10752,1,1,20,14,4,2,40,16,24,32,8,46
12017,10746,10752,57,5,20,9,6,5,30,21,9,24,16,33
12018,10746,10752,17,7,20,8,4,8,27,36,-9,20,20,28
12019,11117,11123,17,14,23,4,9,10,13,28,-15,17,29,21
12020,11117,11123,43,1,23,16,5,2,57,15,42,37,9,53
12021,11117,11123,24,5,23,12,7,4,37,20,17,31,15,43
12022,11117,11123,57,11,23,7,5,11,26,47,-21,19,27,26
12023,11117,11123,22,13,23,5,6,12,20,52,-32,16,30,21
12024,11117,11123,4,2,23,15,6,2,51,24,27,36,10,51
12025,11117,11123,21,9,23,6,11,6,37,31,6,23,23,29
12026,11117,11123,27,10,23,5,12,6,22,21,1,22,24,27
12027,11117,11123,49,4,23,12,8,3,37,24,13,32,14,44
12028,11117,11123,12,7,23,8,6,9,29,28,1,22,24,30
12029,11117,11123,53,15,23,5,4,14,27,47,-20,14,32,19
12030,11117,11123,52,16,23,4,7,12,19,33,-14,15,31,19
12031,11117,11123,28,17,23,4,7,12,17,33,-16,15,31,19
12032,11117,11123,35,6,23,11,5,7,42,30,12,27,19,38
12033,11117,11123,41,8,23,7,8,8,27,27,0,22,24,29
12034,11117,11123,20,12,23,5,9,9,20,31,-11,19,27,24
12035,11117,11123,56,18,23,5,3,15,26,42,-16,13,33,18
12036,11117,11123,1,3,23,13,8,2,42,16,26,34,12,47
12037,11201,11207,17,16,31,6,11,14,19,39,-20,23,39,29
12038,11201,11207,43,1,31,22,6,3,72,20,52,50,12,72
12039,11201,11207,24,2,31,19,8,4,54,23,31,46,16,65
12040,11201,11207,52,11,31,9,8,14,33,41,-8,26,36,35
12041,11201,11207,28,17,31,5,10,16,24,46,-22,20,42,25
12042,11201,11207,49,6,31,14,10,7,45,37,8,38,24,52
12043,11201,11207,27,10,31,7,15,9,29,32,-3,29,33,36
12044,11201,11207,12,8,31,11,8,12,39,38,1,30,32,41
12045,11201,11207,53,18,31,5,5,21,29,61,-32,15,47,20
12046,11201,11207,21,7,31,10,13,8,49,38,11,33,29,43
12047,11201,11207,57,13,31,9,7,15,38,64,-26,25,37,34
12048,11201,11207,22,14,31,8,8,15,30,61,-31,24,38,32
12049,11201,11207,1,5,31,15,11,5,51,24,27,41,21,56
12050,11201,11207,4,3,31,18,7,6,60,34,26,43,19,61
12051,11201,11207,35,4,31,17,6,8,54,35,19,40,22,57
12052,11201,11207,41,9,31,9,9,13,34,41,-7,27,35,36
12053,11201,11207,20,12,31,8,11,12,32,41,-9,27,35,35
12054,11201,11207,56,15,31,8,5,18,36,53,-17,21,41,29
12055,10991,10997,20,10,8,2,3,3,9,8,1,7,9,9
12056,10991,10997,35,11,8,2,3,3,15,15,0,7,9,9
12057,10991,10997,41,12,8,2,2,4,9,11,-2,6,10,8
12058,10991,10997,49,1,8,6,2,0,18,5,13,14,2,20
12059,10991,10997,43,4,8,4,2,2,18,7,11,10,6,14
12060,10991,10997,24,5,8,4,2,2,17,11,6,10,6,14
12061,10991,10997,57,8,8,3,2,3,10,11,-1,8,8,11
12062,10991,10997,22,15,8,2,1,5,4,19,-15,5,11,7
12063,10991,10997,17,13,8,2,2,4,6,10,-4,6,10,8
12064,10991,10997,4,2,8,6,2,0,17,6,11,14,2,20
12065,10991,10997,21,7,8,3,2,3,11,11,0,8,8,11
12066,10991,10997,28,17,8,1,3,4,5,11,-6,5,11,6
12067,10991,10997,52,14,8,2,1,5,7,11,-4,5,11,7
12068,10991,10997,56,16,8,2,0,6,10,20,-10,4,12,6
12069,10991,10997,53,18,8,1,3,4,10,23,-13,5,11,6
12070,10991,10997,12,9,8,3,1,4,10,10,0,7,9,10
12071,10991,10997,27,6,8,3,3,2,10,7,3,9,7,12
12072,10991,10997,1,3,8,6,2,0,13,3,10,14,2,20
12073,11390,11403,43,1,13,9,3,1,23,6,17,21,5,30
12074,11390,11403,24,3,13,8,2,3,21,11,10,18,8,26
12075,11390,11403,57,9,13,5,4,4,23,25,-2,14,12,19
12076,11390,11403,22,15,13,3,2,8,9,16,-7,8,18,11
12077,11390,11403,34,17,13,2,3,8,6,21,-15,7,19,9
12078,11390,11403,12,14,13,2,6,5,16,17,-1,10,16,12
12079,11390,11403,52,16,13,3,2,8,13,24,-11,8,18,11
12080,11390,11403,56,13,13,3,5,5,12,22,-10,11,15,14
12081,11390,11403,27,18,13,1,3,9,6,19,-13,5,21,6
12082,11390,11403,49,4,13,7,5,1,22,10,12,19,7,26
12083,11390,11403,37,11,13,4,4,5,18,17,1,12,14,16
12084,11390,11403,17,6,13,6,3,4,21,20,1,15,11,21
12085,11390,11403,1,2,13,8,3,2,31,13,18,19,7,27
12086,11390,11403,21,5,13,7,1,5,17,15,2,15,11,22
12087,11390,11403,4,8,13,5,4,4,21,21,0,14,12,19
12088,10574,10577,12,10,1,0,1,0,0,0,0,1,1,1
12089,10760,10766,12,8,22,8,7,7,26,37,-11,23,21,31
12090,10760,10766,53,15,22,5,6,11,19,38,-19,16,28,21
12091,10760,10766,43,2,22,15,4,3,54,8,46,34,10,49
12092,10760,10766,24,3,22,11,10,1,37,9,28,32,12,43
12093,10760,10766,57,5,22,10,6,6,35,24,11,26,18,36
12094,10760,10766,21,4,22,11,8,3,46,20,26,30,14,41
12095,10760,10766,4,7,22,8,8,6,25,22,3,24,20,32
12096,10760,10766,28,14,22,5,7,10,18,33,-15,17,27,22
12097,10760,10766,54,17,22,3,7,12,16,33,-17,13,31,16
12098,10760,10766,27,10,22,7,6,9,29,32,-3,20,24,27
12099,10760,10766,17,9,22,8,4,10,27,39,-12,20,24,28
12100,10760,10766,1,1,22,15,5,2,46,18,28,35,9,50
12101,10760,10766,49,6,22,9,8,5,30,21,9,26,18,35
12102,10760,10766,37,16,22,5,4,13,19,41,-22,14,30,19
12103,10760,10766,41,11,22,6,7,9,20,21,-1,19,25,25
12104,10760,10766,56,12,22,6,7,9,21,32,-11,19,25,25
12105,10760,10766,35,13,22,7,2,13,24,38,-14,16,28,23
12106,10760,10766,20,18,22,3,6,13,20,46,-26,12,32,15
12107,10592,10598,4,6,3,2,0,1,5,5,0,4,2,6
12108,10592,10598,21,14,3,0,2,1,2,4,-2,2,4,2
12109,10592,10598,1,13,3,0,2,1,3,5,-2,2,4,2
12110,10592,10598,17,16,3,0,1,2,0,9,-9,1,5,1
12111,10592,10598,28,14,3,0,2,1,2,4,-2,2,4,2
12112,10592,10598,54,18,3,0,0,3,3,8,-5,0,6,0
12113,10592,10598,49,7,3,1,2,0,6,2,4,4,2,5
12114,10592,10598,37,12,3,0,3,0,2,2,0,3,3,3
12115,10592,10598,27,4,3,2,0,1,7,4,3,4,2,6
12116,10592,10598,24,1,3,3,0,0,7,1,6,6,0,9
12117,10592,10598,43,2,3,2,1,0,9,2,7,5,1,7
12118,10592,10598,57,5,3,2,0,1,4,2,2,4,2,6
12119,10592,10598,56,2,3,2,1,0,9,2,7,5,1,7
12120,10592,10598,20,10,3,1,1,1,3,8,-5,3,3,4
12121,10592,10598,41,11,3,1,0,2,2,2,0,2,4,3
12122,10592,10598,35,17,3,0,0,3,2,6,-4,0,6,0
12123,10592,10598,53,8,3,1,2,0,1,0,1,4,2,5
12124,10592,10598,12,9,3,1,1,1,5,6,-1,3,3,4
12125,10816,10822,21,4,30,13,11,6,55,31,24,37,23,50
12126,10816,10822,4,6,30,10,12,8,39,33,6,32,28,42
12127,10816,10822,49,5,30,13,10,7,48,28,20,36,24,49
12128,10816,10822,37,17,30,6,7,17,23,52,-29,19,41,25
12129,10816,10822,28,15,30,7,10,13,22,40,-18,24,36,31
12130,10816,10822,54,18,30,4,9,17,23,55,-32,17,43,21
12131,10816,10822,12,11,30,9,9,12,30,54,-24,27,33,36
12132,10816,10822,53,12,30,9,8,13,29,45,-16,26,34,35
12133,10816,10822,1,1,30,22,6,2,68,19,49,50,10,72
12134,10816,10822,27,10,30,9,9,12,39,45,-6,27,33,36
12135,10816,10822,43,2,30,22,4,4,69,14,55,48,12,70
12136,10816,10822,24,3,30,17,11,2,59,10,49,45,15,62
12137,10816,10822,57,7,30,11,7,12,42,41,1,29,31,40
12138,10816,10822,17,9,30,10,6,14,36,56,-20,26,34,36
12139,10816,10822,56,8,30,11,7,12,35,42,-7,29,31,40
12140,10816,10822,35,13,30,9,6,15,36,48,-12,24,36,33
12141,10816,10822,41,14,30,7,10,13,27,39,-12,24,36,31
12142,10816,10822,20,16,30,6,8,16,30,58,-28,20,40,26
12143,11089,11095,35,6,19,8,5,6,37,28,9,21,17,29
12144,11089,11095,41,11,19,5,7,7,22,23,-1,17,21,22
12145,11089,11095,20,13,19,4,6,9,17,29,-12,14,24,18
12146,11089,11095,56,16,19,4,3,12,20,35,-15,11,27,15
12147,11089,11095,43,2,19,13,4,2,48,12,36,30,8,43
12148,11089,11095,24,5,19,10,6,3,35,19,16,26,12,36
12149,11089,11095,57,10,19,6,4,9,23,34,-11,16,22,22
12150,11089,11095,4,1,19,13,5,1,41,18,23,31,7,44
12151,11089,11095,21,8,19,6,9,4,35,27,8,21,17,27
12152,11089,11095,49,4,19,10,7,2,31,19,12,27,11,37
12153,11089,11095,27,9,19,5,9,5,20,18,2,19,19,24
12154,11089,11095,1,3,19,10,7,2,29,16,13,27,11,37
12155,11089,11095,12,7,19,8,4,7,26,22,4,20,18,28
12156,11089,11095,53,17,19,4,3,12,23,42,-19,11,27,15
12157,11089,11095,17,15,19,3,7,9,10,24,-14,13,25,16
12158,11089,11095,28,14,19,3,7,9,14,28,-14,13,25,16
12159,11089,11095,52,18,19,3,5,11,16,31,-15,11,27,14
12160,11089,11095,22,12,19,5,4,10,18,40,-22,14,24,19
12161,11103,11109,41,10,21,6,7,8,25,26,-1,19,23,25
12162,11103,11109,20,13,21,4,8,9,19,31,-12,16,26,20
12163,11103,11109,56,18,21,4,3,14,21,39,-18,11,31,15
12164,11103,11109,12,7,21,8,5,8,27,24,3,21,21,29
12165,11103,11109,53,16,21,4,4,13,25,46,-21,12,30,16
12166,11103,11109,52,15,21,4,5,12,19,33,-14,13,29,17
12167,7855,7861,41,12,25,8,5,12,30,36,-6,21,29,29
12168,7855,7861,4,3,25,11,10,4,30,16,14,32,18,43
12169,7855,7861,21,4,25,12,6,7,31,18,13,30,20,42
12170,7694,7700,4,1,6,5,0,1,12,5,7,10,2,15
12171,7694,7700,41,3,6,4,0,2,13,7,6,8,4,12
12172,7694,7700,56,5,6,3,2,1,6,5,1,8,4,11
12173,7694,7700,20,14,6,1,2,3,6,6,0,4,8,5
12174,7694,7700,49,4,6,3,3,0,12,5,7,9,3,12
12175,7694,7700,43,2,6,4,1,1,14,5,9,9,3,13
12176,7694,7700,57,16,6,1,1,4,10,14,-4,3,9,4
12177,7694,7700,22,17,6,1,1,4,5,15,-10,3,9,4
12178,7694,7700,24,18,6,0,2,4,6,11,-5,2,10,2
12179,7694,7700,3,9,6,2,2,2,10,10,0,6,6,8
12180,7694,7700,52,12,6,2,1,3,6,9,-3,5,7,7
12181,7694,7700,37,10,6,2,2,2,6,7,-1,6,6,8
12182,7694,7700,17,8,6,3,1,2,9,9,0,7,5,10
12183,7694,7700,8,13,6,2,1,3,6,11,-5,5,7,7
12184,7694,7700,19,15,6,1,2,3,7,13,-6,4,8,5
12185,7694,7700,21,6,6,3,1,2,7,4,3,7,5,10
12186,7694,7700,1,11,6,2,1,3,10,10,0,5,7,7
12187,7694,7700,12,7,6,3,1,2,6,5,1,7,5,10
12188,7701,7707,12,5,7,4,1,2,7,5,2,9,5,13
12189,7701,7707,1,13,7,2,1,4,12,13,-1,5,9,7
12190,7701,7707,4,1,7,6,0,1,13,5,8,12,2,18
12191,7701,7707,21,7,7,3,2,2,7,4,3,8,6,11
12192,7701,7707,49,6,7,3,3,1,13,8,5,9,5,12
12193,7701,7707,37,12,7,2,2,3,6,8,-2,6,8,8
12194,7701,7707,52,9,7,3,1,3,10,11,-1,7,7,10
12195,7701,7707,3,11,7,2,2,3,10,11,-1,6,8,8
12196,7701,7707,43,2,7,5,1,1,17,7,10,11,3,16
12197,7701,7707,57,14,7,2,1,4,13,16,-3,5,9,7
12198,7701,7707,22,15,7,2,1,4,6,15,-9,5,9,7
12199,7701,7707,24,18,7,0,2,5,8,15,-7,2,12,2
12200,7701,7707,41,3,7,4,1,2,13,7,6,9,5,13
12201,7701,7707,56,8,7,3,2,2,8,8,0,8,6,11
12202,7701,7707,20,16,7,1,2,4,6,7,-1,4,10,5
12203,7701,7707,17,4,7,4,1,2,12,10,2,9,5,13
12204,7701,7707,8,10,7,3,1,3,9,12,-3,7,7,10
12205,7701,7707,19,17,7,1,2,4,8,16,-8,4,10,5
12206,8184,8190,19,5,20,9,6,5,31,25,6,24,16,33
12207,8184,8190,17,11,20,7,4,9,21,28,-7,18,22,25
12208,8184,8190,43,1,20,11,6,3,40,22,18,28,12,39
12209,8184,8190,57,13,20,6,6,8,25,28,-3,18,22,24
12210,8184,8190,22,17,20,3,5,12,22,33,-11,11,29,14
12211,8184,8190,52,9,20,7,7,6,22,19,3,21,19,28
12212,8184,8190,3,18,20,3,5,12,22,41,-19,11,29,14
12213,8184,8190,49,2,20,11,5,4,47,23,24,27,13,38
12214,8184,8190,37,7,20,7,8,5,40,22,18,22,18,29
12215,8184,8190,21,3,20,11,4,5,29,22,7,26,14,37
12216,8184,8190,4,8,20,7,8,5,29,26,3,22,18,29
12217,8184,8190,56,10,20,6,8,6,22,25,-3,20,20,26
12218,8184,8190,20,14,20,5,5,10,24,30,-6,15,25,20
12219,8184,8190,41,15,20,4,8,8,17,36,-19,16,24,20
12220,8184,8190,13,16,20,2,9,9,21,43,-22,13,27,15
12221,8184,8190,12,6,20,9,5,6,26,19,7,23,17,32
12222,8184,8190,53,12,20,6,7,7,27,35,-8,19,21,25
12223,8184,8190,1,4,20,10,6,4,33,21,12,26,14,36
12224,8044,8050,1,3,6,4,1,1,10,5,5,9,3,13
12225,8044,8050,53,1,6,4,2,0,11,7,4,10,2,14
12226,8044,8050,12,4,6,4,1,1,9,6,3,9,3,13
12227,8044,8050,56,10,6,2,2,2,8,9,-1,6,6,8
12228,8044,8050,20,12,6,2,0,4,7,10,-3,4,8,6
12229,8044,8050,41,13,6,1,3,2,2,11,-9,5,7,6
12230,8044,8050,13,17,6,0,4,2,4,8,-4,4,8,4
12231,8044,8050,4,16,6,0,4,2,6,8,-2,4,8,4
12232,8044,8050,19,8,6,2,3,1,7,4,3,7,5,9
12233,8044,8050,17,11,6,2,1,3,4,12,-8,5,7,7
12234,8044,8050,52,9,6,2,2,2,8,8,0,6,6,8
12235,8044,8050,3,14,6,1,2,3,6,9,-3,4,8,5
12236,8044,8050,37,5,6,3,2,1,12,4,8,8,4,11
12237,8044,8050,49,6,6,3,1,2,16,8,8,7,5,10
12238,8044,8050,43,2,6,4,1,1,11,5,6,9,3,13
12239,8044,8050,22,15,6,1,1,4,4,7,-3,3,9,4
12240,8044,8050,57,18,6,0,1,5,7,13,-6,1,11,1
12241,8044,8050,21,7,6,3,1,2,9,7,2,7,5,10
12242,8597,8603,12,12,26,8,7,11,30,38,-8,23,29,31
12243,8597,8603,43,2,26,14,7,5,59,33,26,35,17,49
12244,8597,8603,24,8,26,9,10,7,35,35,0,28,24,37
12245,8597,8603,57,9,26,10,6,10,27,24,3,26,26,36
12246,8597,8603,52,18,26,4,10,12,24,34,-10,18,34,22
12247,8597,8603,37,1,26,16,6,4,47,29,18,38,14,54
12248,12643,12656,28,10,30,9,13,8,29,31,-2,31,29,40
12249,12643,12656,52,14,30,9,10,11,32,36,-4,28,32,37
12250,12643,12656,43,2,30,19,6,5,71,30,41,44,16,63
12251,12643,12656,34,4,30,12,9,9,55,53,2,33,27,45
12252,12643,12656,24,12,30,10,8,12,34,40,-6,28,32,38
12253,12643,12656,57,15,30,8,8,14,37,47,-10,24,36,32
12254,12643,12656,27,9,30,10,10,10,28,35,-7,30,30,40
12255,12643,12656,17,7,30,11,8,11,41,46,-5,30,30,41
12256,12643,12656,1,3,30,18,7,5,62,27,35,43,17,61
12257,12447,12460,1,3,7,4,2,1,17,7,10,10,4,14
12258,12447,12460,17,5,7,4,0,3,18,14,4,8,6,12
12259,12447,12460,57,13,7,2,1,4,5,11,-6,5,9,7
12260,12447,12460,34,14,7,2,1,4,11,18,-7,5,9,7
12261,12447,12460,43,2,7,5,1,1,19,11,8,11,3,16
12262,12447,12460,24,6,7,4,0,3,11,9,2,8,6,12
12263,12447,12460,52,10,7,2,3,2,10,11,-1,7,7,9
12264,12447,12460,28,11,7,2,2,3,7,8,-1,6,8,8
12265,12447,12460,27,17,7,1,3,3,5,9,-4,5,9,6
12266,12447,12460,21,7,7,3,2,2,13,9,4,8,6,11
12267,12447,12460,4,8,7,3,2,2,11,11,0,8,6,11
12268,12447,12460,9,15,7,2,0,5,7,15,-8,4,10,6
12269,12447,12460,13,4,7,4,1,2,15,9,6,9,5,13
12270,12447,12460,49,1,7,5,2,0,14,3,11,12,2,17
12271,12447,12460,37,9,7,3,0,4,9,10,-1,6,8,9
12272,12447,12460,6,12,7,2,1,4,8,14,-6,5,9,7
12273,12447,12460,35,16,7,1,3,3,11,13,-2,5,9,6
12274,12447,12460,41,18,7,0,4,3,6,15,-9,4,10,4
12275,12811,12824,49,5,11,4,6,1,18,9,9,14,8,18
12276,12811,12824,37,10,11,4,2,5,14,14,0,10,12,14
12277,12811,12824,35,11,11,3,5,3,17,14,3,11,11,14
12278,12811,12824,13,15,11,3,2,6,14,20,-6,8,14,11
12279,12811,12824,20,17,11,1,3,7,8,24,-16,5,17,6
12280,12811,12824,6,18,11,1,2,8,10,21,-11,4,18,5
12281,12811,12824,21,14,11,3,2,6,14,18,-4,8,14,11
12282,12811,12824,4,16,11,2,3,6,14,21,-7,7,15,9
12283,12811,12824,43,3,11,6,2,3,21,12,9,14,8,20
12284,12811,12824,34,4,11,5,4,2,16,9,7,14,8,19
12285,12811,12824,24,9,11,4,3,4,16,22,-6,11,11,15
12286,12811,12824,57,12,11,2,7,2,14,17,-3,11,11,13
12287,12811,12824,52,6,11,4,6,1,12,10,2,14,8,18
12288,12811,12824,28,13,11,3,3,5,14,21,-7,9,13,12
12289,12811,12824,17,2,11,6,3,2,18,12,6,15,7,21
12290,12811,12824,27,8,11,4,5,2,21,18,3,13,9,17
12291,12811,12824,1,1,11,8,2,1,27,8,19,18,4,26
12292,12811,12824,47,7,11,5,2,4,14,12,2,12,10,17
12293,12800,12803,47,4,9,5,1,3,14,8,6,11,7,16
12294,12800,12803,1,1,9,7,1,1,22,6,16,15,3,22
12295,12800,12803,27,7,9,4,4,1,18,14,4,12,6,16
12296,12800,12803,17,3,9,5,2,2,15,10,5,12,6,17
12297,12800,12803,34,2,9,5,2,2,16,9,7,12,6,17
12298,12800,12803,43,5,9,5,1,3,16,11,5,11,7,16
12299,12800,12803,57,10,9,2,5,2,11,14,-3,9,9,11
12300,12800,12803,24,15,9,2,3,4,12,21,-9,7,11,9
12301,12800,12803,52,8,9,4,4,1,10,8,2,12,6,16
12302,12800,12803,28,14,9,3,1,5,12,19,-7,7,11,10
12303,12800,12803,21,11,9,3,1,5,12,15,-3,7,11,10
12304,12800,12803,4,16,9,1,3,5,10,16,-6,5,13,6
12305,12800,12803,35,9,9,3,3,3,14,11,3,9,9,12
12306,12800,12803,13,12,9,3,1,5,12,16,-4,7,11,10
12307,12800,12803,20,17,9,1,2,6,7,19,-12,4,14,5
12308,12800,12803,6,18,9,1,1,7,8,17,-9,3,15,4
12309,12800,12803,49,6,9,4,4,1,17,8,9,12,6,16
12310,12800,12803,37,13,9,3,1,5,9,13,-4,7,11,10
12311,13574,13580,22,4,10,5,2,3,24,17,7,12,8,17
12312,13574,13580,43,10,10,4,1,5,12,13,-1,9,11,13
12313,13574,13580,34,14,10,2,3,5,16,19,-3,7,13,9
12314,13574,13580,49,16,10,2,3,5,9,14,-5,7,13,9
12315,13574,13580,37,17,10,1,4,5,11,17,-6,6,14,7
12316,13574,13580,6,2,10,7,1,2,23,14,9,15,5,22
12317,13574,13580,35,3,10,6,1,3,20,14,6,13,7,19
12318,13574,13580,4,9,10,3,5,2,18,14,4,11,9,14
12319,13574,13580,21,18,10,1,1,8,10,22,-12,3,17,4
12320,13574,13580,12,6,10,5,0,5,19,24,-5,10,10,15
12321,13574,13580,25,8,10,4,3,3,22,23,-1,11,9,15
12322,13574,13580,17,7,10,4,3,3,20,15,5,11,9,15
12323,13574,13580,27,13,10,3,2,5,11,22,-11,8,12,11
12324,13574,13580,1,1,10,10,0,0,26,4,22,20,0,30
12325,13574,13580,28,11,10,3,3,4,9,15,-6,9,11,12
12326,13574,13580,52,12,10,3,2,5,14,21,-7,8,12,11
12327,13574,13580,33,15,10,2,3,5,8,11,-3,7,13,9
12328,11103,11109,28,17,21,3,7,11,15,31,-16,13,29,16
12329,11103,11109,49,5,21,11,7,3,32,20,12,29,13,40
12330,11103,11109,27,9,21,5,11,5,21,19,2,21,21,26
12331,11103,11109,4,1,21,15,5,1,49,20,29,35,7,50
12332,11103,11109,21,8,21,6,9,6,36,30,6,21,21,27
12333,11103,11109,1,3,21,12,7,2,40,16,24,31,11,43
12334,11103,11109,43,2,21,15,4,2,53,14,39,34,8,49
12335,11103,11109,24,4,21,11,7,3,36,19,17,29,13,40
12336,11103,11109,57,11,21,6,5,10,23,44,-21,17,25,23
12337,11103,11109,22,12,21,5,5,11,20,47,-27,15,27,20
12338,11103,11109,17,14,21,4,8,9,12,25,-13,16,26,20
12339,11103,11109,35,6,21,10,5,6,39,28,11,25,17,35
12340,11152,11165,4,2,27,17,7,3,58,28,30,41,13,58
12341,11152,11165,21,7,27,9,11,7,44,34,10,29,25,38
12342,11152,11165,1,4,27,14,9,4,46,21,25,37,17,51
12343,11152,11165,17,17,27,4,9,14,14,37,-23,17,37,21
12344,11152,11165,27,10,27,7,14,6,27,23,4,28,26,35
12345,11152,11165,49,6,27,13,9,5,42,33,9,35,19,48
12346,11152,11165,52,14,27,5,8,14,22,40,-18,18,36,23
12347,11152,11165,28,16,27,4,10,13,20,38,-18,18,36,22
12348,11152,11165,12,8,27,9,8,10,34,32,2,26,28,35
12349,11152,11165,53,18,27,5,5,17,29,54,-25,15,39,20
12350,11152,11165,35,5,27,14,6,7,49,32,17,34,20,48
12351,11152,11165,41,9,27,9,8,10,32,33,-1,26,28,35
12352,11152,11165,20,11,27,7,10,10,27,35,-8,24,30,31
12353,11152,11165,56,13,27,6,5,16,30,46,-16,17,37,23
12354,11152,11165,43,1,27,18,6,3,63,19,44,42,12,60
12355,11152,11165,24,3,27,16,7,4,47,23,24,39,15,55
12356,11152,11165,57,12,27,8,6,13,33,54,-21,22,32,30
12357,11152,11165,22,15,27,5,8,14,24,59,-35,18,36,23
12358,11173,11186,43,1,29,20,6,3,69,20,49,46,12,66
12359,11173,11186,24,3,29,17,8,4,51,23,28,42,16,59
12360,11173,11186,57,12,29,9,6,14,36,58,-22,24,34,33
12361,11173,11186,22,15,29,6,8,15,27,61,-34,20,38,26
12362,11173,11186,35,5,29,15,6,8,51,35,16,36,22,51
12363,11173,11186,41,8,29,9,9,11,34,37,-3,27,31,36
12364,11173,11186,20,10,29,8,11,10,32,37,-5,27,31,35
12365,11173,11186,56,14,29,7,5,17,34,48,-14,19,39,26
12366,11173,11186,12,9,29,9,8,12,35,38,-3,26,32,35
12367,11173,11186,53,18,29,5,5,19,29,59,-30,15,43,20
12368,11173,11186,52,13,29,7,8,14,26,40,-14,22,36,29
12369,11173,11186,28,17,29,4,10,15,20,44,-24,18,40,22
12370,11173,11186,49,6,29,14,9,6,45,35,10,37,21,51
12371,11173,11186,27,11,29,7,14,8,27,29,-2,28,30,35
12372,11173,11186,17,16,29,5,10,14,17,38,-21,20,38,25
12373,11173,11186,1,4,29,15,10,4,50,22,28,40,18,55
12374,11173,11186,4,2,29,18,7,4,59,31,28,43,15,61
12375,11173,11186,21,7,29,10,12,7,47,34,13,32,26,42
12376,11306,11312,1,4,1,1,0,0,2,1,1,2,0,3
12377,11306,11312,17,7,1,0,1,0,1,1,0,1,1,1
12378,11306,11312,12,7,1,0,1,0,1,1,0,1,1,1
12379,11306,11312,27,3,1,1,0,0,3,1,2,2,0,3
12380,11306,11312,21,2,1,1,0,0,3,0,3,2,0,3
12381,11306,11312,4,7,1,0,1,0,1,1,0,1,1,1
12382,11306,11312,49,13,1,0,0,1,1,2,-1,0,2,0
12383,11306,11312,37,14,1,0,0,1,0,1,-1,0,2,0
12384,11306,11312,52,5,1,1,0,0,1,0,1,2,0,3
12385,11306,11312,43,1,1,1,0,0,4,1,3,2,0,3
12386,11306,11312,22,5,1,1,0,0,1,0,1,2,0,3
12387,11306,11312,24,7,1,0,1,0,1,1,0,1,1,1
12388,11306,11312,57,11,1,0,1,0,0,0,0,1,1,1
12389,11306,11312,34,18,1,0,0,1,0,3,-3,0,2,0
12390,11306,11312,41,11,1,0,1,0,0,0,0,1,1,1
12391,11306,11312,20,14,1,0,0,1,0,1,-1,0,2,0
12392,11306,11312,35,16,1,0,0,1,1,3,-2,0,2,0
12393,11306,11312,56,17,1,0,0,1,1,4,-3,0,2,0
12394,11418,11424,43,1,16,10,5,1,27,8,19,25,7,35
12395,11418,11424,24,2,16,10,3,3,26,11,15,23,9,33
12396,11418,11424,57,6,16,7,5,4,27,27,0,19,13,26
12397,11418,11424,22,14,16,4,3,9,11,19,-8,11,21,15
12398,11418,11424,34,17,16,2,4,10,6,24,-18,8,24,10
12399,11418,11424,52,15,16,4,3,9,15,26,-11,11,21,15
12400,11418,11424,49,4,16,8,7,1,24,10,14,23,9,31
12401,11418,11424,37,13,16,4,5,7,20,21,-1,13,19,17
12402,11418,11424,21,5,16,9,1,6,23,17,6,19,13,28
12403,11418,11424,4,7,16,7,4,5,27,26,1,18,14,25
12404,11418,11424,12,12,16,4,6,6,22,20,2,14,18,18
12405,11418,11424,1,3,16,9,5,2,33,14,19,23,9,32
12406,11418,11424,27,18,16,1,6,9,8,21,-13,8,24,9
12407,3858,3864,37,9,25,8,8,9,23,28,-5,24,26,32
12408,3858,3864,53,8,25,8,9,8,24,27,-3,25,25,33
12409,3858,3864,36,14,25,5,9,11,23,33,-10,19,31,24
12410,3858,3864,4,16,25,4,5,16,17,48,-31,13,37,17
12411,3858,3864,1,2,25,18,4,3,63,27,36,40,10,58
12412,3858,3864,39,13,25,6,7,12,28,40,-12,19,31,25
12413,3858,3864,27,15,25,6,5,14,32,46,-14,17,33,23
12414,3900,4018,39,10,30,9,7,14,40,49,-9,25,35,34
12415,3900,4018,27,13,30,8,7,15,37,54,-17,23,37,31
12416,3900,4018,1,2,30,21,4,5,71,32,39,46,14,67
12417,3900,4018,21,12,30,9,6,15,30,50,-20,24,36,33
12418,3900,4018,4,16,30,4,6,20,23,65,-42,14,46,18
12419,3900,4018,52,5,30,12,9,9,35,29,6,33,27,45
12420,3900,4018,28,8,30,11,7,12,36,39,-3,29,31,40
12421,3900,4018,36,14,30,7,10,13,29,37,-8,24,36,31
12422,3900,4018,53,6,30,12,9,9,36,32,4,33,27,45
12423,3900,4018,17,4,30,17,1,12,45,31,14,35,25,52
12424,3900,4018,26,11,30,9,6,15,29,42,-13,24,36,33
12425,3900,4018,20,9,30,8,11,11,33,35,-2,27,33,35
12426,3900,4018,41,15,30,6,13,11,17,33,-16,25,35,31
12427,3900,4018,49,1,30,21,5,4,66,24,42,47,13,68
12428,3900,4018,37,7,30,11,8,11,33,33,0,30,30,41
12429,3900,4018,43,3,30,18,5,7,53,28,25,41,19,59
12430,4089,4102,20,8,10,3,3,4,14,13,1,9,11,12
12431,4089,4102,41,15,10,2,2,6,10,24,-14,6,14,8
12432,4089,4102,43,3,10,5,3,2,18,13,5,13,7,18
12433,4089,4102,57,6,10,4,3,3,9,9,0,11,9,15
12434,4089,4102,24,10,10,3,3,4,9,8,1,9,11,12
12435,4089,4102,26,16,10,1,5,4,5,13,-8,7,13,8
12436,4089,4102,17,13,10,2,4,4,12,13,-1,8,12,10
12437,4089,4102,49,1,10,7,2,1,22,5,17,16,4,23
12438,4089,4102,37,12,10,3,1,6,11,16,-5,7,13,10
12439,4089,4102,53,14,10,2,2,6,9,18,-9,6,14,8
12440,4089,4102,52,4,10,5,2,3,13,9,4,12,8,17
12441,4089,4102,28,7,10,3,4,3,11,11,0,10,10,13
12442,4089,4102,36,11,10,3,3,4,11,14,-3,9,11,12
12443,4089,4102,21,8,10,3,3,4,14,13,1,9,11,12
12444,4089,4102,1,2,10,6,4,0,22,8,14,16,4,22
12445,4089,4102,39,5,10,5,2,3,10,13,-3,12,8,17
12446,4040,4046,39,3,4,3,0,1,4,3,1,6,2,9
12447,4040,4046,1,1,4,3,1,0,12,3,9,7,1,10
12448,4040,4046,21,11,4,1,1,2,5,6,-1,3,5,4
12449,4040,4046,52,4,4,2,2,0,4,2,2,6,2,8
12450,4040,4046,28,5,4,2,1,1,4,3,1,5,3,7
12451,4040,4046,36,15,4,0,2,2,4,10,-6,2,6,2
12452,4040,4046,53,16,4,0,1,3,3,8,-5,1,7,1
12453,4040,4046,17,11,4,1,1,2,5,6,-1,3,5,4
12454,4040,4046,57,7,4,2,0,2,3,2,1,4,4,6
12455,4040,4046,43,8,4,1,2,1,4,5,-1,4,4,5
12456,4040,4046,24,9,4,1,2,1,3,4,-1,4,4,5
12457,4040,4046,26,14,4,0,3,1,1,2,-1,3,5,3
12458,4040,4046,49,2,4,3,0,1,9,3,6,6,2,9
12459,4040,4046,37,6,4,2,0,2,5,4,1,4,4,6
12460,4040,4046,20,10,4,1,1,2,6,7,-1,3,5,4
12461,4040,4046,41,13,4,1,1,2,5,9,-4,3,5,4
12462,4075,4088,20,8,9,3,3,3,13,10,3,9,9,12
12463,4075,4088,41,15,9,2,1,6,8,22,-14,5,13,7
12464,4075,4088,43,4,9,4,3,2,16,12,4,11,7,15
12465,4075,4088,57,5,9,4,2,3,7,7,0,10,8,14
12466,4075,4088,24,12,9,2,3,4,5,8,-3,7,11,9
12467,4075,4088,26,16,9,1,4,4,3,11,-8,6,12,7
12468,4075,4088,17,11,9,2,3,4,10,11,-1,7,11,9
12469,4075,4088,49,1,9,7,1,1,22,5,17,15,3,22
12470,4075,4088,37,10,9,3,1,5,10,14,-4,7,11,10
12471,4075,4088,53,14,9,2,2,5,9,14,-5,6,12,8
12472,4075,4088,52,3,9,5,2,2,12,6,6,12,6,17
12473,4075,4088,28,7,9,3,4,2,10,8,2,10,8,13
12474,4075,4088,36,13,9,2,3,4,8,13,-5,7,11,9
12475,4075,4088,21,9,9,3,2,4,14,13,1,8,10,11
12476,4075,4088,1,2,9,5,4,0,19,7,12,14,4,19
12477,4075,4088,39,6,9,4,2,3,7,12,-5,10,8,14
12478,4732,4753,1,10,1,0,1,0,0,0,0,1,1,1
12479,4732,4753,21,14,1,0,0,1,0,2,-2,0,2,0
12480,4732,4753,17,1,1,1,0,0,4,1,3,2,0,3
12481,4732,4753,8,16,1,0,0,1,1,4,-3,0,2,0
12482,4732,4753,48,5,1,1,0,0,2,1,1,2,0,3
12483,4732,4753,36,8,1,0,1,0,1,1,0,1,1,1
12484,4732,4753,52,10,1,0,1,0,0,0,0,1,1,1
12485,4732,4753,28,12,1,0,0,1,1,2,-1,0,2,0
12486,4732,4753,53,8,1,0,1,0,1,1,0,1,1,1
12487,4732,4753,49,3,1,1,0,0,2,0,2,2,0,3
12488,9227,9233,43,2,18,11,5,2,45,19,26,27,9,38
12489,9227,9233,57,8,18,7,4,7,27,26,1,18,18,25
12490,9227,9233,24,15,18,3,9,6,18,28,-10,15,21,18
12491,9227,9233,37,4,18,10,2,6,30,25,5,22,14,32
12492,9227,9233,49,9,18,6,6,6,23,20,3,18,18,24
12493,9227,9233,53,6,18,7,7,4,27,24,3,21,15,28
12494,9227,9233,12,12,18,5,4,9,22,32,-10,14,22,19
12495,9227,9233,1,1,18,13,3,2,42,16,26,29,7,42
12496,9227,9233,17,14,18,4,6,8,18,27,-9,14,22,18
12497,9227,9233,19,18,18,3,5,10,15,37,-22,11,25,14
12498,9227,9233,27,13,18,5,3,10,23,31,-8,13,23,18
12499,9584,9590,27,5,13,7,2,4,18,15,3,16,10,23
12500,9584,9590,12,3,13,7,5,1,18,12,6,19,7,26
12501,9584,9590,53,9,13,4,6,3,13,15,-2,14,12,18
12502,9584,9590,1,2,13,8,3,2,31,13,18,19,7,27
12503,9584,9590,43,1,13,10,2,1,33,7,26,22,4,32
12504,9584,9590,24,4,13,7,4,2,21,7,14,18,8,25
12505,9584,9590,2,11,13,4,3,6,13,20,-7,11,15,15
12506,9584,9590,57,14,13,3,3,7,17,17,0,9,17,12
12507,9584,9590,41,8,13,6,4,3,19,14,5,16,10,22
12508,9584,9590,13,10,13,4,3,6,15,21,-6,11,15,15
12509,9584,9590,49,6,13,6,5,2,22,10,12,17,9,23
12510,9584,9590,37,7,13,5,8,0,18,8,10,18,8,23
12511,9584,9590,52,16,13,3,3,7,14,25,-11,9,17,12
12512,9584,9590,48,17,13,1,3,9,6,29,-23,5,21,6
12513,9584,9590,20,12,13,4,1,8,15,26,-11,9,17,13
12514,9584,9590,56,15,13,3,3,7,16,20,-4,9,17,12
12515,9584,9590,4,13,13,4,1,8,11,23,-12,9,17,13
12516,9584,9590,21,18,13,0,3,10,8,26,-18,3,23,3
12517,9647,9660,41,6,19,10,4,5,27,18,9,24,14,34
12518,9647,9660,20,9,19,7,3,9,24,29,-5,17,21,24
12519,9647,9660,13,15,19,4,4,11,20,33,-13,12,26,16
12520,9647,9660,56,17,19,3,4,12,18,32,-14,10,28,13
12521,9647,9660,43,1,19,14,4,1,52,12,40,32,6,46
12522,9647,9660,24,2,19,12,5,2,30,9,21,29,9,41
12523,9647,9660,2,10,19,6,6,7,22,27,-5,18,20,24
12524,9647,9660,57,12,19,5,5,9,23,22,1,15,23,20
12525,9647,9660,37,5,19,9,10,0,28,10,18,28,10,37
12526,9647,9660,49,8,19,7,6,6,26,17,9,20,18,27
12527,9647,9660,52,16,19,4,4,11,19,34,-15,12,26,16
12528,9647,9660,48,18,19,1,4,14,7,51,-44,6,32,7
12529,9647,9660,12,4,19,10,7,2,29,19,10,27,11,37
12530,9647,9660,53,11,19,5,7,7,16,23,-7,17,21,22
12531,9647,9660,4,13,19,5,3,11,14,31,-17,13,25,18
12532,9647,9660,21,14,19,4,5,10,23,32,-9,13,25,17
12533,9647,9660,27,7,19,10,2,7,26,25,1,22,16,32
12534,9647,9660,1,3,19,11,5,3,40,20,20,27,11,38
12535,9689,9695,1,3,23,14,5,4,44,21,23,33,13,47
12536,9689,9695,12,5,23,11,8,4,33,25,8,30,16,41
12537,9689,9695,53,9,23,7,9,7,22,24,-2,23,23,30
12538,9689,9695,27,7,23,10,5,8,30,31,-1,25,21,35
12539,9689,9695,52,14,23,4,8,11,23,38,-15,16,30,20
12540,9689,9695,48,18,23,4,5,14,16,52,-36,13,33,17
12541,9689,9695,37,4,23,10,12,1,33,16,17,32,14,42
12542,9689,9695,49,8,23,8,7,8,30,21,9,23,23,31
12543,9689,9695,43,1,23,16,5,2,56,17,39,37,9,53
12544,9689,9695,24,2,23,16,5,2,35,9,26,37,9,53
12545,9689,9695,2,11,23,6,8,9,23,32,-9,20,26,26
12546,9689,9695,57,12,23,6,7,10,26,25,1,19,27,25
12547,9689,9695,41,6,23,11,5,7,30,21,9,27,19,38
12548,9689,9695,20,10,23,8,5,10,29,33,-4,21,25,29
12549,9689,9695,56,15,23,5,4,14,24,38,-14,14,32,19
12550,9689,9695,13,17,23,4,5,14,23,43,-20,13,33,17
12551,9689,9695,4,13,23,5,6,12,19,39,-20,16,30,21
12552,9689,9695,21,16,23,4,7,12,24,35,-11,15,31,19
12553,9549,9562,4,11,9,3,1,5,8,16,-8,7,11,10
12554,9549,9562,21,17,9,0,3,6,5,14,-9,3,15,3
12555,9549,9562,41,5,9,4,3,2,15,10,5,11,7,15
12556,9549,9562,56,9,9,3,2,4,14,11,3,8,10,11
12557,9549,9562,20,12,9,3,1,5,10,21,-11,7,11,10
12558,9549,9562,13,13,9,2,3,4,9,15,-6,7,11,9
12559,9549,9562,57,16,9,2,1,6,11,14,-3,5,13,7
12560,9549,9562,49,3,9,6,2,1,19,5,14,14,4,20
12561,9549,9562,37,6,9,3,6,0,14,6,8,12,6,15
12562,9549,9562,43,2,9,7,1,1,24,4,20,15,3,22
12563,9549,9562,24,4,9,4,3,2,12,6,6,11,7,15
12564,9549,9562,2,14,9,2,3,4,9,17,-8,7,11,9
12565,9549,9562,52,15,9,2,2,5,10,16,-6,6,12,8
12566,9549,9562,48,18,9,0,3,6,4,23,-19,3,15,3
12567,11390,11403,20,7,13,6,1,6,20,18,2,13,13,19
12568,11390,11403,35,10,13,4,5,4,13,17,-4,13,13,17
12569,11390,11403,41,12,13,3,6,4,13,13,0,12,14,15
12570,11460,11466,17,8,19,7,5,7,25,28,-3,19,19,26
12571,11460,11466,49,3,19,9,9,1,26,11,15,27,11,36
12572,11460,11466,37,14,19,4,7,8,22,24,-2,15,23,19
12573,11460,11466,12,15,19,4,7,8,25,31,-6,15,23,19
12574,11460,11466,21,5,19,11,1,7,28,20,8,23,15,34
12575,11460,11466,4,7,19,8,5,6,31,29,2,21,17,29
12576,11460,11466,52,13,19,5,5,9,18,27,-9,15,23,20
12577,11460,11466,43,1,19,12,5,2,35,10,25,29,9,41
12578,11460,11466,24,2,19,12,4,3,33,13,20,28,10,40
12579,11460,11466,57,6,19,8,7,4,35,30,5,23,15,31
12580,11460,11466,22,12,19,5,5,9,17,23,-6,15,23,20
12581,11460,11466,34,18,19,2,4,13,8,32,-24,8,30,10
12582,11460,11466,27,17,19,2,8,9,13,25,-12,12,26,14
12583,11460,11466,1,4,19,9,8,2,35,16,19,26,12,35
12584,11460,11466,20,9,19,7,3,9,26,28,-2,17,21,24
12585,11460,11466,35,10,19,4,10,5,17,23,-6,18,20,22
12586,11460,11466,41,11,19,4,9,6,19,21,-2,17,21,21
12587,11460,11466,56,16,19,4,6,9,19,41,-22,14,24,18
12588,11516,11522,27,13,25,6,8,11,21,31,-10,20,30,26
12589,11516,11522,17,7,25,11,6,8,37,34,3,28,22,39
12590,11516,11522,12,10,25,7,9,9,32,35,-3,23,27,30
12591,11516,11522,1,3,25,13,10,2,45,17,28,36,14,49
12592,11516,11522,43,1,25,16,6,3,47,13,34,38,12,54
12593,11516,11522,52,12,25,7,6,12,27,36,-9,20,30,27
12594,11516,11522,35,9,25,8,10,7,33,31,2,26,24,34
12595,11516,11522,20,11,25,8,5,12,34,40,-6,21,29,29
12596,11516,11522,41,15,25,5,10,10,25,33,-8,20,30,25
12597,11516,11522,56,17,25,5,7,13,25,53,-28,17,33,22
12598,11516,11522,24,2,25,14,7,4,38,16,22,35,15,49
12599,11516,11522,57,8,25,8,11,6,41,38,3,27,23,35
12600,11516,11522,22,16,25,5,8,12,18,32,-14,18,32,23
12601,11516,11522,34,18,25,2,5,18,11,50,-39,9,41,11
12602,11516,11522,21,5,25,13,3,9,35,32,3,29,21,42
12603,11516,11522,4,6,25,11,6,8,41,36,5,28,22,39
12604,11516,11522,49,4,25,12,11,2,42,19,23,35,15,47
12605,11516,11522,37,14,25,5,10,10,31,37,-6,20,30,25
12606,11579,11585,49,3,33,15,14,4,51,26,25,44,22,59
12607,11579,11585,37,13,33,8,11,14,40,51,-11,27,39,35
12608,11579,11585,21,4,33,17,5,11,46,39,7,39,27,56
12609,11579,11585,4,6,33,15,9,9,53,44,9,39,27,54
12610,11579,11585,43,2,33,21,7,5,65,25,40,49,17,70
12611,11579,11585,24,5,33,14,13,6,42,22,20,41,25,55
12612,11579,11585,57,9,33,10,13,10,52,52,0,33,33,43
12613,11579,11585,22,16,33,7,10,16,29,44,-15,24,42,31
12614,11579,11585,34,18,33,4,8,21,18,61,-43,16,50,20
12615,11579,11585,35,8,33,12,11,10,52,45,7,35,31,47
12616,11579,11585,20,10,33,11,8,14,46,53,-7,30,36,41
12617,11579,11585,41,15,33,7,13,13,32,42,-10,27,39,34
12618,11579,11585,56,17,33,5,10,18,31,69,-38,20,46,25
12619,11579,11585,52,11,33,11,7,15,37,45,-8,29,37,40
12620,11579,11585,1,1,33,21,10,2,63,24,39,52,14,73
12621,11579,11585,12,14,33,8,10,15,37,50,-13,26,40,34
12622,11579,11585,17,7,33,14,9,10,51,42,9,37,29,51
12623,11579,11585,27,12,33,9,8,16,31,42,-11,26,40,35
12624,11355,11361,52,14,9,2,1,6,9,17,-8,5,13,7
12625,11355,11361,12,12,9,2,4,3,12,11,1,8,10,10
12626,11355,11361,27,17,9,1,2,6,5,14,-9,4,14,5
12627,11355,11361,37,8,9,4,2,3,15,9,6,10,8,14
12628,11355,11361,49,9,9,3,5,1,9,6,3,11,7,14
12629,11355,11361,21,4,9,5,1,3,12,9,3,11,7,16
12630,11355,11361,4,5,9,4,3,2,15,13,2,11,7,15
12631,11355,11361,43,1,9,6,2,1,18,6,12,14,4,20
12632,11355,11361,24,2,9,6,2,1,17,7,10,14,4,20
12633,11355,11361,57,7,9,4,3,2,17,17,0,11,7,15
12634,11355,11361,22,11,9,3,1,5,9,10,-1,7,11,10
12635,11355,11361,34,18,9,1,2,6,3,14,-11,4,14,5
12636,11355,11361,17,6,9,4,3,2,12,10,2,11,7,15
12637,11355,11361,1,3,9,6,1,2,26,10,16,13,5,19
12638,11355,11361,20,10,9,4,1,4,12,14,-2,9,9,13
12639,11355,11361,35,13,9,2,3,4,7,14,-7,7,11,9
12640,11355,11361,41,15,9,1,4,4,6,12,-6,6,12,7
12641,11355,11361,56,16,9,1,4,4,8,19,-11,6,12,7
12642,11859,11865,1,4,23,11,5,7,32,20,12,27,19,38
12643,11859,11865,49,2,23,14,5,4,47,28,19,33,13,47
12644,11859,11865,37,11,23,9,5,9,28,31,-3,23,23,32
12645,11859,11865,14,16,23,5,3,15,33,73,-40,13,33,18
12646,9759,9765,4,16,33,7,9,17,25,49,-24,23,43,30
12647,9759,9765,43,1,33,24,7,2,77,25,52,55,11,79
12648,9759,9765,24,2,33,24,7,2,56,15,41,55,11,79
12649,9759,9765,2,11,33,9,12,12,33,45,-12,30,36,39
12650,9759,9765,57,12,33,9,11,13,36,39,-3,29,37,38
12651,9759,9765,52,13,33,8,11,14,34,50,-16,27,39,35
12652,9759,9765,48,18,33,4,7,22,20,77,-57,15,51,19
12653,9759,9765,27,7,33,13,9,11,47,48,-1,35,31,48
12654,9759,9765,37,5,33,14,14,5,43,24,19,42,24,56
12655,9759,9765,49,9,33,10,11,12,39,36,3,31,35,41
12656,9759,9765,1,3,33,18,7,8,67,33,34,43,23,61
12657,9542,9548,1,1,8,6,2,0,23,7,16,14,2,20
12658,9542,9548,27,8,8,3,2,3,11,13,-2,8,8,11
12659,9542,9548,52,14,8,2,2,4,10,13,-3,6,10,8
12660,9542,9548,48,18,8,0,2,6,4,23,-19,2,14,2
12661,9542,9548,21,17,8,0,3,5,5,12,-7,3,13,3
12662,9542,9548,12,9,8,2,5,1,8,8,0,9,7,11
12663,9542,9548,53,12,8,2,4,2,6,10,-4,8,8,10
12664,9542,9548,49,3,8,5,2,1,16,5,11,12,4,17
12665,9542,9548,37,5,8,3,5,0,13,5,8,11,5,14
12666,9542,9548,41,6,8,3,3,2,13,10,3,9,7,12
12667,9542,9548,56,7,8,3,2,3,14,10,4,8,8,11
12668,9542,9548,20,11,8,3,1,4,9,19,-10,7,9,10
12669,9542,9548,13,13,8,2,3,3,8,12,-4,7,9,9
12670,9542,9548,43,2,8,6,1,1,23,4,19,13,3,19
12671,9542,9548,24,4,8,4,3,1,12,5,7,11,5,15
12672,9542,9548,2,15,8,2,2,4,8,16,-8,6,10,8
12673,9542,9548,57,16,8,1,1,6,9,13,-4,3,13,4
12674,9542,9548,4,10,8,3,1,4,7,14,-7,7,9,10
12675,9899,9905,21,3,10,6,4,0,22,10,12,16,4,22
12676,9899,9905,4,17,10,2,0,8,11,24,-13,4,16,6
12677,9899,9905,12,7,10,4,4,2,13,11,2,12,8,16
12678,9899,9905,53,10,10,4,1,5,12,14,-2,9,11,13
12679,9899,9905,28,8,10,4,3,3,10,11,-1,11,9,15
12680,9899,9905,52,12,10,3,3,4,10,15,-5,9,11,12
12681,9899,9905,41,5,10,4,5,1,15,9,6,13,7,17
12682,9899,9905,20,6,10,5,1,4,20,14,6,11,9,16
12683,9899,9905,56,18,10,1,3,6,8,19,-11,5,15,6
12684,9899,9905,43,2,10,6,4,0,23,5,18,16,4,22
12685,9899,9905,24,4,10,6,2,2,13,8,5,14,6,20
12686,9899,9905,22,11,10,4,0,6,13,24,-11,8,12,12
12687,9899,9905,2,13,10,3,1,6,10,17,-7,7,13,10
12688,9899,9905,57,14,10,2,3,5,12,15,-3,7,13,9
12689,9899,9905,27,16,10,1,4,5,9,17,-8,6,14,7
12690,9899,9905,49,9,10,4,2,4,19,18,1,10,10,14
12691,9899,9905,37,15,10,2,2,6,12,15,-3,6,14,8
12692,9899,9905,1,1,10,7,2,1,24,10,14,16,4,23
12693,9948,9954,1,2,16,10,3,3,38,18,20,23,9,33
12694,9948,9954,49,8,16,6,4,6,26,24,2,16,16,22
12695,9948,9954,37,18,16,2,6,8,16,21,-5,10,22,12
12696,9948,9954,53,10,16,6,3,7,20,21,-1,15,17,21
12697,9948,9954,12,12,16,5,4,7,18,23,-5,14,18,19
12698,9948,9954,27,13,16,4,6,6,19,26,-7,14,18,18
12699,9948,9954,28,7,16,6,5,5,15,18,-3,17,15,23
12700,9948,9954,52,14,16,4,5,7,15,23,-8,13,19,17
12701,9948,9954,21,1,16,10,6,0,36,13,23,26,6,36
12702,9948,9954,4,11,16,6,1,9,18,27,-9,13,19,19
12703,9948,9954,24,3,16,10,2,4,23,14,9,22,10,32
12704,9948,9954,43,5,16,7,6,3,28,13,15,20,12,27
12705,9948,9954,57,9,16,6,4,6,23,21,2,16,16,22
12706,9948,9954,2,15,16,4,2,10,12,26,-14,10,22,14
12707,9948,9954,22,17,16,4,0,12,18,45,-27,8,24,12
12708,9948,9954,20,4,16,10,1,5,35,21,14,21,11,31
12709,9948,9954,41,6,16,7,6,3,28,19,9,20,12,27
12710,9948,9954,56,16,16,3,4,9,16,31,-15,10,22,13
12711,9955,9961,20,4,17,10,1,6,35,24,11,21,13,31
12712,9955,9961,24,3,17,11,2,4,24,14,10,24,10,35
12713,9955,9961,43,5,17,8,6,3,32,14,18,22,12,30
12714,9955,9961,57,8,17,6,4,7,24,23,1,16,18,22
12715,9955,9961,2,16,17,4,2,11,13,30,-17,10,24,14
12716,9955,9961,22,17,17,4,0,13,18,51,-33,8,26,12
12717,9955,9961,21,1,17,11,6,0,39,13,26,28,6,39
12718,9955,9961,4,14,17,6,1,10,18,28,-10,13,21,19
12719,9955,9961,28,7,17,6,5,6,15,20,-5,17,17,23
12720,9955,9961,52,13,17,5,5,7,17,23,-6,15,19,20
12721,9955,9961,41,6,17,7,7,3,29,20,9,21,13,28
12722,9955,9961,56,15,17,4,4,9,18,32,-14,12,22,16
12723,9955,9961,27,12,17,5,6,6,20,26,-6,16,18,21
12724,9955,9961,12,8,17,6,4,7,24,23,1,16,18,22
12725,11418,11424,17,9,16,6,4,6,22,25,-3,16,16,22
12726,11418,11424,20,8,16,7,1,8,23,23,0,15,17,22
12727,11418,11424,41,10,16,4,8,4,17,16,1,16,16,20
12728,11418,11424,35,11,16,4,7,5,14,20,-6,15,17,19
12729,11418,11424,56,16,16,3,5,8,15,32,-17,11,21,14
12730,11313,11315,35,17,2,0,0,2,1,4,-3,0,4,0
12731,11313,11315,1,1,2,2,0,0,7,2,5,4,0,6
12732,11313,11315,12,10,2,0,2,0,3,3,0,2,2,2
12733,11313,11315,17,13,2,0,1,1,1,2,-1,1,3,1
12734,11313,11315,27,4,2,1,1,0,3,1,2,3,1,4
12735,11313,11315,21,2,2,2,0,0,4,0,4,4,0,6
12736,11313,11315,49,13,2,0,1,1,1,2,-1,1,3,1
12737,11313,11315,37,15,2,0,1,1,0,1,-1,1,3,1
12738,11313,11315,4,16,2,0,1,1,2,6,-4,1,3,1
12739,11313,11315,52,7,2,1,0,1,1,1,0,2,2,3
12740,11313,11315,34,18,2,0,0,2,0,4,-4,0,4,0
12741,11313,11315,20,7,2,1,0,1,1,1,0,2,2,3
12742,11313,11315,56,9,2,1,0,1,2,4,-2,2,2,3
12743,11313,11315,41,12,2,0,2,0,0,0,0,2,2,2
12744,11313,11315,43,3,2,1,1,0,4,1,3,3,1,4
12745,11313,11315,24,5,2,1,1,0,2,1,1,3,1,4
12746,11313,11315,22,6,2,1,1,0,1,0,1,3,1,4
12747,11313,11315,57,11,2,0,2,0,2,2,0,2,2,2
12748,11565,11571,57,9,31,10,13,8,51,47,4,33,29,43
12749,11565,11571,43,1,31,20,7,4,62,21,41,47,15,67
12750,11565,11571,24,4,31,14,12,5,40,19,21,40,22,54
12751,11565,11571,22,16,31,6,9,16,26,44,-18,21,41,27
12752,11565,11571,34,18,31,3,7,21,14,59,-45,13,49,16
12753,11565,11571,52,11,31,10,7,14,35,43,-8,27,35,37
12754,11565,11571,49,3,31,15,13,3,49,23,26,43,19,58
12755,11565,11571,21,5,31,16,4,11,43,39,4,36,26,52
12756,11565,11571,4,6,31,14,8,9,48,41,7,36,26,50
12757,11565,11571,17,7,31,13,8,10,49,42,7,34,28,47
12758,11565,11571,12,12,31,8,10,13,36,47,-11,26,36,34
12759,11565,11571,27,13,31,8,8,15,29,40,-11,24,38,32
12760,11565,11571,1,2,31,19,10,2,58,21,37,48,14,67
12761,11565,11571,37,14,31,7,11,13,36,47,-11,25,37,32
12762,11565,11571,35,8,31,12,10,9,50,40,10,34,28,46
12763,11565,11571,20,10,31,10,7,14,44,52,-8,27,35,37
12764,11565,11571,41,15,31,6,13,12,31,41,-10,25,37,31
12765,11565,11571,56,17,31,5,9,17,29,64,-35,19,43,24
12766,11817,11823,4,5,18,9,4,5,30,20,10,22,14,31
12767,11817,11823,21,7,18,9,1,8,34,32,2,19,17,28
12768,11817,11823,1,6,18,9,4,5,22,15,7,22,14,31
12769,11817,11823,17,11,18,7,4,7,28,27,1,18,18,25
12770,11817,11823,27,8,18,8,3,7,31,28,3,19,17,27
12771,11817,11823,49,2,18,11,3,4,36,24,12,25,11,36
12772,11817,11823,37,9,18,7,5,6,19,22,-3,19,17,26
12773,11817,11823,14,16,18,4,2,12,28,57,-29,10,26,14
12774,11817,11823,52,10,18,6,8,4,28,20,8,20,16,26
12775,11817,11823,20,4,18,9,4,5,47,26,21,22,14,31
12776,11817,11823,41,13,18,6,4,8,25,37,-12,16,20,22
12777,11817,11823,35,15,18,4,3,11,28,40,-12,11,25,15
12778,11817,11823,6,18,18,2,2,14,17,48,-31,6,30,8
12779,11817,11823,43,1,18,14,3,1,42,14,28,31,5,45
12780,11817,11823,24,3,18,11,0,7,32,22,10,22,14,33
12781,11817,11823,57,12,18,6,4,8,40,42,-2,16,20,22
12782,11817,11823,22,14,18,5,6,7,20,18,2,16,20,21
12783,11817,11823,12,17,18,3,4,11,19,34,-15,10,26,13
12784,11824,11830,12,17,19,3,4,12,19,36,-17,10,28,13
12785,11824,11830,43,1,19,14,4,1,44,16,28,32,6,46
12786,11824,11830,24,3,19,11,1,7,32,22,10,23,15,34
12787,11824,11830,22,12,19,6,6,7,22,18,4,18,20,24
12788,11824,11830,57,13,19,6,5,8,41,43,-2,17,21,23
12789,11824,11830,20,4,19,9,5,5,47,26,21,23,15,32
12790,11824,11830,41,14,19,6,5,8,26,38,-12,17,21,23
12791,11824,11830,35,15,19,5,3,11,31,41,-10,13,25,18
12792,11824,11830,6,18,19,2,3,14,17,48,-31,7,31,9
12793,11824,11830,52,9,19,6,9,4,30,22,8,21,17,27
12794,11824,11830,49,2,19,12,3,4,42,26,16,27,11,39
12795,11824,11830,37,11,19,7,5,7,21,25,-4,19,19,26
12796,11824,11830,14,16,19,4,2,13,30,63,-33,10,28,14
12797,11824,11830,4,5,19,9,5,5,30,20,10,23,15,32
12798,11824,11830,27,8,19,8,4,7,32,29,3,20,18,28
12799,11824,11830,17,10,19,7,5,7,29,28,1,19,19,26
12800,11824,11830,1,7,19,9,4,6,23,18,5,22,16,31
12801,11824,11830,21,6,19,10,1,8,37,34,3,21,17,31
12802,11887,11900,17,10,27,11,5,11,39,38,1,27,27,38
12803,11887,11900,12,17,27,3,8,16,24,49,-25,14,40,17
12804,4732,4753,37,6,1,0,1,0,2,2,0,1,1,1
12805,4732,4753,43,2,1,1,0,0,3,1,2,2,0,3
12806,4732,4753,24,3,1,1,0,0,2,0,2,2,0,3
12807,4732,4753,57,14,1,0,0,1,0,2,-2,0,2,0
12808,4732,4753,41,6,1,0,1,0,2,2,0,1,1,1
12809,4732,4753,20,13,1,0,0,1,1,3,-2,0,2,0
12810,4754,4760,41,5,2,1,1,0,4,3,1,3,1,4
12811,4754,4760,20,14,2,0,1,1,1,3,-2,1,3,1
12812,4754,4760,24,4,2,1,1,0,3,1,2,3,1,4
12813,4754,4760,43,6,2,1,0,1,4,4,0,2,2,3
12814,4754,4760,57,7,2,1,0,1,3,3,0,2,2,3
12815,4754,4760,49,3,2,1,1,0,4,2,2,3,1,4
12816,4754,4760,37,9,2,0,2,0,3,3,0,2,2,2
12817,4754,4760,53,9,2,0,2,0,3,3,0,2,2,2
12818,4754,4760,52,1,2,1,1,0,4,0,4,3,1,4
12819,4754,4760,48,8,2,1,0,1,2,5,-3,2,2,3
12820,4754,4760,36,11,2,0,2,0,2,2,0,2,2,2
12821,4754,4760,28,12,2,0,1,1,2,3,-1,1,3,1
12822,4754,4760,17,2,2,1,1,0,5,2,3,3,1,4
12823,4754,4760,8,16,2,0,1,1,2,5,-3,1,3,1
12824,4754,4760,21,15,2,0,1,1,0,2,-2,1,3,1
12825,4754,4760,1,13,2,0,1,1,1,2,-1,1,3,1
12826,4782,4788,1,5,6,2,3,1,12,6,6,7,5,9
12827,4782,4788,21,14,6,1,2,3,3,7,-4,4,8,5
12828,4782,4788,17,12,6,1,3,2,8,12,-4,5,7,6
12829,4782,4788,8,15,6,1,1,4,4,12,-8,3,9,4
12830,4782,4788,52,2,6,3,3,0,13,4,9,9,3,12
12831,4782,4788,48,9,6,2,2,2,7,10,-3,6,6,8
12832,4782,4788,28,11,6,1,3,2,6,8,-2,5,7,6
12833,4782,4788,36,13,6,1,2,3,10,12,-2,4,8,5
12834,4782,4788,53,16,6,0,4,2,5,9,-4,4,8,4
12835,4782,4788,24,3,6,3,2,1,8,5,3,8,4,11
12836,4782,4788,43,4,6,3,1,2,12,9,3,7,5,10
12837,4782,4788,57,8,6,2,2,2,9,8,1,6,6,8
12838,4782,4788,49,1,6,4,1,1,9,5,4,9,3,13
12839,4782,4788,37,6,6,2,3,1,8,5,3,7,5,9
12840,4782,4788,41,7,6,2,2,2,11,8,3,6,6,8
12841,4782,4788,20,10,6,2,2,2,8,13,-5,6,6,8
12842,5181,5187,41,14,13,3,5,5,13,15,-2,11,15,14
12843,5181,5187,20,16,13,2,7,4,14,15,-1,11,15,13
12844,5181,5187,43,1,13,7,6,0,29,7,22,20,6,27
12845,5181,5187,57,6,13,5,6,2,16,14,2,16,10,21
12846,5181,5187,24,9,13,4,5,4,11,10,1,13,13,17
12847,5181,5187,5,10,13,4,5,4,23,25,-2,13,13,17
12848,5181,5187,49,12,13,4,4,5,20,18,2,12,14,16
12849,5181,5187,37,13,13,3,6,4,12,12,0,12,14,15
12850,5181,5187,53,3,13,7,3,3,21,13,8,17,9,24
12851,5181,5187,12,8,13,5,3,5,21,25,-4,13,13,18
12852,5181,5187,22,20,13,0,4,9,11,32,-21,4,22,4
12853,5181,5187,52,2,13,7,6,0,30,11,19,20,6,27
12854,5181,5187,48,17,13,2,7,4,10,12,-2,11,15,13
12855,5181,5187,36,19,13,1,5,7,7,26,-19,7,19,8
12856,5181,5187,17,5,13,6,3,4,21,15,6,15,11,21
12857,5181,5187,8,18,13,3,3,7,10,20,-10,9,17,12
12858,5181,5187,21,4,13,7,3,3,19,11,8,17,9,24
12859,5181,5187,1,7,13,5,5,3,22,14,8,15,11,20
12860,5181,5187,18,11,13,4,5,4,14,21,-7,13,13,17
12861,5181,5187,27,15,13,3,5,5,13,21,-8,11,15,14
12862,5279,5292,27,17,25,6,8,11,24,42,-18,20,30,26
12863,5279,5292,1,3,25,13,7,5,49,22,27,33,17,46
12864,5279,5292,18,18,25,5,10,10,22,47,-25,20,30,25
12865,5279,5292,17,7,25,12,4,9,36,34,2,28,22,40
12866,5279,5292,21,5,25,12,7,6,43,24,19,31,19,43
12867,5279,5292,49,4,25,13,6,6,41,22,19,32,18,45
12868,5279,5292,8,13,25,7,7,11,29,40,-11,21,29,28
12869,5279,5292,52,1,25,16,9,0,67,24,43,41,9,57
12870,5279,5292,48,11,25,6,12,7,22,23,-1,24,26,30
12871,5279,5292,36,19,25,4,7,14,17,45,-28,15,35,19
12872,5279,5292,53,6,25,12,6,7,38,26,12,30,20,42
12873,5279,5292,12,8,25,10,8,7,36,35,1,28,22,38
12874,5279,5292,37,10,25,7,9,9,20,23,-3,23,27,30
12875,5279,5292,5,16,25,6,8,11,39,45,-6,20,30,26
12876,5279,5292,57,9,25,8,9,8,25,29,-4,25,25,33
12877,5279,5292,24,15,25,6,9,10,14,24,-10,21,29,27
12878,5279,5292,22,20,25,1,9,15,19,54,-35,11,39,12
12879,5279,5292,43,2,25,13,10,2,49,15,34,36,14,49
12880,5279,5292,20,12,25,7,7,11,26,33,-7,21,29,28
12881,5279,5292,41,14,25,7,6,12,26,35,-9,20,30,27
12882,5293,5299,20,13,26,7,8,11,26,33,-7,22,30,29
12883,5293,5299,41,15,26,7,6,13,27,38,-11,20,32,27
12884,5293,5299,43,2,26,13,11,2,49,15,34,37,15,50
12885,13574,13580,47,5,10,4,5,1,16,9,7,13,7,17
12886,13616,13622,47,2,16,8,7,1,31,16,15,23,9,31
12887,13616,13622,1,1,16,14,2,0,43,10,33,30,2,44
12888,13616,13622,28,8,16,6,5,5,17,18,-1,17,15,23
12889,13616,13622,33,15,16,4,4,8,16,22,-6,12,20,16
12890,13616,13622,52,16,16,4,2,10,20,40,-20,10,22,14
12891,13616,13622,17,5,16,7,4,5,28,19,9,18,14,25
12892,13616,13622,12,9,16,7,0,9,27,37,-10,14,18,21
12893,13616,13622,25,11,16,5,5,6,26,32,-6,15,17,20
12894,13616,13622,27,12,16,5,5,6,21,31,-10,15,17,20
12895,13616,13622,4,10,16,5,6,5,25,23,2,16,16,21
12896,13616,13622,21,18,16,2,2,12,18,33,-15,6,26,8
12897,13616,13622,35,4,16,8,3,5,25,21,4,19,13,27
12898,13616,13622,6,6,16,7,3,6,27,23,4,17,15,24
12899,13616,13622,22,3,16,9,3,4,36,22,14,21,11,30
12900,13616,13622,43,7,16,7,3,6,21,19,2,17,15,24
12901,13616,13622,34,13,16,5,3,8,25,29,-4,13,19,18
12902,13616,13622,49,14,16,4,6,6,19,21,-2,14,18,18
12903,13616,13622,37,17,16,3,5,8,17,26,-9,11,21,14
12904,13504,13510,37,15,3,0,2,1,2,4,-2,2,4,2
12905,13504,13510,49,16,3,0,1,2,3,6,-3,1,5,1
12906,13504,13510,6,3,3,2,1,0,9,4,5,5,1,7
12907,13504,13510,35,8,3,1,1,1,6,6,0,3,3,4
12908,13504,13510,4,6,3,1,1,1,7,5,2,3,3,4
12909,13504,13510,21,18,3,0,0,3,2,8,-6,0,6,0
12910,13504,13510,22,1,3,3,0,0,13,3,10,6,0,9
12911,13504,13510,43,4,3,2,0,1,2,2,0,4,2,6
12912,13504,13510,34,5,3,1,2,0,3,1,2,4,2,5
12913,13504,13510,17,7,3,1,1,1,4,2,2,3,3,4
12914,13504,13510,25,12,3,1,0,2,5,10,-5,2,4,3
12915,13504,13510,12,13,3,1,0,2,4,9,-5,2,4,3
12916,13504,13510,27,11,3,1,1,1,2,5,-3,3,3,4
12917,13504,13510,1,2,3,3,0,0,8,1,7,6,0,9
12918,13504,13510,52,9,3,1,1,1,4,4,0,3,3,4
12919,13504,13510,33,14,3,0,3,0,2,2,0,3,3,3
12920,13504,13510,28,17,3,0,1,2,3,7,-4,1,5,1
12921,13504,13510,47,10,3,1,1,1,3,3,0,3,3,4
12922,13511,13524,47,8,4,1,2,1,5,5,0,4,4,5
12923,13511,13524,52,12,4,1,1,2,5,7,-2,3,5,4
12924,13511,13524,28,14,4,1,1,2,4,7,-3,3,5,4
12925,13511,13524,33,16,4,0,3,1,3,4,-1,3,5,3
12926,13511,13524,1,2,4,4,0,0,11,2,9,8,0,12
12927,13511,13524,27,10,4,1,2,1,3,6,-3,4,4,5
12928,13511,13524,12,6,4,2,0,2,6,10,-4,4,4,6
12929,13511,13524,25,15,4,1,1,2,7,12,-5,3,5,4
12930,13511,13524,17,4,4,2,1,1,7,3,4,5,3,7
12931,13511,13524,22,1,4,4,0,0,15,3,12,8,0,12
12932,13511,13524,43,5,4,2,0,2,2,4,-2,4,4,6
12933,13511,13524,34,9,4,1,2,1,4,4,0,4,4,5
12934,13511,13524,4,7,4,1,2,1,8,6,2,4,4,5
12935,13511,13524,21,18,4,0,0,4,2,9,-7,0,8,0
12936,13511,13524,6,3,4,3,1,0,12,5,7,7,1,10
12937,13511,13524,35,13,4,1,1,2,6,9,-3,3,5,4
12938,13511,13524,49,11,4,1,1,2,6,6,0,3,5,4
12939,13511,13524,37,17,4,0,2,2,3,7,-4,2,6,2
12940,13560,13573,49,14,9,2,3,4,9,12,-3,7,11,9
12941,13560,13573,37,17,9,1,4,4,9,14,-5,6,12,7
12942,13560,13573,6,2,9,7,1,1,22,9,13,15,3,22
12943,13560,13573,35,4,9,5,1,3,17,13,4,11,7,16
12944,13560,13573,4,6,9,3,4,2,16,12,4,10,8,13
12945,13560,13573,21,18,9,1,1,7,7,18,-11,3,15,4
12946,13560,13573,22,3,9,5,2,2,24,15,9,12,6,17
12947,13560,13573,43,7,9,4,0,5,10,11,-1,8,10,12
12948,13560,13573,34,12,9,2,3,4,15,16,-1,7,11,9
12949,13560,13573,12,8,9,4,0,5,14,23,-9,8,10,12
12950,13560,13573,25,10,9,3,3,3,20,23,-3,9,9,12
12951,13560,13573,17,9,9,3,3,3,17,13,4,9,9,12
12952,13560,13573,27,11,9,3,2,4,11,20,-9,8,10,11
12953,13560,13573,33,13,9,2,3,4,8,10,-2,7,11,9
12954,13560,13573,28,15,9,2,3,4,7,15,-8,7,11,9
12955,13560,13573,52,16,9,2,2,5,10,18,-8,6,12,8
12956,13560,13573,47,5,9,3,5,1,14,9,5,11,7,14
12957,13560,13573,1,1,9,9,0,0,25,4,21,18,0,27
12958,13868,13874,6,5,1,1,0,0,2,1,1,2,0,3
12959,13868,13874,56,14,1,0,0,1,0,1,-1,0,2,0
12960,13868,13874,35,18,1,0,0,1,0,3,-3,0,2,0
12961,13868,13874,47,8,1,1,0,0,1,0,1,2,0,3
12962,13868,13874,17,11,1,0,0,1,1,2,-1,0,2,0
12963,13868,13874,33,2,1,1,0,0,2,0,2,2,0,3
12964,13868,13874,28,15,1,0,0,1,0,2,-2,0,2,0
12965,13868,13874,1,2,1,1,0,0,2,0,2,2,0,3
12966,13868,13874,27,9,1,0,1,0,1,1,0,1,1,1
12967,11887,11900,27,11,27,10,8,9,41,39,2,28,26,38
12968,11887,11900,21,6,27,13,4,10,50,40,10,30,24,43
12969,11887,11900,4,8,27,11,7,9,40,34,6,29,25,40
12970,11887,11900,49,2,27,15,6,6,50,30,20,36,18,51
12971,11887,11900,37,7,27,12,5,10,36,36,0,29,25,41
12972,11887,11900,14,16,27,5,5,17,34,78,-44,15,39,20
12973,11887,11900,52,9,27,10,10,7,37,29,8,30,24,40
12974,11887,11900,20,3,27,13,6,8,63,40,23,32,22,45
12975,11887,11900,41,12,27,9,7,11,37,53,-16,25,29,34
12976,11887,11900,35,13,27,9,6,12,47,51,-4,24,30,33
12977,11887,11900,6,18,27,4,4,19,29,66,-37,12,42,16
12978,11887,11900,43,1,27,22,4,1,66,19,47,48,6,70
12979,11887,11900,24,5,27,13,5,9,40,29,11,31,23,44
12980,11887,11900,22,14,27,7,10,10,29,33,-4,24,30,31
12981,11887,11900,57,15,27,6,8,13,50,61,-11,20,34,26
12982,11887,11900,1,4,27,13,6,8,40,27,13,32,22,45
12983,11929,11935,1,5,32,15,8,9,47,31,16,38,26,53
12984,11929,11935,17,10,32,12,6,14,41,49,-8,30,34,42
12985,11929,11935,20,4,32,15,8,9,71,45,26,38,26,53
12986,11929,11935,41,12,32,10,8,14,46,63,-17,28,36,38
12987,11929,11935,35,13,32,10,7,15,55,61,-6,27,37,37
12988,11929,11935,6,16,32,8,4,20,38,72,-34,20,44,28
12989,11929,11935,43,1,32,25,6,1,78,22,56,56,8,81
12990,11929,11935,24,3,32,16,6,10,46,32,14,38,26,54
12991,11929,11935,22,14,32,8,11,13,35,43,-8,27,37,35
12992,11929,11935,57,15,32,8,9,15,60,72,-12,25,39,33
12993,11929,11935,12,18,32,4,10,18,29,55,-26,18,46,22
12994,11929,11935,52,11,32,10,11,11,39,39,0,31,33,41
12995,11929,11935,49,2,32,16,9,7,63,41,22,41,23,57
12996,11929,11935,37,7,32,15,6,11,45,37,8,36,28,51
12997,11929,11935,14,17,32,6,5,21,38,93,-55,17,47,23
12998,11929,11935,21,6,32,15,7,10,55,41,14,37,27,52
12999,11929,11935,4,9,32,12,9,11,49,47,2,33,31,45
13000,11929,11935,27,8,32,14,8,10,53,45,8,36,28,50
13001,11936,11942,27,7,33,15,8,10,56,45,11,38,28,53
13002,11936,11942,21,5,33,16,7,10,57,41,16,39,27,55
13003,11936,11942,4,9,33,12,10,11,51,49,2,34,32,46
13004,11936,11942,49,2,33,17,9,7,65,41,24,43,23,60
13005,11936,11942,37,8,33,15,7,11,47,39,8,37,29,52
13006,11936,11942,14,17,33,6,6,21,40,95,-55,18,48,24
13007,11936,11942,52,11,33,10,11,12,39,43,-4,31,35,41
13008,11936,11942,12,18,33,4,11,18,31,57,-26,19,47,23
13009,11936,11942,43,1,33,26,6,1,79,22,57,58,8,84
13010,11936,11942,24,3,33,17,6,10,50,33,17,40,26,57
13011,11936,11942,57,14,33,9,9,15,64,72,-8,27,39,36
13012,11936,11942,22,15,33,8,11,14,35,46,-11,27,39,35
13013,11936,11942,20,4,33,16,8,9,76,45,31,40,26,56
13014,11936,11942,41,12,33,10,8,15,47,67,-20,28,38,38
13015,11936,11942,35,13,33,10,7,16,55,63,-8,27,39,37
13016,11936,11942,6,16,33,8,4,21,38,77,-39,20,46,28
13017,11936,11942,17,10,33,12,6,15,41,51,-10,30,36,42
13018,11936,11942,1,6,33,15,8,10,47,32,15,38,28,53
13019,11943,12026,1,6,34,16,8,10,49,32,17,40,28,56
13020,11943,12026,17,10,34,12,7,15,41,51,-10,31,37,43
13021,11943,12026,20,4,34,17,8,9,78,45,33,42,26,59
13022,11943,12026,41,12,34,10,8,16,48,71,-23,28,40,38
13023,11943,12026,35,13,34,10,7,17,57,67,-10,27,41,37
13024,11943,12026,6,16,34,9,4,21,42,79,-37,22,46,31
13025,11943,12026,43,1,34,26,6,2,80,24,56,58,10,84
13026,11943,12026,24,3,34,18,6,10,53,33,20,42,26,60
13027,11943,12026,57,14,34,9,10,15,65,73,-8,28,40,37
13028,11943,12026,22,15,34,8,11,15,37,50,-13,27,41,35
13029,11943,12026,12,18,34,4,12,18,32,58,-26,20,48,24
13030,11943,12026,52,11,34,10,11,13,39,45,-6,31,37,41
13031,11943,12026,49,2,34,18,9,7,69,43,26,45,23,63
13032,11943,12026,37,8,34,15,7,12,47,42,5,37,31,52
13033,11943,12026,14,17,34,6,7,21,40,95,-55,19,49,25
13034,11943,12026,21,5,34,17,7,10,61,42,19,41,27,58
13035,11943,12026,4,9,34,12,10,12,51,51,0,34,34,46
13036,11943,12026,27,7,34,16,8,10,58,46,12,40,28,56
13037,12027,12033,27,5,1,1,0,0,2,1,1,2,0,3
13038,12027,12033,20,18,1,0,0,1,0,3,-3,0,2,0
13039,12027,12033,4,3,1,1,0,0,2,0,2,2,0,3
13040,12027,12033,9,9,1,0,1,0,1,1,0,1,1,1
13041,12027,12033,21,15,1,0,0,1,0,2,-2,0,2,0
13042,12027,12033,49,7,1,1,0,0,1,0,1,2,0,3
13043,12027,12033,37,9,1,0,1,0,1,1,0,1,1,1
13044,12027,12033,52,17,1,0,0,1,1,4,-3,0,2,0
13045,9549,9562,1,1,9,7,2,0,26,8,18,16,2,23
13046,9549,9562,12,8,9,3,5,1,10,9,1,11,7,14
13047,9549,9562,53,10,9,2,5,2,6,10,-4,9,9,11
13048,9549,9562,27,7,9,4,2,3,12,13,-1,10,8,14
13049,10060,10073,27,9,26,9,6,11,31,38,-7,24,28,33
13050,10060,10073,1,1,26,18,3,5,61,29,32,39,13,57
13051,10060,10073,53,10,26,9,5,12,32,34,-2,23,29,32
13052,10060,10073,12,13,26,7,7,12,30,35,-5,21,31,28
13053,10060,10073,28,11,26,8,8,10,21,28,-7,24,28,32
13054,10060,10073,52,14,26,6,10,10,26,38,-12,22,30,28
13055,10060,10073,37,16,26,6,9,11,28,26,2,21,31,27
13056,10060,10073,49,7,26,9,7,10,39,37,2,25,27,34
13057,10060,10073,24,2,26,18,3,5,41,21,20,39,13,57
13058,10060,10073,43,4,26,12,8,6,46,22,24,32,20,44
13059,10060,10073,57,8,26,9,6,11,38,37,1,24,28,33
13060,10060,10073,2,17,26,6,4,16,19,47,-28,16,36,22
13061,10060,10073,22,18,26,6,4,16,25,65,-40,16,36,22
13062,10060,10073,20,5,26,13,4,9,43,38,5,30,22,43
13063,10060,10073,41,6,26,10,13,3,40,22,18,33,19,43
13064,10060,10073,56,15,26,7,6,13,32,51,-19,20,32,27
13065,10060,10073,21,3,26,16,7,3,59,27,32,39,13,55
13066,10060,10073,4,12,26,8,4,14,27,43,-16,20,32,28
13067,10109,10115,21,3,32,19,9,4,70,36,34,47,17,66
13068,10109,10115,4,17,32,8,8,16,32,51,-19,24,40,32
13069,10109,10115,41,5,32,13,15,4,47,26,21,41,23,54
13070,10109,10115,20,6,32,15,6,11,48,42,6,36,28,51
13071,10109,10115,56,11,32,10,8,14,39,54,-15,28,36,38
13072,10109,10115,24,2,32,20,6,6,46,23,23,46,18,66
13073,10109,10115,43,4,32,17,9,6,63,24,39,43,21,60
13074,10109,10115,57,7,32,12,7,13,47,44,3,31,33,43
13075,10109,10115,22,14,32,9,6,17,30,71,-41,24,40,33
13076,10109,10115,2,18,32,7,6,19,20,54,-34,20,44,27
13077,10109,10115,49,10,32,10,8,14,43,48,-5,28,36,38
13078,10109,10115,37,13,32,8,10,14,34,34,0,26,38,34
13079,10109,10115,28,8,32,10,9,13,28,34,-6,29,35,39
13080,10109,10115,52,15,32,7,12,13,30,45,-15,26,38,33
13081,10109,10115,1,1,32,22,5,5,71,33,38,49,15,71
13082,10109,10115,53,12,32,9,7,16,36,44,-8,25,39,34
13083,10109,10115,12,16,32,8,8,16,34,44,-10,24,40,32
13084,10109,10115,27,9,32,10,9,13,35,46,-11,29,35,39
13085,10123,10206,27,8,34,11,10,13,39,48,-9,32,36,43
13086,10123,10206,53,12,34,10,7,17,39,49,-10,27,41,37
13087,10123,10206,12,15,34,9,8,17,42,47,-5,26,42,35
13088,10123,10206,1,1,34,23,5,6,74,34,40,51,17,74
13089,10123,10206,28,11,34,10,9,15,30,39,-9,29,39,39
13090,10123,10206,52,14,34,8,12,14,33,48,-15,28,40,36
13091,10123,10206,49,10,34,11,8,15,46,51,-5,30,38,41
13092,10123,10206,37,16,34,8,11,15,36,38,-2,27,41,35
13093,10123,10206,24,2,34,21,7,6,50,24,26,49,19,70
13094,10123,10206,43,4,34,18,9,7,64,27,37,45,23,63
13095,10123,10206,57,7,34,12,9,13,48,45,3,33,35,45
13096,10123,10206,22,13,34,10,6,18,32,74,-42,26,42,36
13097,10123,10206,2,18,34,7,7,20,21,56,-35,21,47,28
13098,10123,10206,41,5,34,14,16,4,52,28,24,44,24,58
13099,10123,10206,20,6,34,16,7,11,50,43,7,39,29,55
13100,10123,10206,56,9,34,11,9,14,40,54,-14,31,37,42
13101,10123,10206,21,3,34,20,9,5,75,40,35,49,19,69
13102,10123,10206,4,17,34,8,9,17,34,60,-26,25,43,33
13103,10319,10325,24,1,17,12,4,1,32,13,19,28,6,40
13104,10319,10325,43,2,17,12,3,2,38,15,23,27,7,39
13105,10319,10325,57,17,17,3,4,10,18,28,-10,10,24,13
13106,10319,10325,22,18,17,2,6,9,9,31,-22,10,24,12
13107,10319,10325,17,14,17,4,5,8,12,24,-12,13,21,17
13108,10319,10325,28,6,17,8,4,5,21,22,-1,20,14,28
13109,10319,10325,52,11,17,5,3,9,15,27,-12,13,21,18
13110,10319,10325,54,16,17,4,4,9,21,31,-10,12,22,16
13111,10319,10325,49,9,17,5,6,6,23,25,-2,16,18,21
13112,10319,10325,37,15,17,4,4,9,18,25,-7,12,22,16
13113,10319,10325,21,5,17,8,6,3,33,23,10,22,12,30
13114,10319,10325,41,3,17,10,5,2,38,13,25,25,9,35
13115,10319,10325,20,7,17,7,3,7,25,26,-1,17,17,24
13116,10319,10325,56,8,17,6,5,6,27,24,3,17,17,23
13117,10319,10325,27,12,17,4,6,7,16,28,-12,14,20,18
13118,10319,10325,12,10,17,5,4,8,21,24,-3,14,20,19
13119,10319,10325,53,13,17,4,5,8,18,26,-8,13,21,17
13120,10319,10325,1,4,17,10,3,4,38,18,20,23,11,33
13121,10210,10213,27,14,2,0,1,1,0,3,-3,1,3,1
13122,10210,10213,28,1,2,2,0,0,6,1,5,4,0,6
13123,6602,6608,37,2,6,3,2,1,13,5,8,8,4,11
13124,6602,6608,49,7,6,2,3,1,10,6,4,7,5,9
13125,6602,6608,1,11,6,2,2,2,7,7,0,6,6,8
13126,6602,6608,27,6,6,3,0,3,8,11,-3,6,6,9
13127,6602,6608,53,3,6,3,1,2,9,3,6,7,5,10
13128,6602,6608,12,12,6,2,2,2,4,6,-2,6,6,8
13129,6602,6608,52,14,6,2,0,4,8,13,-5,4,8,6
13130,6602,6608,48,17,6,0,4,2,2,8,-6,4,8,4
13131,7029,7035,52,3,16,8,6,2,22,14,8,22,10,30
13132,7029,7035,48,14,16,2,9,5,20,26,-6,13,19,15
13133,7029,7035,12,1,16,12,2,2,41,11,30,26,6,38
13134,7029,7035,53,8,16,6,7,3,19,17,2,19,13,25
13135,7029,7035,27,17,16,3,2,11,8,31,-23,8,24,11
13136,7029,7035,59,18,16,2,3,11,11,42,-31,7,25,9
13137,7029,7035,1,2,16,11,2,3,33,10,23,24,8,35
13138,7029,7035,49,4,16,8,5,3,39,19,20,21,11,29
13139,7029,7035,37,9,16,5,8,3,18,17,1,18,14,23
13140,7029,7035,20,11,16,4,8,4,17,15,2,16,16,20
13141,7029,7035,41,12,16,4,4,8,19,27,-8,12,20,16
13142,7029,7035,43,5,16,8,2,6,32,19,13,18,14,26
13143,7029,7035,57,7,16,7,4,5,29,24,5,18,14,25
13144,7029,7035,22,15,16,3,5,8,13,40,-27,11,21,14
13145,7029,7035,17,6,16,8,1,7,28,24,4,17,15,25
13146,7029,7035,19,13,16,3,6,7,16,26,-10,12,20,15
13147,7029,7035,8,16,16,3,4,9,16,23,-7,10,22,13
13148,7029,7035,21,10,16,5,6,5,19,15,4,16,16,21
13149,7036,7063,21,9,17,6,6,5,23,15,8,18,16,24
13150,7036,7063,17,6,17,9,1,7,31,24,7,19,15,28
13151,7036,7063,19,13,17,4,6,7,18,26,-8,14,20,18
13152,7036,7063,8,16,17,3,4,10,16,27,-11,10,24,13
13153,7036,7063,43,4,17,9,2,6,35,20,15,20,14,29
13154,7036,7063,57,7,17,8,4,5,32,26,6,20,14,28
13155,7036,7063,22,15,17,3,5,9,13,42,-29,11,23,14
13156,7036,7063,20,11,17,5,8,4,19,15,4,18,16,23
13157,7036,7063,41,12,17,5,4,8,22,27,-5,14,20,19
13158,7036,7063,49,5,17,8,5,4,41,22,19,21,13,29
13159,7036,7063,37,10,17,5,9,3,19,18,1,19,15,24
13160,7036,7063,1,2,17,11,2,4,33,13,20,24,10,35
13161,7036,7063,27,17,17,3,3,11,9,32,-23,9,25,12
13162,7036,7063,59,18,17,2,3,12,11,45,-34,7,27,9
13163,7036,7063,12,1,17,13,2,2,44,13,31,28,6,41
13164,7036,7063,53,8,17,6,7,4,20,20,0,19,15,25
13165,7036,7063,52,3,17,8,6,3,22,16,6,22,12,30
13166,7036,7063,48,14,17,2,9,6,22,29,-7,13,21,15
13167,6938,6940,27,1,2,2,0,0,4,1,3,4,0,6
13168,6938,6940,59,11,2,0,2,0,2,2,0,2,2,2
13169,6938,6940,1,9,2,1,0,1,2,2,0,2,2,3
13170,6938,6940,49,5,2,1,1,0,2,1,1,3,1,4
13171,6938,6940,37,8,2,1,0,1,3,2,1,2,2,3
13172,6938,6940,57,3,2,2,0,0,4,2,2,4,0,6
13173,6938,6940,22,16,2,0,1,1,0,3,-3,1,3,1
13174,6938,6940,43,17,2,0,0,2,2,4,-2,0,4,0
13175,6938,6940,52,10,2,1,0,1,1,3,-2,2,2,3
13176,6938,6940,48,11,2,0,2,0,2,2,0,2,2,2
13177,6938,6940,17,7,2,1,0,1,4,3,1,2,2,3
13178,6938,6940,8,13,2,0,1,1,1,2,-1,1,3,1
13179,6938,6940,19,15,2,0,1,1,2,4,-2,1,3,1
13180,6938,6940,12,1,2,2,0,0,4,1,3,4,0,6
13181,6938,6940,53,4,2,1,1,0,3,2,1,3,1,4
13182,6938,6940,21,14,2,0,1,1,0,1,-1,1,3,1
13183,6938,6940,20,6,2,1,0,1,3,1,2,2,2,3
13184,6938,6940,41,18,2,0,0,2,1,4,-3,0,4,0
13185,7092,7098,17,7,22,10,3,9,37,31,6,23,21,33
13186,7092,7098,19,13,22,6,7,9,24,32,-8,19,25,25
13187,7092,7098,8,15,22,5,6,11,22,31,-9,16,28,21
13188,7092,7098,21,12,22,6,7,9,26,23,3,19,25,25
13189,7092,7098,43,4,22,13,3,6,44,20,24,29,15,42
13190,7092,7098,57,6,22,11,4,7,38,34,4,26,18,37
13191,7092,7098,22,14,22,5,8,9,20,46,-26,18,26,23
13192,7092,7098,41,9,22,8,5,9,29,30,-1,21,23,29
13193,7092,7098,20,11,22,6,9,7,23,24,-1,21,23,27
13194,7092,7098,49,5,22,12,6,4,50,22,28,30,14,42
13195,7092,7098,37,10,22,6,10,6,23,28,-5,22,22,28
13196,7092,7098,1,2,22,14,3,5,48,19,29,31,13,45
13197,7092,7098,27,17,22,4,4,14,12,47,-35,12,32,16
13198,7092,7098,59,18,22,2,3,17,13,58,-45,7,37,9
13199,7092,7098,52,3,22,12,7,3,35,19,16,31,13,43
13200,7092,7098,48,16,22,3,10,9,25,36,-11,16,28,19
13201,7092,7098,12,1,22,15,2,5,48,18,30,32,12,47
13202,7092,7098,53,8,22,7,9,6,26,25,1,23,21,30
13203,13868,13874,25,1,1,1,0,0,3,0,3,2,0,3
13204,13868,13874,43,9,1,0,1,0,1,1,0,1,1,1
13205,13868,13874,34,15,1,0,0,1,0,2,-2,0,2,0
13206,13868,13874,22,15,1,0,0,1,0,2,-2,0,2,0
13207,13868,13874,4,5,1,1,0,0,2,1,1,2,0,3
13208,13868,13874,9,5,1,1,0,0,2,1,1,2,0,3
13209,13868,13874,12,2,1,1,0,0,2,0,2,2,0,3
13210,13868,13874,49,11,1,0,0,1,1,2,-1,0,2,0
13211,13868,13874,37,11,1,0,0,1,1,2,-1,0,2,0
13212,13938,13944,49,4,12,7,1,4,20,10,10,15,9,22
13213,13938,13944,37,13,12,4,2,6,16,19,-3,10,14,14
13214,13938,13944,12,3,12,7,2,3,27,15,12,16,8,23
13215,13938,13944,25,5,12,7,1,4,30,21,9,15,9,22
13216,13938,13944,4,11,12,4,4,4,20,26,-6,12,12,16
13217,13938,13944,9,17,12,1,4,7,9,31,-22,6,18,7
13218,13938,13944,22,2,12,8,2,2,22,12,10,18,6,26
13219,13938,13944,34,7,12,5,3,4,20,18,2,13,11,18
13220,13938,13944,43,8,12,4,5,3,19,19,0,13,11,17
13221,13938,13944,27,14,12,3,5,4,17,15,2,11,13,14
13222,13938,13944,17,10,12,5,1,6,19,21,-2,11,13,16
13223,13938,13944,28,6,12,6,2,4,17,11,6,14,10,20
13224,13938,13944,33,9,12,4,5,3,20,22,-2,13,11,17
13225,13938,13944,47,16,12,2,4,6,13,21,-8,8,16,10
13226,13938,13944,35,12,12,4,2,6,19,20,-1,10,14,14
13227,13938,13944,6,15,12,3,2,7,14,18,-4,8,16,11
13228,13938,13944,56,18,12,1,3,8,17,33,-16,5,19,6
13229,13938,13944,1,1,12,8,2,2,23,10,13,18,6,26
13230,13875,13877,6,13,2,1,0,1,2,3,-1,2,2,3
13231,13875,13877,35,16,2,0,0,2,1,5,-4,0,4,0
13232,13875,13877,56,18,2,0,0,2,0,7,-7,0,4,0
13233,13875,13877,47,12,2,1,0,1,2,2,0,2,2,3
13234,13875,13877,17,15,2,0,0,2,2,5,-3,0,4,0
13235,13875,13877,1,3,2,2,0,0,4,1,3,4,0,6
13236,13875,13877,33,2,2,2,0,0,4,0,4,4,0,6
13237,13875,13877,28,8,2,1,0,1,4,3,1,2,2,3
13238,13875,13877,27,4,2,1,1,0,3,2,1,3,1,4
13239,13875,13877,22,10,2,1,0,1,3,3,0,2,2,3
13240,13875,13877,43,14,2,0,1,1,2,3,-1,1,3,1
13241,13875,13877,34,17,2,0,0,2,0,5,-5,0,4,0
13242,13875,13877,12,1,2,2,0,0,8,0,8,4,0,6
13243,13875,13877,25,9,2,1,0,1,4,4,0,2,2,3
13244,13875,13877,4,4,2,1,1,0,3,2,1,3,1,4
13245,13875,13877,9,4,2,1,1,0,3,2,1,3,1,4
13246,13875,13877,49,7,2,1,0,1,4,2,2,2,2,3
13247,13875,13877,37,10,2,1,0,1,3,3,0,2,2,3
13248,14407,14413,49,2,23,14,2,7,53,36,17,30,16,44
13249,14407,14413,37,13,23,6,6,11,34,42,-8,18,28,24
13250,14407,14413,25,9,23,9,6,8,44,53,-9,24,22,33
13251,14407,14413,12,11,23,8,6,9,42,45,-3,22,24,30
13252,14407,14413,58,17,23,2,9,12,16,42,-26,13,33,15
13253,14407,14413,4,5,23,13,1,9,56,44,12,27,19,40
13254,14407,14413,43,1,23,16,6,1,59,23,36,38,8,54
13255,14407,14413,22,7,23,11,6,6,47,36,11,28,18,39
13256,14407,14413,24,10,23,10,2,11,39,53,-14,22,24,32
13257,14407,14413,34,12,23,9,2,12,42,48,-6,20,26,29
13258,14407,14413,27,15,23,5,6,12,27,45,-18,16,30,21
13259,14407,14413,17,4,23,12,5,6,48,29,19,29,17,41
13260,14407,14413,33,6,23,12,4,7,51,34,17,28,18,40
13261,14407,14413,28,16,23,5,4,14,22,49,-27,14,32,19
13262,14407,14413,47,14,23,6,4,13,39,48,-9,16,30,22
13263,14407,14413,35,8,23,11,6,6,40,32,8,28,18,39
13264,14407,14413,6,18,23,1,10,12,22,49,-27,12,34,13
13265,14407,14413,1,3,23,13,3,7,52,25,27,29,17,42
13266,14953,14959,35,1,1,1,0,0,8,2,6,2,0,3
13267,14953,14959,6,7,1,1,0,0,1,0,1,2,0,3
13268,14953,14959,33,2,1,1,0,0,5,0,5,2,0,3
13269,14953,14959,52,12,1,0,0,1,0,1,-1,0,2,0
13270,14953,14959,28,13,1,0,0,1,2,4,-2,0,2,0
13271,14953,14959,1,5,1,1,0,0,4,2,2,2,0,3
13272,14953,14959,49,10,1,0,1,0,0,0,0,1,1,1
13273,14953,14959,37,16,1,0,0,1,1,5,-4,0,2,0
13274,14953,14959,12,8,1,0,1,0,1,1,0,1,1,1
13275,14953,14959,25,13,1,0,0,1,2,4,-2,0,2,0
13276,14953,14959,17,8,1,0,1,0,1,1,0,1,1,1
13277,14953,14959,27,10,1,0,1,0,0,0,0,1,1,1
13278,14953,14959,4,5,1,1,0,0,4,2,2,2,0,3
13279,14953,14959,21,15,1,0,0,1,0,3,-3,0,2,0
13280,14953,14959,22,3,1,1,0,0,5,1,4,2,0,3
13281,14953,14959,43,4,1,1,0,0,3,0,3,2,0,3
13282,14953,14959,34,17,1,0,0,1,0,5,-5,0,2,0
13283,14953,14959,40,18,1,0,0,1,2,8,-6,0,2,0
13284,15079,15085,22,2,16,10,5,1,46,21,25,25,7,35
13285,9955,9961,49,10,17,6,4,7,26,27,-1,16,18,22
13286,9955,9961,37,18,17,2,6,9,16,22,-6,10,24,12
13287,9955,9961,1,2,17,11,3,3,41,18,23,25,9,36
13288,9955,9961,53,11,17,6,4,7,21,22,-1,16,18,22
13289,10081,10087,1,1,28,19,4,5,64,31,33,42,14,61
13290,10081,10087,53,11,28,9,5,14,32,38,-6,23,33,32
13291,10081,10087,12,16,28,7,7,14,30,39,-9,21,35,28
13292,10081,10087,28,9,28,9,8,11,23,30,-7,26,30,35
13293,10081,10087,52,12,28,7,11,10,29,38,-9,25,31,32
13294,10081,10087,27,8,28,9,8,11,32,39,-7,26,30,35
13295,10081,10087,20,6,28,13,5,10,43,40,3,31,25,44
13296,10081,10087,56,13,28,8,7,13,35,51,-16,23,33,31
13297,10081,10087,21,3,28,17,8,3,62,28,34,42,14,59
13298,10081,10087,4,15,28,8,5,15,30,48,-18,21,35,29
13299,10081,10087,49,10,28,9,7,12,40,40,0,25,31,34
13300,10081,10087,37,14,28,7,9,12,30,30,0,23,33,30
13301,10081,10087,24,2,28,19,3,6,42,22,20,41,15,60
13302,10081,10087,43,4,28,14,8,6,52,23,29,36,20,50
13303,10081,10087,57,7,28,10,6,12,42,41,1,26,30,36
13304,10081,10087,22,17,28,7,5,16,27,66,-39,19,37,26
13305,10081,10087,2,18,28,6,5,17,19,50,-31,17,39,23
13306,10081,10087,41,5,28,12,13,3,44,22,22,37,19,49
13307,10095,10101,24,2,30,20,4,6,45,22,23,44,16,64
13308,10095,10101,43,4,30,15,9,6,59,24,35,39,21,54
13309,10095,10101,57,7,30,11,7,12,44,42,2,29,31,40
13310,10095,10101,2,17,30,7,6,17,20,50,-30,20,40,27
13311,10095,10101,22,18,30,7,6,17,27,71,-44,20,40,27
13312,10095,10101,49,8,30,10,8,12,43,42,1,28,32,38
13313,10095,10101,37,15,30,7,9,14,30,33,-3,23,37,30
13314,10095,10101,21,3,30,18,8,4,67,34,33,44,16,62
13315,10095,10101,4,14,30,8,6,16,31,50,-19,22,38,30
13316,10095,10101,41,5,30,13,14,3,46,23,23,40,20,53
13317,10095,10101,20,6,30,14,5,11,47,42,5,33,27,47
13318,10095,10101,56,9,30,10,7,13,39,52,-13,27,33,37
13319,10095,10101,27,11,30,9,9,12,33,43,-10,27,33,36
13320,10095,10101,28,10,30,9,9,12,24,32,-8,27,33,36
13321,10095,10101,52,13,30,7,11,12,29,43,-14,25,35,32
13322,10095,10101,53,12,30,9,6,15,34,41,-7,24,36,33
13323,10095,10101,12,16,30,7,8,15,32,42,-10,22,38,29
13324,10095,10101,1,1,30,21,4,5,67,31,36,46,14,67
13325,9864,9870,1,3,5,3,1,1,8,5,3,7,3,10
13326,9864,9870,27,14,5,1,2,2,7,8,-1,4,6,5
13327,9864,9870,24,4,5,3,1,1,6,4,2,7,3,10
13328,9864,9870,43,5,5,2,3,0,4,1,3,7,3,9
13329,9864,9870,57,13,5,1,2,2,8,8,0,4,6,5
13330,9864,9870,2,15,5,1,1,3,5,10,-5,3,7,4
13331,9864,9870,22,16,5,1,0,4,4,14,-10,2,8,3
13332,9864,9870,20,2,5,3,1,1,11,4,7,7,3,10
13333,9864,9870,41,6,5,2,2,1,9,6,3,6,4,8
13334,9864,9870,56,17,5,0,2,3,5,12,-7,2,8,2
13335,9864,9870,28,7,5,2,2,1,6,5,1,6,4,8
13336,9864,9870,52,11,5,2,1,2,8,9,-1,5,5,7
13337,9864,9870,21,1,5,4,1,0,15,5,10,9,1,13
13338,9864,9870,4,18,5,0,0,5,4,13,-9,0,10,0
13339,9864,9870,37,9,5,2,1,2,9,5,4,5,5,7
13340,9864,9870,49,10,5,2,1,2,7,6,1,5,5,7
13341,9864,9870,12,7,5,2,2,1,6,5,1,6,4,8
13342,9864,9870,53,12,5,2,1,2,4,6,-2,5,5,7
13343,10277,10290,49,7,13,5,4,4,17,15,2,14,12,19
13344,10277,10290,37,13,13,3,3,7,14,18,-4,9,17,12
13345,10277,10290,21,4,13,7,4,2,27,17,10,18,8,25
13346,10277,10290,28,8,13,5,4,4,14,18,-4,14,12,19
13347,10277,10290,52,10,13,5,2,6,11,16,-5,12,14,17
13348,10277,10290,54,14,13,3,2,8,15,22,-7,8,18,11
13349,10277,10290,27,17,13,2,4,7,9,24,-15,8,18,10
13350,10277,10290,41,3,13,7,5,1,26,9,17,19,7,26
13351,10277,10290,20,6,13,6,2,5,21,22,-1,14,12,20
13352,10277,10290,56,9,13,5,3,5,23,21,2,13,13,18
13353,10277,10290,12,11,13,4,3,6,17,17,0,11,15,15
13354,10277,10290,53,12,13,3,4,6,17,23,-6,10,16,13
13355,10277,10290,17,16,13,2,4,7,9,22,-13,8,18,10
13356,10277,10290,24,1,13,10,3,0,27,8,19,23,3,33
13357,10277,10290,43,2,13,9,2,2,29,12,17,20,6,29
13358,10277,10290,57,15,13,2,4,7,12,20,-8,8,18,10
13359,10277,10290,22,18,13,1,6,6,6,24,-18,8,18,9
13360,10277,10290,1,5,13,7,3,3,27,13,14,17,9,24
13361,10305,10311,1,5,15,8,3,4,31,17,14,19,11,27
13362,10305,10311,17,17,15,3,4,8,10,23,-13,10,20,13
13363,10305,10311,54,14,15,3,4,8,17,24,-7,10,20,13
13364,10210,10213,54,16,2,0,0,2,1,5,-4,0,4,0
13365,10210,10213,52,18,2,0,0,2,0,5,-5,0,4,0
13366,10210,10213,1,7,2,1,1,0,2,0,2,3,1,4
13367,10210,10213,12,5,2,1,1,0,4,0,4,3,1,4
13368,10210,10213,53,15,2,0,1,1,0,4,-4,1,3,1
13369,10210,10213,17,12,2,0,1,1,1,3,-2,1,3,1
13370,10210,10213,43,2,2,2,0,0,5,0,5,4,0,6
13371,10210,10213,24,4,2,1,1,0,5,1,4,3,1,4
13372,10210,10213,22,13,2,0,1,1,1,4,-3,1,3,1
13373,10210,10213,57,17,2,0,0,2,1,6,-5,0,4,0
13374,10210,10213,21,8,2,1,1,0,4,3,1,3,1,4
13375,10210,10213,20,3,2,2,0,0,4,1,3,4,0,6
13376,10210,10213,41,6,2,1,1,0,3,0,3,3,1,4
13377,10210,10213,56,10,2,0,2,0,1,1,0,2,2,2
13378,10210,10213,49,9,2,1,0,1,2,2,0,2,2,3
13379,10210,10213,37,11,2,0,1,1,3,4,-1,1,3,1
13380,10228,10234,49,8,6,3,1,2,10,6,4,7,5,10
13381,10228,10234,37,11,6,1,2,3,7,8,-1,4,8,5
13382,10228,10234,41,3,6,4,2,0,15,3,12,10,2,14
13383,10228,10234,20,5,6,4,2,0,10,5,5,10,2,14
13384,10228,10234,56,10,6,1,3,2,6,8,-2,5,7,6
13385,10228,10234,17,12,6,1,2,3,6,11,-5,4,8,5
13386,10228,10234,24,1,6,5,1,0,15,5,10,11,1,16
13387,10228,10234,43,2,6,5,0,1,17,6,11,10,2,15
13388,10228,10234,57,14,6,1,1,4,5,11,-6,3,9,4
13389,10228,10234,22,15,6,1,1,4,2,14,-12,3,9,4
13390,10228,10234,28,6,6,4,1,1,11,6,5,9,3,13
13391,10228,10234,54,17,6,0,1,5,7,16,-9,1,11,1
13392,10228,10234,52,18,6,0,1,5,2,12,-10,1,11,1
13393,10228,10234,12,9,6,2,2,2,7,5,2,6,6,8
13394,10228,10234,21,7,6,4,1,1,13,9,4,9,3,13
13395,10228,10234,27,16,6,0,2,4,2,14,-12,2,10,2
13396,10228,10234,53,13,6,1,1,4,10,15,-5,3,9,4
13397,10228,10234,1,4,6,4,2,0,16,7,9,10,2,14
13398,10235,10241,1,3,7,5,2,0,19,7,12,12,2,17
13399,10235,10241,12,9,7,2,2,3,7,6,1,6,8,8
13400,10235,10241,53,10,7,2,1,4,12,16,-4,5,9,7
13401,10235,10241,27,17,7,0,2,5,2,19,-17,2,12,2
13402,10235,10241,21,4,7,5,1,1,18,9,9,11,3,16
13403,10235,10241,56,11,7,1,3,3,7,11,-4,5,9,6
13404,10235,10241,28,5,7,5,1,1,12,6,6,11,3,16
13405,10235,10241,52,16,7,1,1,5,3,12,-9,3,11,4
13406,10235,10241,54,18,7,0,1,6,8,18,-10,1,13,1
13407,10235,10241,24,1,7,6,1,0,18,6,12,13,1,19
13408,10235,10241,43,2,7,6,0,1,18,6,12,12,2,18
13409,10235,10241,57,13,7,1,2,4,7,13,-6,4,10,5
13410,10235,10241,22,15,7,1,2,4,4,16,-12,4,10,5
13411,10235,10241,17,14,7,1,2,4,6,14,-8,4,10,5
13412,10235,10241,41,6,7,4,2,1,15,4,11,10,4,14
13413,10235,10241,20,7,7,4,2,1,11,7,4,10,4,14
13414,10235,10241,49,8,7,4,1,2,12,7,5,9,5,13
13415,10235,10241,37,12,7,1,2,4,7,9,-2,4,10,5
13416,10641,10654,56,8,10,4,2,4,12,16,-4,10,10,14
13417,10641,10654,41,11,10,3,2,5,8,10,-2,8,12,11
13418,10641,10654,35,14,10,3,1,6,13,17,-4,7,13,10
13419,10641,10654,20,16,10,2,2,6,10,21,-11,6,14,8
13420,10641,10654,21,5,10,4,5,1,19,9,10,13,7,17
13421,10641,10654,4,7,10,4,2,4,14,14,0,10,10,14
13422,10641,10654,43,1,10,8,2,0,27,3,24,18,2,26
13423,10641,10654,24,2,10,6,4,0,20,4,16,16,4,22
13424,10641,10654,57,4,10,6,1,3,15,12,3,13,7,19
13425,10641,10654,1,3,10,6,3,1,18,9,9,15,5,21
13426,10641,10654,28,17,10,1,4,5,5,15,-10,6,14,7
13427,10641,10654,54,18,10,1,2,7,9,20,-11,4,16,5
13428,10641,10654,27,15,10,3,1,6,10,14,-4,7,13,10
13429,10641,10654,12,6,10,4,3,3,13,14,-1,11,9,15
13430,10641,10654,53,13,10,2,5,3,8,12,-4,9,11,11
13431,10641,10654,37,9,10,3,3,4,11,15,-4,9,11,12
13432,10641,10654,49,12,10,2,5,3,11,11,0,9,11,11
13433,10641,10654,17,10,10,3,3,4,12,19,-7,9,11,12
13434,10627,10633,17,13,8,2,3,3,6,15,-9,7,9,9
13435,10627,10633,1,4,8,4,3,1,13,8,5,11,5,15
13436,10627,10633,49,9,8,2,5,1,10,6,4,9,7,11
13437,10627,10633,37,11,8,2,3,3,7,11,-4,7,9,9
13438,10627,10633,12,8,8,3,2,3,12,14,-2,8,8,11
13439,10627,10633,53,11,8,2,3,3,7,11,-4,7,9,9
13440,10627,10633,56,5,8,4,2,2,12,12,0,10,6,14
13441,10627,10633,41,14,8,2,2,4,4,6,-2,6,10,8
13442,10627,10633,20,15,8,2,2,4,8,15,-7,6,10,8
13443,10627,10633,35,16,8,2,1,5,9,12,-3,5,11,7
13444,10627,10633,27,10,8,3,1,4,10,9,1,7,9,10
13445,10627,10633,28,17,8,0,3,5,3,14,-11,3,13,3
13446,12027,12033,43,3,1,1,0,0,2,0,2,2,0,3
13447,12027,12033,24,11,1,0,0,1,1,2,-1,0,2,0
13448,12027,12033,22,11,1,0,0,1,1,2,-1,0,2,0
13449,12027,12033,57,15,1,0,0,1,0,2,-2,0,2,0
13450,12027,12033,35,1,1,1,0,0,4,1,3,2,0,3
13451,12027,12033,6,2,1,1,0,0,3,0,3,2,0,3
13452,12027,12033,41,7,1,1,0,0,1,0,1,2,0,3
13453,12027,12033,13,13,1,0,0,1,0,1,-1,0,2,0
13454,12027,12033,17,13,1,0,0,1,0,1,-1,0,2,0
13455,12027,12033,1,5,1,1,0,0,2,1,1,2,0,3
13456,12104,12110,43,1,12,10,1,1,37,15,22,21,3,31
13457,12104,12110,24,9,12,3,7,2,16,12,4,13,11,16
13458,12104,12110,57,14,12,2,4,6,18,27,-9,8,16,10
13459,12104,12110,22,18,12,0,4,8,15,31,-16,4,20,4
13460,12104,12110,13,4,12,6,3,3,20,9,11,15,9,21
13461,12104,12110,6,5,12,6,3,3,19,16,3,15,9,21
13462,12104,12110,35,8,12,4,4,4,18,18,0,12,12,16
13463,12104,12110,41,13,12,2,7,3,12,18,-6,11,13,13
13464,12104,12110,20,16,12,2,3,7,13,26,-13,7,17,9
13465,12104,12110,52,17,12,2,2,8,11,22,-11,6,18,8
13466,12104,12110,37,10,12,3,6,3,14,14,0,12,12,15
13467,12104,12110,49,11,12,4,2,6,10,10,0,10,14,14
13468,12104,12110,17,15,12,1,7,4,10,16,-6,9,15,10
13469,12104,12110,27,6,12,6,2,4,19,14,5,14,10,20
13470,12104,12110,21,3,12,6,4,2,15,11,4,16,8,22
13471,12104,12110,9,7,12,4,7,1,18,13,5,15,9,19
13472,12104,12110,4,12,12,2,7,3,17,20,-3,11,13,13
13473,12104,12110,1,2,12,6,5,1,20,10,10,17,7,23
13474,12111,12131,1,2,13,7,5,1,21,10,11,19,7,26
13475,12111,12131,4,12,13,2,8,3,17,20,-3,12,14,14
13476,12111,12131,27,4,13,7,2,4,20,14,6,16,10,23
13477,12111,12131,37,8,13,4,6,3,16,14,2,14,12,18
13478,12111,12131,49,11,13,4,3,6,10,10,0,11,15,15
13479,12111,12131,52,14,13,3,2,8,15,23,-8,8,18,11
13480,12111,12131,21,5,13,6,5,2,16,12,4,17,9,23
13481,12111,12131,9,7,13,4,8,1,19,14,5,16,10,20
13482,12111,12131,13,3,13,7,3,3,21,9,12,17,9,24
13483,12111,12131,6,6,13,6,4,3,20,17,3,16,10,22
13484,12111,12131,35,9,13,4,5,4,19,19,0,13,13,17
13485,12111,12131,41,13,13,2,7,4,12,20,-8,11,15,13
13486,12111,12131,20,17,13,2,3,8,13,27,-14,7,19,9
13487,12111,12131,43,1,13,11,1,1,38,15,23,23,3,34
13488,12111,12131,24,10,13,3,7,3,16,13,3,13,13,16
13489,12111,12131,57,15,13,2,4,7,18,28,-10,8,18,10
13490,12111,12131,22,18,13,0,4,9,16,35,-19,4,22,4
13491,12111,12131,17,16,13,1,7,5,10,17,-7,9,17,10
13492,12132,12138,43,1,14,11,2,1,39,16,23,24,4,35
13493,12132,12138,24,11,14,3,8,3,18,15,3,14,14,17
13494,12132,12138,57,15,14,2,4,8,18,32,-14,8,20,10
13495,12132,12138,22,18,14,0,5,9,18,37,-19,5,23,5
13496,12132,12138,13,4,14,7,4,3,22,10,12,18,10,25
13497,12132,12138,6,5,14,6,5,3,21,18,3,17,11,23
13498,12132,12138,35,7,14,5,5,4,20,19,1,15,13,20
13499,12132,12138,41,14,14,2,7,5,12,23,-11,11,17,13
13500,12132,12138,20,17,14,2,3,9,13,28,-15,7,21,9
13501,12132,12138,52,13,14,4,2,8,17,24,-7,10,18,14
13502,12132,12138,37,9,14,4,7,3,17,15,2,15,13,19
13503,12132,12138,49,10,14,5,3,6,14,10,4,13,15,18
13504,12132,12138,27,3,14,8,2,4,23,16,7,18,10,26
13505,12132,12138,17,16,14,1,7,6,11,19,-8,9,19,10
13506,12132,12138,21,6,14,6,5,3,18,15,3,17,11,23
13507,12132,12138,9,8,14,4,8,2,20,16,4,16,12,20
13508,12132,12138,4,12,14,3,8,3,19,21,-2,14,14,17
13509,12132,12138,1,2,14,8,5,1,24,10,14,21,7,29
13510,12160,12180,1,2,18,9,8,1,28,13,15,26,10,35
13511,12160,12180,21,5,18,7,8,3,24,17,7,22,14,29
13512,12160,12180,9,10,18,5,10,3,26,23,3,20,16,25
13513,12160,12180,4,12,18,4,9,5,24,27,-3,17,19,21
13514,12160,12180,27,3,18,10,3,5,36,24,12,23,13,33
13515,12160,12180,17,16,18,2,8,8,15,27,-12,12,24,14
13516,12160,12180,20,17,18,3,4,11,15,32,-17,10,26,13
13517,12160,12180,49,8,18,7,5,6,21,13,8,19,17,26
13518,12160,12180,37,11,18,4,9,5,20,21,-1,17,19,21
13519,12160,12180,52,14,18,4,4,10,18,29,-11,12,24,16
13520,12160,12180,13,4,18,8,7,3,29,16,13,23,13,31
13521,12160,12180,35,6,18,7,6,5,27,23,4,20,16,27
13522,12160,12180,6,7,18,7,6,5,26,24,2,20,16,27
13523,12160,12180,41,13,18,3,8,7,19,31,-12,14,22,17
13524,12160,12180,43,1,18,13,4,1,45,19,26,30,6,43
13525,10305,10311,52,11,15,5,2,8,13,22,-9,12,18,17
13526,10305,10311,12,10,15,5,3,7,20,20,0,13,17,18
13527,10305,10311,53,16,15,3,4,8,17,26,-9,10,20,13
13528,10305,10311,27,13,15,3,5,7,13,26,-13,11,19,14
13529,10305,10311,41,3,15,9,5,1,31,11,20,23,7,32
13530,10305,10311,20,6,15,7,2,6,24,24,0,16,14,23
13531,10305,10311,56,7,15,6,4,5,26,22,4,16,14,22
13532,10305,10311,24,1,15,11,3,1,29,12,17,25,5,36
13533,10305,10311,43,2,15,10,3,2,33,14,19,23,7,33
13534,10305,10311,57,15,15,3,4,8,16,23,-7,10,20,13
13535,10305,10311,22,18,15,2,6,7,9,27,-18,10,20,12
13536,10305,10311,28,8,15,6,4,5,18,21,-3,16,14,22
13537,10305,10311,21,4,15,8,4,3,29,19,10,20,10,28
13538,10305,10311,49,9,15,5,5,5,20,20,0,15,15,20
13539,10305,10311,37,12,15,4,3,8,17,22,-5,11,19,15
13540,10333,10374,49,9,19,7,6,6,28,26,2,20,18,27
13541,10333,10374,37,15,19,4,5,10,20,30,-10,13,25,17
13542,10333,10374,21,5,19,9,7,3,37,24,13,25,13,34
13543,10333,10374,24,1,19,14,4,1,36,13,23,32,6,46
13544,10333,10374,43,2,19,14,3,2,48,17,31,31,7,45
13545,10333,10374,57,17,19,3,4,12,18,33,-15,10,28,13
13546,10333,10374,22,18,19,2,6,11,10,39,-29,10,28,12
13547,10333,10374,41,4,19,10,7,2,40,15,25,27,11,37
13548,10333,10374,20,7,19,8,3,8,30,29,1,19,19,27
13549,10333,10374,56,8,19,7,6,6,32,26,6,20,18,27
13550,10333,10374,27,12,19,4,8,7,18,30,-12,16,22,20
13551,10333,10374,12,10,19,5,6,8,24,27,-3,16,22,21
13552,10333,10374,53,14,19,4,6,9,20,29,-9,14,24,18
13553,10333,10374,28,6,19,9,4,6,23,25,-2,22,16,31
13554,10333,10374,54,11,19,5,5,9,24,32,-8,15,23,20
13555,10333,10374,52,13,19,5,3,11,17,33,-16,13,25,18
13556,10333,10374,17,16,19,4,5,10,13,31,-18,13,25,17
13557,10333,10374,1,3,19,11,4,4,40,19,21,26,12,37
13558,10424,10430,1,5,26,12,9,5,49,30,19,33,19,45
13559,10424,10430,17,11,26,7,7,12,18,37,-19,21,31,28
13560,10424,10430,28,7,26,10,7,9,32,37,-5,27,25,37
13561,10424,10430,52,12,26,8,3,15,26,47,-21,19,33,27
13562,10424,10430,54,17,26,6,5,15,26,48,-22,17,35,23
13563,10424,10430,12,14,26,6,8,12,32,44,-12,20,32,26
13564,10424,10430,53,15,26,6,8,12,30,43,-13,20,32,26
13565,10424,10430,27,13,26,5,12,9,22,39,-17,22,30,27
13566,10424,10430,24,1,26,20,5,1,53,14,39,45,7,65
13567,10424,10430,43,2,26,16,7,3,63,26,37,39,13,55
13568,10424,10430,57,16,26,6,6,14,26,37,-11,18,34,24
13569,10424,10430,22,18,26,2,8,16,15,52,-37,12,40,14
13570,10424,10430,41,4,26,13,8,5,49,18,31,34,18,47
13571,10424,10430,56,8,26,8,12,6,40,32,8,28,24,36
13572,10424,10430,20,9,26,10,4,12,39,40,-1,24,28,34
13573,10424,10430,21,3,26,13,9,4,49,28,21,35,17,48
13574,10424,10430,49,6,26,12,7,7,38,30,8,31,21,43
13575,10424,10430,37,10,26,9,5,12,32,37,-5,23,29,32
13576,10434,10437,49,6,28,12,8,8,40,33,7,32,24,44
13577,10434,10437,37,10,28,9,7,12,34,39,-5,25,31,34
13578,10434,10437,21,4,28,14,9,5,54,32,22,37,19,51
13579,10434,10437,41,3,28,14,9,5,51,19,32,37,19,51
13580,10434,10437,56,8,28,8,14,6,43,35,8,30,26,38
13581,10434,10437,20,9,28,10,5,13,41,43,-2,25,31,35
13582,10434,10437,24,1,28,21,6,1,54,14,40,48,8,69
13583,10434,10437,43,2,28,17,8,3,69,30,39,42,14,59
13584,10434,10437,57,12,28,8,6,14,31,39,-8,22,34,30
13585,10434,10437,22,18,28,2,9,17,18,57,-39,13,43,15
13586,10434,10437,27,15,28,5,13,10,24,42,-18,23,33,28
13587,10434,10437,53,13,28,7,8,13,35,48,-13,22,34,29
13588,10434,10437,12,14,28,7,8,13,35,49,-14,22,34,29
13589,10434,10437,28,7,28,10,9,9,34,39,-5,29,27,39
13590,10434,10437,52,16,28,8,3,17,27,52,-25,19,37,27
13591,10434,10437,54,17,28,7,6,15,29,49,-20,20,36,27
13592,10434,10437,17,11,28,8,7,13,23,42,-19,23,33,31
13593,10434,10437,1,5,28,13,9,6,52,32,20,35,21,48
13594,10683,10689,12,7,15,6,4,5,19,21,-2,16,14,22
13595,10683,10689,53,16,15,2,6,7,9,24,-15,10,20,12
13596,10683,10689,1,2,15,9,4,2,25,14,11,22,8,31
13597,10683,10689,17,11,15,5,4,6,18,28,-10,14,16,19
13598,10683,10689,28,17,15,2,5,8,9,24,-15,9,21,11
13599,10683,10689,54,18,15,2,4,9,11,24,-13,8,22,10
13600,10683,10689,27,12,15,5,3,7,17,18,-1,13,17,18
13601,10683,10689,35,9,15,6,2,7,21,21,0,14,16,20
13602,10683,10689,56,10,15,5,5,5,16,21,-5,15,15,20
13603,5293,5299,57,9,26,8,9,9,25,30,-5,25,27,33
13604,5293,5299,24,16,26,6,9,11,15,26,-11,21,31,27
13605,5293,5299,22,20,26,1,10,15,20,55,-35,12,40,13
13606,5293,5299,49,4,26,14,6,6,42,22,20,34,18,48
13607,5293,5299,37,11,26,7,10,9,20,23,-3,24,28,31
13608,5293,5299,5,17,26,6,8,12,41,49,-8,20,32,26
13609,5293,5299,53,7,26,12,7,7,39,27,12,31,21,43
13610,5293,5299,12,8,26,11,8,7,38,35,3,30,22,41
13611,5293,5299,52,1,26,17,9,0,70,25,45,43,9,60
13612,5293,5299,48,12,26,6,12,8,22,25,-3,24,28,30
13613,5293,5299,36,19,26,4,7,15,17,50,-33,15,37,19
13614,5293,5299,17,5,26,13,4,9,40,36,4,30,22,43
13615,5293,5299,8,10,26,8,7,11,31,41,-10,23,29,31
13616,5293,5299,21,6,26,12,7,7,44,26,18,31,21,43
13617,5293,5299,1,3,26,14,7,5,54,22,32,35,17,49
13618,5293,5299,18,18,26,5,11,10,22,47,-25,21,31,26
13619,5293,5299,27,14,26,7,8,11,26,43,-17,22,30,29
13620,5300,5306,27,13,27,8,8,11,28,44,-16,24,30,32
13621,5300,5306,1,3,27,14,7,6,54,23,31,35,19,49
13622,5300,5306,18,18,27,5,11,11,22,48,-26,21,33,26
13623,5300,5306,21,6,27,13,7,7,51,26,25,33,21,46
13624,5300,5306,17,5,27,14,4,9,41,36,5,32,22,46
13625,5300,5306,8,12,27,8,8,11,31,41,-10,24,30,32
13626,5300,5306,52,1,27,17,9,1,70,27,43,43,11,60
13627,5300,5306,53,7,27,13,7,7,40,27,13,33,21,46
13628,5300,5306,12,8,27,11,8,8,38,36,2,30,24,41
13629,5300,5306,48,15,27,6,12,9,23,28,-5,24,30,30
13630,5300,5306,36,19,27,5,7,15,19,50,-31,17,37,22
13631,5300,5306,37,9,27,8,10,9,21,23,-2,26,28,34
13632,5300,5306,5,17,27,6,8,13,41,56,-15,20,34,26
13633,5300,5306,49,4,27,14,6,7,42,25,17,34,20,48
13634,5300,5306,43,2,27,14,11,2,52,15,37,39,15,53
13635,5300,5306,57,10,27,8,10,9,25,30,-5,26,28,34
13636,5300,5306,24,16,27,6,9,12,15,27,-12,21,33,27
13637,5300,5306,22,20,27,1,10,16,21,57,-36,12,42,13
13638,5300,5306,20,11,27,8,8,11,27,33,-6,24,30,32
13639,5300,5306,41,14,27,8,6,13,30,39,-9,22,32,30
13640,5335,5337,43,2,33,18,11,4,64,17,47,47,19,65
13641,5335,5337,57,9,33,11,11,11,35,38,-3,33,33,44
13642,5335,5337,24,16,33,8,9,16,22,37,-15,25,41,33
13643,5335,5337,22,20,33,3,11,19,25,64,-39,17,49,20
13644,5335,5337,20,10,33,10,11,12,34,39,-5,31,35,41
13645,5335,5337,41,11,33,11,7,15,40,47,-7,29,37,40
13646,5335,5337,49,3,33,18,6,9,57,33,24,42,24,60
13647,5335,5337,37,12,33,9,12,12,25,31,-6,30,36,39
13648,5335,5337,5,17,33,7,11,15,49,68,-19,25,41,32
13649,5335,5337,53,7,33,16,8,9,49,32,17,40,26,56
13650,5335,5337,12,8,33,13,10,10,45,44,1,36,30,49
13651,5335,5337,52,1,33,21,10,2,79,32,47,52,14,73
13652,5335,5337,17,6,33,17,5,11,46,41,5,39,27,56
13653,5335,5337,8,14,33,9,9,15,41,53,-12,27,39,36
13654,5335,5337,21,4,33,17,8,8,60,28,32,42,24,59
13655,5335,5337,1,5,33,16,10,7,61,28,33,42,24,58
13656,5335,5337,18,19,33,6,11,16,26,64,-38,23,43,29
13657,5335,5337,27,13,33,9,11,13,32,51,-19,29,37,38
13658,5335,5337,48,15,33,7,14,12,28,40,-12,28,38,35
13659,5335,5337,36,18,33,8,7,18,27,58,-31,23,43,31
13660,5146,5159,27,13,9,3,2,4,9,15,-6,8,10,11
13661,5146,5159,1,5,9,4,3,2,17,10,7,11,7,15
13662,5146,5159,18,16,9,2,3,4,8,17,-9,7,11,9
13663,5146,5159,21,3,9,5,1,3,12,8,4,11,7,16
13664,5146,5159,17,6,9,4,2,3,13,9,4,10,8,14
13665,5146,5159,8,15,9,3,1,5,9,16,-7,7,11,10
13666,5146,5159,53,7,9,4,2,3,13,10,3,10,8,14
13667,5146,5159,12,9,9,4,2,3,18,19,-1,10,8,14
13668,5146,5159,49,10,9,3,3,3,16,14,2,9,9,12
13669,5146,5159,5,12,9,3,3,3,14,15,-1,9,9,12
13670,5146,5159,37,17,9,1,6,2,7,7,0,8,10,9
13671,5146,5159,52,2,9,5,4,0,21,9,12,14,4,19
13672,5146,5159,48,14,9,2,5,2,8,8,0,9,9,11
13673,5146,5159,36,19,9,0,4,5,4,16,-12,4,14,4
13674,5146,5159,41,11,9,3,3,3,10,9,1,9,9,12
13675,5146,5159,20,18,9,1,5,3,7,9,-2,7,11,8
13676,5146,5159,43,1,9,5,4,0,24,5,19,14,4,19
13677,5146,5159,57,4,9,4,4,1,12,9,3,12,6,16
13678,5146,5159,24,8,9,4,2,3,10,8,2,10,8,14
13679,5146,5159,22,20,9,0,1,8,5,24,-19,1,17,1
13680,5608,5614,43,3,19,11,4,4,38,24,14,26,12,37
13681,15079,15085,43,5,16,9,5,2,32,17,15,23,9,32
13682,15079,15085,34,16,16,4,3,9,16,37,-21,11,21,15
13683,15079,15085,40,17,16,3,4,9,20,36,-16,10,22,13
13684,15079,15085,49,3,16,10,4,2,30,17,13,24,8,34
13685,15079,15085,37,18,16,1,5,10,15,39,-24,7,25,8
13686,15079,15085,4,4,16,10,3,3,31,21,10,23,9,33
13687,15079,15085,21,15,16,4,3,9,22,29,-7,11,21,15
13688,15079,15085,12,6,16,8,4,4,23,15,8,20,12,28
13689,15079,15085,25,14,16,4,3,9,23,28,-5,11,21,15
13690,15079,15085,27,10,16,5,3,8,14,29,-15,13,19,18
13691,15079,15085,17,13,16,4,5,7,21,24,-3,13,19,17
13692,15079,15085,33,8,16,6,1,9,32,27,5,13,19,19
13693,15079,15085,28,9,16,5,4,7,23,26,-3,14,18,19
13694,15079,15085,52,12,16,5,2,9,23,31,-8,12,20,17
13695,15079,15085,35,7,16,7,5,4,35,23,12,19,13,26
13696,15079,15085,6,11,16,4,6,6,27,34,-7,14,18,18
13697,15079,15085,1,1,16,12,1,3,38,17,21,25,7,37
13698,15135,15141,35,9,22,7,9,6,44,34,10,23,21,30
13699,15135,15141,6,13,22,6,6,10,32,39,-7,18,26,24
13700,15135,15141,33,7,22,11,2,9,46,29,17,24,20,35
13701,15135,15141,28,8,22,9,4,9,33,32,1,22,22,31
13702,15135,15141,52,12,22,7,3,12,30,40,-10,17,27,24
13703,15135,15141,1,1,22,16,1,5,54,26,28,33,11,49
13704,15135,15141,17,14,22,5,6,11,34,43,-9,16,28,21
13705,15135,15141,12,4,22,12,6,4,34,21,13,30,14,42
13706,15135,15141,25,10,22,7,4,11,36,43,-7,18,26,25
13707,15135,15141,27,11,22,7,4,11,22,43,-21,18,26,25
13708,15135,15141,4,5,22,12,6,4,38,28,10,30,14,42
13709,15135,15141,21,15,22,5,5,12,29,41,-12,15,29,20
13710,15135,15141,49,6,22,12,5,5,42,27,15,29,15,41
13711,15135,15141,37,18,22,2,7,13,23,58,-35,11,33,13
13712,15135,15141,43,2,22,13,7,2,52,24,28,33,11,46
13713,15135,15141,22,3,22,12,9,1,61,30,31,33,11,45
13714,15135,15141,40,16,22,4,7,11,25,44,-19,15,29,19
13715,15135,15141,34,17,22,4,3,15,18,51,-33,11,33,15
13716,15012,15015,22,3,8,5,2,1,25,12,13,12,4,17
13717,15012,15015,43,4,8,5,2,1,18,8,10,12,4,17
13718,15012,15015,34,7,8,4,1,3,11,17,-6,9,7,13
13719,15012,15015,40,17,8,0,2,6,7,23,-16,2,14,2
13720,15012,15015,4,1,8,7,0,1,17,9,8,14,2,21
13721,15012,15015,21,14,8,2,2,4,11,12,-1,6,10,8
13722,15012,15015,27,10,8,3,2,3,7,9,-2,8,8,11
13723,15012,15015,12,6,8,4,1,3,13,8,5,9,7,13
13724,15012,15015,25,15,8,2,1,5,13,15,-2,5,11,7
13725,15012,15015,33,8,8,4,0,4,17,10,7,8,8,12
13726,15012,15015,28,9,8,3,3,2,15,13,2,9,7,12
13727,15012,15015,52,18,8,0,1,7,5,17,-12,1,15,1
13728,15012,15015,1,2,8,6,0,2,18,8,10,12,4,18
13729,15012,15015,49,5,8,4,3,1,11,7,4,11,5,15
13730,15012,15015,37,16,8,0,3,5,6,22,-16,3,13,3
13731,15012,15015,6,11,8,3,2,3,14,18,-4,8,8,11
13732,15012,15015,35,12,8,2,4,2,17,14,3,8,8,10
13733,15012,15015,17,13,8,2,3,3,8,11,-3,7,9,9
13734,15450,15477,17,5,16,8,5,3,26,16,10,21,11,29
13735,15450,15477,42,7,16,7,2,7,26,22,4,16,16,23
13736,15450,15477,35,15,16,4,2,10,28,36,-8,10,22,14
13737,15450,15477,49,8,16,6,5,5,29,24,5,17,15,23
13738,15450,15477,37,14,16,5,1,10,19,37,-18,11,21,16
13739,15450,15477,4,10,16,6,2,8,23,27,-4,14,18,20
13740,15450,15477,21,11,16,5,4,7,25,30,-5,14,18,19
13741,15450,15477,1,1,16,14,1,1,45,14,31,29,3,43
13742,15450,15477,28,2,16,10,3,3,45,24,21,23,9,33
13743,15450,15477,33,9,16,6,5,5,29,31,-2,17,15,23
13744,15450,15477,12,4,16,9,4,3,33,24,9,22,10,31
13745,15450,15477,25,13,16,5,1,10,12,27,-15,11,21,16
13746,15450,15477,27,16,16,1,5,10,16,41,-25,7,25,8
13747,15450,15477,43,3,16,10,2,4,39,21,18,22,10,32
13748,15450,15477,22,6,16,7,5,4,35,25,10,19,13,26
13749,15450,15477,40,12,16,4,5,7,19,18,1,13,19,17
13750,15450,15477,24,17,16,1,4,11,10,42,-32,6,26,7
13751,15352,15358,21,6,5,2,2,1,8,7,1,6,4,8
13752,15352,15358,4,7,5,2,2,1,7,6,1,6,4,8
13753,15352,15358,43,3,5,3,1,1,11,5,6,7,3,10
13754,15352,15358,22,9,4,2,1,1,14,10,4,5,3,7
13755,15352,15358,24,12,5,1,1,3,2,10,-8,3,7,4
13756,15352,15358,40,15,5,0,3,2,5,7,-2,3,7,3
13757,15352,15358,37,14,5,1,0,4,4,15,-11,2,8,3
13758,15352,15358,49,17,5,0,1,4,4,11,-7,1,9,1
13759,15352,15358,27,16,5,0,2,3,5,13,-8,2,8,2
13760,15352,15358,12,4,4,3,1,0,8,4,4,7,1,10
13761,10627,10633,54,18,8,0,2,6,6,15,-9,2,14,2
13762,10627,10633,43,1,8,6,2,0,22,3,19,14,2,20
13763,10627,10633,24,2,8,5,3,0,15,3,12,13,3,18
13764,10627,10633,57,3,8,5,0,3,12,11,1,10,6,15
13765,10627,10633,4,6,8,4,1,3,13,11,2,9,7,13
13766,10627,10633,21,7,8,3,4,1,14,7,7,10,6,13
13767,11208,11214,35,5,32,17,7,8,54,35,19,41,23,58
13768,11208,11214,41,9,32,10,9,13,38,42,-4,29,35,39
13769,11208,11214,20,11,32,8,12,12,32,41,-9,28,36,36
13770,11208,11214,56,16,32,8,5,19,36,57,-21,21,43,29
13771,11208,11214,43,1,32,23,6,3,73,20,53,52,12,75
13772,11208,11214,24,2,32,20,8,4,58,23,35,48,16,68
13773,11208,11214,57,13,32,9,7,16,39,68,-29,25,39,34
13774,11208,11214,22,14,32,8,8,16,30,63,-33,24,40,32
13775,11208,11214,52,12,32,9,8,15,33,42,-9,26,38,35
13776,11208,11214,28,17,32,6,10,16,29,48,-19,22,42,28
13777,11208,11214,1,4,32,16,11,5,55,25,30,43,21,59
13778,11208,11214,27,10,32,8,15,9,31,32,-1,31,33,39
13779,11208,11214,4,3,32,19,7,6,65,35,30,45,19,64
13780,11208,11214,21,7,32,10,13,9,51,43,8,33,31,43
13781,11208,11214,12,8,32,11,8,13,40,43,-3,30,34,41
13782,11208,11214,53,18,32,5,5,22,29,64,-35,15,49,20
13783,11208,11214,49,6,32,14,10,8,46,41,5,38,26,52
13784,11208,11214,17,15,32,7,11,14,22,39,-17,25,39,32
13785,11215,11221,17,14,33,8,11,14,24,40,-16,27,39,35
13786,11215,11221,49,6,33,15,10,8,48,42,6,40,26,55
13787,11215,11221,12,8,33,11,8,14,40,45,-5,30,36,41
13788,11215,11221,53,18,33,5,5,23,31,68,-37,15,51,20
13789,11215,11221,4,3,33,20,7,6,67,36,31,47,19,67
13790,11215,11221,21,7,33,10,14,9,53,45,8,34,32,44
13791,11215,11221,20,12,33,8,12,13,33,43,-10,28,38,36
13792,11215,11221,56,16,33,9,5,19,38,57,-19,23,43,32
13793,11215,11221,27,10,33,8,15,10,32,34,-2,31,35,39
13794,11215,11221,1,4,33,17,11,5,59,27,32,45,21,62
13795,11215,11221,52,11,33,10,8,15,39,43,-4,28,38,38
13796,11215,11221,28,17,33,6,10,17,29,49,-20,22,44,28
13797,11215,11221,43,1,33,23,7,3,74,21,53,53,13,76
13798,11215,11221,24,2,33,20,9,4,59,24,35,49,17,69
13799,11215,11221,22,13,33,9,8,16,31,63,-32,26,40,35
13800,11215,11221,57,15,33,9,7,17,40,70,-30,25,41,34
13801,11215,11221,35,5,33,17,7,9,55,41,14,41,25,58
13802,11215,11221,41,9,33,10,10,13,40,44,-4,30,36,40
13803,10956,10969,17,17,4,1,0,3,4,8,-4,2,6,3
13804,10956,10969,24,10,4,1,1,2,7,9,-2,3,5,4
13805,10956,10969,43,11,4,1,1,2,3,5,-2,3,5,4
13806,10956,10969,57,13,4,1,1,2,3,7,-4,3,5,4
13807,10956,10969,22,14,4,1,1,2,2,8,-6,3,5,4
13808,10956,10969,52,9,4,1,1,2,5,5,0,3,5,4
13809,10956,10969,28,12,4,1,1,2,5,8,-3,3,5,4
13810,10956,10969,56,6,4,2,0,2,7,4,3,4,4,6
13811,10956,10969,20,7,4,1,2,1,6,3,3,4,4,5
13812,10956,10969,35,8,4,1,2,1,8,6,2,4,4,5
13813,10956,10969,41,15,4,1,0,3,4,6,-2,2,6,3
13814,10956,10969,4,1,4,4,0,0,12,4,8,8,0,12
13815,10956,10969,21,5,4,2,1,1,6,6,0,5,3,7
13816,10956,10969,49,2,4,3,1,0,12,3,9,7,1,10
13817,10956,10969,12,16,4,1,0,3,2,5,-3,2,6,3
13818,10956,10969,53,18,4,0,2,2,4,13,-9,2,6,2
13819,10956,10969,27,3,4,3,1,0,8,2,6,7,1,10
13820,10956,10969,1,4,4,3,1,0,5,1,4,7,1,10
13821,11369,11382,27,18,11,1,2,8,6,17,-11,4,18,5
13822,11369,11382,49,5,11,5,5,1,16,7,9,15,7,20
13823,11369,11382,37,10,11,4,3,4,18,13,5,11,11,15
13824,11369,11382,52,16,11,2,2,7,10,21,-11,6,16,8
13825,11369,11382,1,2,11,7,2,2,29,12,17,16,6,23
13826,11369,11382,12,12,11,2,5,4,15,15,0,9,13,11
13827,11369,11382,17,6,11,5,3,3,17,16,1,13,9,18
13828,11369,11382,43,1,11,8,2,1,22,6,16,18,4,26
13829,11369,11382,24,3,11,7,2,2,20,10,10,16,6,23
13830,11369,11382,57,9,11,4,4,3,20,23,-3,12,10,16
13831,11369,11382,22,15,11,3,1,7,9,15,-6,7,15,10
13832,11369,11382,34,17,11,1,3,7,4,19,-15,5,17,6
13833,11369,11382,20,7,11,5,1,5,16,15,1,11,11,16
13834,11369,11382,35,11,11,3,4,4,11,16,-5,10,12,13
13835,11369,11382,41,13,11,2,5,4,9,13,-4,9,13,11
13836,11369,11382,56,14,11,2,5,4,11,21,-10,9,13,11
13837,11369,11382,21,4,11,7,1,3,15,10,5,15,7,22
13838,11369,11382,4,8,11,4,4,3,18,17,1,12,10,16
13839,11327,11333,43,1,5,3,2,0,10,3,7,8,2,11
13840,11859,11865,21,6,23,11,3,9,41,37,4,25,21,36
13841,11859,11865,4,7,23,10,6,7,35,27,8,26,20,36
13842,11859,11865,12,17,23,3,5,15,21,44,-23,11,35,14
13843,11859,11865,27,10,23,9,6,8,36,33,3,24,22,33
13844,11859,11865,43,1,23,18,4,1,54,18,36,40,6,58
13845,11859,11865,24,5,23,11,3,9,34,26,8,25,21,36
13846,11859,11865,22,13,23,6,9,8,25,23,2,21,25,27
13847,11859,11865,57,15,23,6,7,10,46,53,-7,19,27,25
13848,11859,11865,52,9,23,8,10,5,33,26,7,26,20,34
13849,11859,11865,20,3,23,12,5,6,60,32,28,29,17,41
13850,11859,11865,41,12,23,7,6,10,31,49,-18,20,26,27
13851,11859,11865,35,14,23,7,4,12,37,45,-8,18,28,25
13852,11859,11865,6,18,23,3,3,17,23,56,-33,9,37,12
13853,11859,11865,17,8,23,10,5,8,36,31,5,25,21,35
13854,11866,11872,17,9,24,10,5,9,36,33,3,25,23,35
13855,11866,11872,20,3,24,12,6,6,61,33,28,30,18,42
13856,11866,11872,41,12,24,8,6,10,33,49,-16,22,26,30
13857,11866,11872,35,14,24,7,5,12,39,47,-8,19,29,26
13858,11866,11872,6,18,24,3,4,17,26,59,-33,10,38,13
13859,11866,11872,52,7,24,9,10,5,34,26,8,28,20,37
13860,11866,11872,43,1,24,19,4,1,57,19,38,42,6,61
13861,11866,11872,24,5,24,11,4,9,36,28,8,26,22,37
13862,11866,11872,22,13,24,6,10,8,26,24,2,22,26,28
13863,11866,11872,57,15,24,6,7,11,47,56,-9,19,29,25
13864,11866,11872,27,11,24,9,7,8,37,34,3,25,23,34
13865,11866,11872,12,17,24,3,6,15,21,44,-23,12,36,15
13866,11866,11872,21,6,24,11,4,9,42,38,4,26,22,37
13867,11866,11872,4,8,24,10,6,8,35,30,5,26,22,36
13868,11866,11872,49,2,24,14,6,4,47,28,19,34,14,48
13869,11866,11872,37,10,24,10,5,9,31,31,0,25,23,35
13870,11866,11872,14,16,24,5,3,16,33,74,-41,13,35,18
13871,11866,11872,1,4,24,11,6,7,35,23,12,28,20,39
13872,12097,12103,49,9,11,4,2,5,10,7,3,10,12,14
13873,12097,12103,37,12,11,2,6,3,11,14,-3,10,12,12
13874,12097,12103,43,1,11,9,1,1,34,15,19,19,3,28
13875,12097,12103,24,8,11,3,6,2,14,10,4,12,10,15
13876,12097,12103,57,14,11,2,4,5,17,23,-6,8,14,10
13877,12097,12103,22,18,11,0,3,8,13,29,-16,3,19,3
13878,12097,12103,52,17,11,2,2,7,11,21,-10,6,16,8
13879,12097,12103,6,4,11,6,2,3,18,15,3,14,8,20
13880,12097,12103,13,5,11,5,3,3,19,9,10,13,9,18
13881,12097,12103,35,10,11,3,4,4,14,17,-3,10,12,13
13882,12097,12103,41,13,11,2,6,3,10,16,-6,10,12,12
13883,12097,12103,20,15,11,2,3,6,13,23,-10,7,15,9
13884,12097,12103,27,7,11,5,2,4,15,12,3,12,10,17
13885,12097,12103,17,16,11,1,6,4,9,15,-6,8,14,9
13886,12097,12103,1,2,11,6,4,1,20,10,10,16,6,22
13887,12097,12103,21,3,11,6,3,2,15,11,4,15,7,21
13888,12097,12103,9,6,11,4,6,1,16,11,5,14,8,18
13889,12097,12103,4,11,11,2,7,2,15,16,-1,11,11,13
13890,12146,12152,21,6,16,6,7,3,20,17,3,19,13,25
13891,12146,12152,9,10,16,4,9,3,21,19,2,17,15,21
13892,12146,12152,4,12,16,4,8,4,21,23,-2,16,16,20
13893,12146,12152,1,2,16,9,6,1,27,12,15,24,8,33
13894,12146,12152,17,17,16,1,8,7,14,24,-10,10,22,11
13895,12146,12152,27,3,16,9,2,5,30,22,8,20,12,29
13896,12146,12152,13,4,16,8,5,3,25,12,13,21,11,29
13897,12146,12152,6,5,16,7,5,4,26,20,6,19,13,26
13898,12146,12152,35,8,16,5,6,5,21,21,0,16,16,21
13899,12146,12152,41,14,16,2,8,6,16,29,-13,12,20,14
13900,12146,12152,20,16,16,3,3,10,15,31,-16,9,23,12
13901,12146,12152,52,13,16,4,3,9,17,26,-9,11,21,15
13902,12146,12152,43,1,16,13,2,1,44,18,26,28,4,41
13903,12146,12152,24,9,16,4,9,3,20,15,5,17,15,21
13904,12146,12152,57,15,16,3,4,9,23,39,-16,10,22,13
13905,12146,12152,22,18,16,1,5,10,21,39,-18,7,25,8
13906,12146,12152,49,7,16,6,4,6,17,11,6,16,16,22
13907,12146,12152,37,11,16,4,8,4,17,17,0,16,16,20
13908,12153,12159,49,7,17,7,4,6,19,11,8,18,16,25
13909,12153,12159,37,11,17,4,8,5,17,18,-1,16,18,20
13910,12153,12159,43,1,17,13,3,1,45,19,26,29,5,42
13911,12153,12159,24,9,17,5,9,3,21,15,6,19,15,24
13912,12153,12159,57,14,17,3,5,9,24,40,-16,11,23,14
13913,12153,12159,22,18,17,1,5,11,22,42,-20,7,27,8
13914,12153,12159,52,13,17,4,4,9,17,26,-9,12,22,16
13915,12153,12159,13,4,17,8,6,3,27,14,13,22,12,30
13916,12153,12159,6,6,17,7,5,5,26,24,2,19,15,26
13917,12153,12159,35,8,17,6,6,5,24,22,2,18,16,24
13918,12153,12159,41,16,17,2,8,7,16,31,-15,12,22,14
13919,10683,10689,41,14,15,4,4,7,12,14,-2,12,18,16
13920,10683,10689,20,15,15,3,3,9,17,31,-14,9,21,12
13921,10683,10689,21,4,15,7,6,2,31,15,16,20,10,27
13922,10683,10689,4,6,15,6,4,5,19,17,2,16,14,22
13923,10683,10689,49,8,15,5,6,4,18,16,2,16,14,21
13924,10683,10689,37,13,15,5,3,7,16,24,-8,13,17,18
13925,10683,10689,43,1,15,9,4,2,32,7,25,22,8,31
13926,10683,10689,24,3,15,8,7,0,28,4,24,23,7,31
13927,10683,10689,57,5,15,7,4,4,21,16,5,18,12,25
13928,10795,10801,43,1,27,20,4,3,65,10,55,44,10,64
13929,10795,10801,24,3,27,15,11,1,53,9,44,41,13,56
13930,10795,10801,57,7,27,10,7,10,40,36,4,27,27,37
13931,10795,10801,49,5,27,12,8,7,41,25,16,32,22,44
13932,10795,10801,37,16,27,5,6,16,20,49,-29,16,38,21
13933,10795,10801,28,15,27,6,9,12,19,37,-18,21,33,27
13934,10795,10801,54,18,27,4,7,16,21,49,-28,15,39,19
13935,10795,10801,21,4,27,13,10,4,54,25,29,36,18,49
13936,10795,10801,4,6,27,10,11,6,37,29,8,31,23,41
13937,10795,10801,35,11,27,9,4,14,33,43,-10,22,32,31
13938,10795,10801,56,12,27,8,7,12,29,40,-11,23,31,31
13939,10795,10801,41,14,27,6,10,11,23,32,-9,22,32,28
13940,10795,10801,20,17,27,4,8,15,25,55,-30,16,38,20
13941,10795,10801,12,8,27,9,7,11,27,48,-21,25,29,34
13942,10795,10801,53,13,27,8,7,12,26,42,-16,23,31,31
13943,10795,10801,27,9,27,8,9,10,36,38,-2,25,29,33
13944,10795,10801,17,10,27,9,5,13,32,52,-20,23,31,32
13945,10795,10801,1,2,27,19,6,2,57,19,38,44,10,63
13946,10837,10843,1,1,33,25,6,2,76,19,57,56,10,81
13947,10837,10843,53,9,33,11,9,13,34,47,-13,31,35,42
13948,10837,10843,12,13,33,9,9,15,33,65,-32,27,39,36
13949,10837,10843,27,12,33,9,9,15,41,53,-12,27,39,36
13950,10837,10843,43,2,33,23,5,5,72,19,53,51,15,74
13951,10837,10843,24,3,33,18,12,3,62,14,48,48,18,66
13952,10837,10843,57,7,33,12,7,14,46,46,0,31,35,43
13953,10837,10843,56,8,33,12,7,14,38,46,-8,31,35,43
13954,10837,10843,35,11,33,10,7,16,38,50,-12,27,39,37
13955,10837,10843,41,14,33,8,12,13,33,41,-8,28,38,36
13956,10837,10843,20,15,33,8,8,17,34,63,-29,24,42,32
13957,10837,10843,21,4,33,15,12,6,63,32,31,42,24,57
13958,10837,10843,4,6,33,12,12,9,46,37,9,36,30,48
13959,10837,10843,28,16,33,7,11,15,23,45,-22,25,41,32
13960,10837,10843,54,18,33,5,10,18,29,61,-32,20,46,25
13961,10837,10843,49,5,33,15,10,8,52,33,19,40,26,55
13962,10837,10843,37,17,33,7,8,18,30,57,-27,22,44,29
13963,10837,10843,17,10,33,11,6,16,42,64,-22,28,38,39
13964,11005,11018,4,2,10,6,4,0,20,9,11,16,4,22
13965,11005,11018,21,6,10,4,3,3,17,13,4,11,9,15
13966,11005,11018,35,9,10,3,4,3,17,16,1,10,10,13
13967,11005,11018,41,10,10,3,3,4,13,13,0,9,11,12
13968,11005,11018,56,13,10,3,1,6,13,22,-9,7,13,10
13969,11005,11018,20,14,10,2,3,5,11,16,-5,7,13,9
13970,11005,11018,43,4,10,6,2,2,27,8,19,14,6,20
13971,11005,11018,24,5,10,5,3,2,19,11,8,13,7,18
13972,11005,11018,57,12,10,3,2,5,13,17,-4,8,12,11
13973,11005,11018,22,18,10,2,2,6,7,24,-17,6,14,8
13974,11005,11018,12,7,10,4,2,4,14,12,2,10,10,14
13975,11005,11018,53,16,10,2,3,5,14,25,-11,7,13,9
13976,11005,11018,27,8,10,3,4,3,13,11,2,10,10,13
13977,11005,11018,17,17,10,2,2,6,6,15,-9,6,14,8
13978,11005,11018,52,11,10,3,2,5,12,15,-3,8,12,11
13979,11005,11018,28,15,10,2,3,5,8,16,-8,7,13,9
13980,11005,11018,49,1,10,6,4,0,21,8,13,16,4,22
13981,11005,11018,1,3,10,6,3,1,15,9,6,15,5,21
13982,11019,11025,1,3,11,7,3,1,17,10,7,17,5,24
13983,11019,11025,49,1,11,7,4,0,22,8,14,18,4,25
13984,11019,11025,52,11,11,3,3,5,14,17,-3,9,13,12
13985,11019,11025,28,15,11,2,4,5,10,18,-8,8,14,10
13986,11019,11025,17,16,11,2,3,6,6,15,-9,7,15,9
13987,11019,11025,27,8,11,3,5,3,14,12,2,11,11,14
13988,11019,11025,12,6,11,5,2,4,16,12,4,12,10,17
13989,11019,11025,53,17,11,2,3,6,16,28,-12,7,15,9
13990,11019,11025,43,4,11,6,3,2,28,9,19,15,7,21
13991,11019,11025,24,5,11,5,4,2,21,13,8,14,8,19
13992,11019,11025,57,13,11,3,2,6,13,19,-6,8,14,11
13993,11019,11025,22,18,11,2,3,6,7,24,-17,7,15,9
13994,11019,11025,35,9,11,3,4,4,18,18,0,10,12,13
13995,11019,11025,41,10,11,3,3,5,13,14,-1,9,13,12
13996,11019,11025,20,12,11,3,3,5,12,16,-4,9,13,12
13997,3781,3787,53,5,16,6,5,5,19,20,-1,17,15,23
13998,3781,3787,1,3,16,10,4,2,34,17,17,24,8,34
13999,3781,3787,17,4,16,9,0,7,27,19,8,18,14,27
14000,3809,3822,1,2,19,13,4,2,46,18,28,30,8,43
14001,3809,3822,21,5,19,7,5,7,22,23,-1,19,19,26
14002,3809,3822,4,15,19,3,4,12,15,33,-18,10,28,13
14003,3809,3822,53,10,19,6,7,6,20,23,-3,19,19,25
14004,3809,3822,28,6,19,7,5,7,24,27,-3,19,19,26
14005,3809,3822,52,9,19,6,7,6,21,24,-3,19,19,25
14006,3809,3822,36,14,19,2,8,9,14,28,-14,12,26,14
14007,3809,3822,20,7,19,6,8,5,23,15,8,20,18,26
14008,3809,3822,41,13,19,4,7,8,11,23,-12,15,23,19
14009,3809,3822,49,1,19,14,4,1,43,12,31,32,6,46
14010,3809,3822,37,8,19,6,7,6,16,18,-2,19,19,25
14011,3809,3822,17,4,19,11,0,8,30,21,9,22,16,33
14012,3809,3822,43,3,19,12,3,4,33,15,18,27,11,39
14013,3809,3822,26,11,19,6,5,8,20,24,-4,17,21,23
14014,3809,3822,39,12,19,5,4,10,20,32,-12,14,24,19
14015,3809,3822,27,16,19,3,4,12,19,41,-22,10,28,13
14016,3830,3836,39,12,21,5,6,10,23,35,-12,16,26,21
14017,3830,3836,27,16,21,4,4,13,25,43,-18,12,30,16
14018,3830,3836,43,3,21,12,4,5,36,20,16,28,14,40
14019,3830,3836,26,10,21,7,5,9,23,28,-5,19,23,26
14020,3830,3836,17,4,21,12,0,9,32,22,10,24,18,36
14021,3830,3836,49,1,21,16,4,1,48,13,35,36,6,52
14022,3830,3836,37,7,21,7,7,7,18,19,-1,21,21,28
14023,3830,3836,20,9,21,6,9,6,25,19,6,21,21,27
14024,3830,3836,41,13,21,4,8,9,14,28,-14,16,26,20
14025,3830,3836,28,5,21,8,5,8,25,28,-3,21,21,29
14026,3830,3836,52,6,21,7,8,6,22,24,-2,22,20,29
14027,3830,3836,36,15,21,3,8,10,15,30,-15,14,28,17
14028,3830,3836,53,11,21,6,7,8,20,26,-6,19,23,25
14029,3830,3836,21,8,21,7,6,8,23,30,-7,20,22,27
14030,3830,3836,4,14,21,4,5,12,16,33,-17,13,29,17
14031,3830,3836,1,2,21,15,4,2,53,20,33,34,8,49
14032,4124,4144,1,1,14,10,4,0,35,10,25,24,4,34
14033,4124,4144,21,8,14,5,3,6,19,17,2,13,15,18
14034,4124,4144,53,16,14,2,3,9,10,24,-14,7,21,9
14035,4124,4144,52,5,14,7,3,4,18,11,7,17,11,24
14036,4124,4144,36,9,14,5,3,6,15,25,-10,13,15,18
14037,4124,4144,28,11,14,4,4,6,12,15,-3,12,16,16
14038,4124,4144,49,2,14,9,4,1,28,8,20,22,6,31
14039,4124,4144,37,15,14,3,2,9,13,27,-14,8,20,11
14040,4124,4144,17,13,14,3,4,7,15,24,-9,10,18,13
14041,4124,4144,41,10,14,5,2,7,14,25,-11,12,16,17
14042,4124,4144,20,12,14,3,4,7,17,19,-2,10,18,13
14043,4124,4144,57,3,14,8,3,3,16,11,5,19,9,27
14044,4124,4144,43,4,14,7,4,3,31,16,15,18,10,25
14045,4124,4144,24,7,14,5,5,4,14,9,5,15,13,20
14046,4124,4144,26,14,14,2,6,6,7,16,-9,10,18,12
14047,4124,4144,39,6,14,6,2,6,13,20,-7,14,14,20
14048,4215,4221,39,13,25,7,7,11,19,38,-19,21,29,28
14049,4215,4221,43,2,25,15,6,4,54,22,32,36,14,51
14050,4215,4221,57,5,25,11,6,8,25,20,5,28,22,39
14051,4215,4221,24,6,25,9,9,7,28,19,9,27,23,36
14052,4215,4221,26,15,25,4,11,10,14,30,-16,19,31,23
14053,4215,4221,41,9,25,9,3,13,32,42,-10,21,29,30
14054,4215,4221,20,14,25,6,6,13,26,38,-12,18,32,24
14055,4215,4221,49,3,25,14,9,2,43,14,29,37,13,51
14056,4215,4221,37,16,25,4,5,16,17,43,-26,13,37,17
14057,4215,4221,52,4,25,11,7,7,32,22,10,29,21,40
14058,4215,4221,28,8,25,8,7,10,25,32,-7,23,27,31
14059,4215,4221,36,10,25,7,9,9,24,37,-13,23,27,30
14060,4215,4221,53,11,25,8,5,12,23,31,-8,21,29,29
14061,4215,4221,21,12,25,7,8,10,29,27,2,22,28,29
14062,4215,4221,1,1,25,16,6,3,49,19,30,38,12,54
14063,4215,4221,17,7,25,9,6,10,32,38,-6,24,26,33
14064,4593,4599,17,8,26,10,8,8,39,36,3,28,24,38
14065,4593,4599,8,11,26,8,7,11,26,35,-9,23,29,31
14066,4593,4599,1,1,26,16,8,2,45,19,26,40,12,56
14067,4593,4599,21,6,26,12,4,10,39,30,9,28,24,40
14068,4593,4599,53,2,26,13,6,7,34,25,9,32,20,45
14069,4593,4599,52,4,26,10,13,3,40,14,26,33,19,43
14070,4593,4599,48,9,26,9,8,9,22,24,-2,26,26,35
14071,4593,4599,28,13,26,5,11,10,22,32,-10,21,31,26
14072,4593,4599,36,15,26,4,5,17,23,50,-27,13,39,17
14073,4593,4599,49,3,26,11,12,3,35,20,15,34,18,45
14074,4593,4599,43,5,26,11,9,6,41,24,17,31,21,42
14075,12153,12159,20,17,17,3,3,11,15,32,-17,9,25,12
14076,12153,12159,27,3,17,9,3,5,32,24,8,21,13,30
14077,12153,12159,17,15,17,2,8,7,15,24,-9,12,22,14
14078,12153,12159,1,2,17,9,7,1,27,12,15,25,9,34
14079,12153,12159,21,5,17,7,7,3,24,17,7,21,13,28
14080,12153,12159,9,10,17,5,9,3,23,20,3,19,15,24
14081,12153,12159,4,12,17,4,8,5,22,25,-3,16,18,20
14082,12034,12040,1,6,2,1,1,0,3,2,1,3,1,4
14083,12034,12040,17,16,2,0,0,2,0,3,-3,0,4,0
14084,12034,12040,6,4,2,1,1,0,4,1,3,3,1,4
14085,12034,12040,41,7,2,1,1,0,2,1,1,3,1,4
14086,12034,12040,35,8,2,1,0,1,5,4,1,2,2,3
14087,12034,12040,13,10,2,1,0,1,2,1,1,2,2,3
14088,12034,12040,20,18,2,0,0,2,2,7,-5,0,4,0
14089,12034,12040,52,17,2,0,0,2,3,8,-5,0,4,0
14090,12034,12040,43,1,2,2,0,0,6,2,4,4,0,6
14091,12034,12040,24,9,2,1,0,1,4,3,1,2,2,3
14092,12034,12040,57,14,2,0,1,1,0,2,-2,1,3,1
14093,12034,12040,22,15,2,0,0,2,1,4,-3,0,4,0
14094,12034,12040,49,3,2,2,0,0,3,0,3,4,0,6
14095,12034,12040,37,11,2,0,2,0,2,2,0,2,2,2
14096,12034,12040,27,2,2,2,0,0,6,3,3,4,0,6
14097,12034,12040,4,5,2,1,1,0,3,1,2,3,1,4
14098,12034,12040,9,12,2,0,2,0,1,1,0,2,2,2
14099,12034,12040,21,13,2,0,1,1,1,3,-2,1,3,1
14100,12202,12208,21,5,22,10,8,4,32,24,8,28,16,38
14101,12202,12208,9,9,22,6,11,5,31,30,1,23,21,29
14102,12202,12208,4,11,22,5,10,7,31,35,-4,20,24,25
14103,12202,12208,43,1,22,16,4,2,55,23,32,36,8,52
14104,12202,12208,24,7,22,6,12,4,27,21,6,24,20,30
14105,12202,12208,57,14,22,5,7,10,33,46,-13,17,27,22
14106,12202,12208,22,18,22,1,6,15,23,54,-31,8,36,9
14107,12202,12208,52,15,22,5,6,11,22,33,-11,16,28,21
14108,12202,12208,17,16,22,3,11,8,20,29,-9,17,27,20
14109,12202,12208,27,3,22,13,3,6,45,30,15,29,15,42
14110,12202,12208,1,2,22,13,8,1,34,15,19,34,10,47
14111,12202,12208,49,6,22,9,6,7,27,16,11,24,20,33
14112,12202,12208,37,12,22,5,9,8,25,28,-3,19,25,24
14113,12202,12208,13,4,22,11,8,3,36,17,19,30,14,41
14114,12202,12208,6,8,22,7,8,7,28,28,0,22,22,29
14115,12202,12208,35,10,22,7,6,9,29,31,-2,20,24,27
14116,12202,12208,41,13,22,5,8,9,25,39,-14,18,26,23
14117,12202,12208,20,17,22,3,5,14,20,44,-24,11,33,14
14118,12251,12257,49,6,27,10,9,8,30,18,12,29,25,39
14119,12251,12257,37,12,27,7,9,11,32,35,-3,23,31,30
14120,12251,12257,1,2,27,15,11,1,39,15,24,41,13,56
14121,12251,12257,17,14,27,6,11,10,25,33,-8,23,31,29
14122,12251,12257,27,3,27,15,4,8,48,35,13,34,20,49
14123,12251,12257,52,15,27,7,7,13,26,36,-10,21,33,28
14124,12251,12257,13,4,27,13,10,4,44,22,22,36,18,49
14125,12251,12257,6,7,27,9,9,9,35,34,1,27,27,36
14126,12251,12257,35,11,27,8,8,11,38,41,-3,24,30,32
14127,12251,12257,41,13,27,7,9,11,31,44,-13,23,31,30
14128,12251,12257,20,17,27,4,6,17,25,51,-26,14,40,18
14129,12251,12257,43,1,27,18,6,3,63,28,35,42,12,60
14130,12251,12257,24,9,27,7,13,7,29,31,-2,27,27,34
14131,12251,12257,57,10,27,8,9,10,42,49,-7,25,29,33
14132,12251,12257,22,18,27,3,7,17,31,66,-35,13,41,16
14133,12251,12257,21,5,27,12,10,5,39,30,9,34,20,46
14134,12251,12257,9,8,27,7,14,6,35,33,2,28,26,35
14135,12251,12257,4,16,27,6,10,11,37,48,-11,22,32,28
14136,12517,12523,21,7,15,6,3,6,28,24,4,15,15,21
14137,12517,12523,4,12,15,5,3,7,22,27,-5,13,17,18
14138,12517,12523,9,17,15,3,2,10,16,38,-22,8,22,11
14139,12517,12523,27,16,15,3,6,6,10,20,-10,12,18,15
14140,12517,12523,49,2,15,9,4,2,26,13,13,22,8,31
14141,12517,12523,37,10,15,5,4,6,19,25,-6,14,16,19
14142,12517,12523,52,14,15,3,7,5,14,19,-5,13,17,16
14143,12517,12523,28,15,15,3,6,6,14,23,-9,12,18,15
14144,12517,12523,13,5,15,6,6,3,25,17,8,18,12,24
14145,12517,12523,35,9,15,5,5,5,27,19,8,15,15,20
14146,12517,12523,6,11,15,5,3,7,16,19,-3,13,17,18
14147,12517,12523,41,18,15,1,6,8,16,30,-14,8,22,9
14148,12517,12523,43,1,15,10,3,2,34,16,18,23,7,33
14149,12517,12523,34,6,15,6,4,5,31,29,2,16,14,22
14150,12517,12523,24,8,15,6,3,6,18,19,-1,15,15,21
14151,12517,12523,57,13,15,4,4,7,13,21,-8,12,18,16
14152,12517,12523,17,4,15,9,2,4,31,19,12,20,10,29
14153,12517,12523,1,3,15,9,3,3,34,16,18,21,9,30
14154,12552,12558,1,2,18,11,4,3,40,18,22,26,10,37
14155,11327,11333,22,3,5,3,1,1,8,2,6,7,3,10
14156,11327,11333,24,5,5,3,1,1,8,6,2,7,3,10
14157,11327,11333,57,10,5,1,3,1,9,9,0,5,5,6
14158,11327,11333,34,15,5,1,1,3,2,8,-6,3,7,4
14159,11327,11333,52,8,5,2,0,3,3,8,-5,4,6,6
14160,11327,11333,49,11,5,1,3,1,4,4,0,5,5,6
14161,11327,11333,37,12,5,1,2,2,6,5,1,4,6,5
14162,11327,11333,21,4,5,3,1,1,7,4,3,7,3,10
14163,11327,11333,4,7,5,2,2,1,8,8,0,6,4,8
14164,11327,11333,20,6,5,3,0,2,8,7,1,6,4,9
14165,11327,11333,56,13,5,1,2,2,5,11,-6,4,6,5
14166,11327,11333,41,16,5,0,4,1,2,4,-2,4,6,4
14167,11327,11333,35,18,5,0,2,3,4,9,-5,2,8,2
14168,11327,11333,17,17,5,0,3,2,2,4,-2,3,7,3
14169,11327,11333,27,14,5,1,1,3,4,7,-3,3,7,4
14170,11327,11333,12,9,5,1,3,1,6,5,1,5,5,6
14171,11327,11333,1,2,5,3,1,1,15,7,8,7,3,10
14172,11341,11347,1,3,7,4,1,2,19,10,9,9,5,13
14173,11341,11347,12,10,7,2,3,2,10,8,2,7,7,9
14174,11341,11347,27,17,7,1,1,5,5,12,-7,3,11,4
14175,11341,11347,17,11,7,2,3,2,7,7,0,7,7,9
14176,11341,11347,20,9,7,3,0,4,9,12,-3,6,8,9
14177,11341,11347,41,14,7,1,4,2,4,5,-1,6,8,7
14178,11341,11347,35,15,7,1,3,3,6,10,-4,5,9,6
14179,11341,11347,56,16,7,1,3,3,7,15,-8,5,9,6
14180,11341,11347,21,4,7,4,1,2,9,6,3,9,5,13
14181,11341,11347,4,6,7,3,2,2,12,11,1,8,6,11
14182,11341,11347,49,8,7,2,4,1,7,6,1,8,6,10
14183,11341,11347,37,12,7,2,2,3,10,8,2,6,8,8
14184,11341,11347,52,13,7,2,1,4,6,12,-6,5,9,7
14185,11341,11347,43,1,7,5,2,0,13,4,9,12,2,17
14186,11341,11347,24,2,7,5,1,1,11,7,4,11,3,16
14187,11341,11347,57,5,7,3,3,1,15,11,4,9,5,12
14188,11341,11347,22,7,7,3,1,3,9,5,4,7,7,10
14189,11341,11347,34,18,7,1,1,5,2,12,-10,3,11,4
14190,11789,11795,43,1,16,12,3,1,36,12,24,27,5,39
14191,11789,11795,24,3,16,10,0,6,29,21,8,20,12,30
14192,11789,11795,57,12,16,6,3,7,39,38,1,15,17,21
14193,11789,11795,22,14,16,3,6,7,16,17,-1,12,20,15
14194,11789,11795,4,5,16,8,4,4,25,16,9,20,12,28
14195,11789,11795,21,7,16,8,1,7,28,29,-1,17,15,25
14196,11789,11795,52,9,16,5,8,3,26,18,8,18,14,23
14197,11789,11795,27,6,16,8,3,5,30,23,7,19,13,27
14198,11789,11795,12,16,16,3,3,10,17,30,-13,9,23,12
14199,11789,11795,49,2,16,11,2,3,35,19,16,24,8,35
14200,11789,11795,37,11,16,6,4,6,18,22,-4,16,16,22
14201,11789,11795,14,15,16,4,2,10,27,46,-19,10,22,14
14202,11789,11795,20,4,16,8,4,4,44,24,20,20,12,28
14203,11789,11795,41,13,16,5,3,8,23,36,-13,13,19,18
14204,11789,11795,35,17,16,3,2,11,21,40,-19,8,24,11
14205,11789,11795,6,18,16,2,2,12,15,42,-27,6,26,8
14206,11789,11795,17,10,16,6,4,6,23,24,-1,16,16,22
14207,11789,11795,1,8,16,7,4,5,17,12,5,18,14,25
14208,11831,11837,27,7,20,9,4,7,34,29,5,22,18,31
14209,11831,11837,17,10,20,8,5,7,32,30,2,21,19,29
14210,11831,11837,41,14,20,6,5,9,27,44,-17,17,23,23
14211,11831,11837,35,15,20,5,3,12,31,43,-12,13,27,18
14212,11831,11837,6,18,20,2,3,15,19,51,-32,7,33,9
14213,11831,11837,20,4,20,10,5,5,53,27,26,25,15,35
14214,11831,11837,21,5,20,10,2,8,38,35,3,22,18,32
14215,11831,11837,4,6,20,9,5,6,31,22,9,23,17,32
14216,11831,11837,49,2,20,13,3,4,43,26,17,29,11,42
14217,11831,11837,37,11,20,8,5,7,25,26,-1,21,19,29
14218,11831,11837,14,16,20,4,3,13,31,64,-33,11,29,15
14219,11831,11837,12,17,20,3,4,13,19,38,-19,10,30,13
14220,11831,11837,22,12,20,6,7,7,22,18,4,19,21,25
14221,11831,11837,57,13,20,6,5,9,42,47,-5,17,23,23
14222,11831,11837,43,1,20,15,4,1,46,16,30,34,6,49
14223,11831,11837,24,3,20,11,2,7,32,22,10,24,16,35
14224,11831,11837,52,9,20,7,9,4,32,23,9,23,17,30
14225,11831,11837,1,8,20,9,4,7,23,19,4,22,18,31
14226,11880,11886,52,11,26,9,10,7,35,29,6,28,24,37
14227,11880,11886,57,15,26,6,8,12,49,59,-10,20,32,26
14228,11880,11886,49,2,26,15,6,5,50,29,21,36,16,51
14229,11880,11886,37,9,26,11,5,10,35,36,-1,27,25,38
14230,11880,11886,14,16,26,5,5,16,34,75,-41,15,37,20
14231,11880,11886,21,4,26,13,4,9,50,38,12,30,22,43
14232,11880,11886,4,7,26,11,7,8,40,31,9,29,23,40
14233,11880,11886,20,5,26,12,6,8,61,39,22,30,22,42
14234,11880,11886,41,12,26,8,7,11,34,53,-19,23,29,31
14235,11019,11025,56,14,11,3,1,7,13,23,-10,7,15,10
14236,11019,11025,4,2,11,7,4,0,23,11,12,18,4,25
14237,11019,11025,21,7,11,4,4,3,19,15,4,12,10,16
14238,11054,11060,4,1,17,12,4,1,40,18,22,28,6,40
14239,11054,11060,21,6,17,6,8,3,33,22,11,20,14,26
14240,11054,11060,49,5,17,8,7,2,28,18,10,23,11,31
14241,11054,11060,43,2,17,11,4,2,42,11,31,26,8,37
14242,11054,11060,24,4,17,9,5,3,32,18,14,23,11,32
14243,11054,11060,57,9,17,6,4,7,21,25,-4,16,18,22
14244,11054,11060,22,13,17,4,4,9,15,38,-23,12,22,16
14245,11054,11060,35,8,17,6,5,6,26,25,1,17,17,23
14246,11054,11060,41,11,17,4,7,6,20,21,-1,15,19,19
14247,11054,11060,20,12,17,4,5,8,17,28,-11,13,21,17
14248,11054,11060,56,16,17,4,2,11,18,32,-14,10,24,14
14249,11054,11060,12,7,17,7,4,6,22,17,5,18,16,25
14250,11054,11060,53,15,17,4,3,10,22,38,-16,11,23,15
14251,11054,11060,27,10,17,5,7,5,20,18,2,17,17,22
14252,11054,11060,17,14,17,3,7,7,10,20,-10,13,21,16
14253,11054,11060,52,17,17,3,4,10,16,30,-14,10,24,13
14254,11054,11060,28,18,17,2,6,9,13,28,-15,10,24,12
14255,11054,11060,1,3,17,9,6,2,27,15,12,24,10,33
14256,11453,11459,1,3,18,9,7,2,34,15,19,25,11,34
14257,11453,11459,17,8,18,7,5,6,24,26,-2,19,17,26
14258,11453,11459,49,4,18,8,9,1,25,11,14,25,11,33
14259,11453,11459,37,13,18,4,7,7,22,23,-1,15,21,19
14260,11453,11459,20,9,18,7,3,8,26,26,0,17,19,24
14261,11453,11459,41,10,18,4,9,5,19,20,-1,17,19,21
14262,11453,11459,35,11,18,4,9,5,16,22,-6,17,19,21
14263,11453,11459,56,16,18,3,6,9,17,40,-23,12,24,15
14264,11453,11459,12,12,18,4,7,7,25,26,-1,15,21,19
14265,11453,11459,27,17,18,1,8,9,12,25,-13,10,26,11
14266,11453,11459,43,1,18,12,5,1,35,8,27,29,7,41
14267,11453,11459,24,2,18,12,3,3,32,12,20,27,9,39
14268,11453,11459,57,7,18,7,7,4,30,30,0,21,15,28
14269,11453,11459,22,14,18,4,5,9,15,23,-8,13,23,17
14270,11453,11459,34,18,18,2,4,12,7,30,-23,8,28,10
14271,11453,11459,21,5,18,10,1,7,26,19,7,21,15,31
14272,11453,11459,4,6,18,8,4,6,30,28,2,20,16,28
14273,11453,11459,52,15,18,4,5,9,16,27,-11,13,23,17
14274,11320,11326,21,2,4,3,1,0,7,2,5,7,1,10
14275,11320,11326,4,9,4,1,2,1,6,8,-2,4,4,5
14276,11320,11326,49,8,4,1,2,1,4,4,0,4,4,5
14277,11320,11326,37,10,4,1,1,2,6,5,1,3,5,4
14278,11320,11326,43,1,4,3,1,0,9,2,7,7,1,10
14279,11320,11326,22,5,4,2,1,1,5,2,3,5,3,7
14280,11320,11326,24,6,4,2,1,1,5,6,-1,5,3,7
14281,11320,11326,34,13,4,1,0,3,2,8,-6,2,6,3
14282,11320,11326,57,16,4,0,3,1,4,8,-4,3,5,3
14283,11320,11326,20,4,4,3,0,1,7,2,5,6,2,9
14284,11320,11326,56,12,4,1,1,2,5,11,-6,3,5,4
14285,11320,11326,41,15,4,0,3,1,2,4,-2,3,5,3
14286,11320,11326,35,18,4,0,2,2,4,7,-3,2,6,2
14287,11320,11326,27,11,4,1,1,2,4,4,0,3,5,4
14288,11320,11326,17,17,4,0,2,2,2,4,-2,2,6,2
14289,11320,11326,52,7,4,2,0,2,3,5,-2,4,4,6
14290,11320,11326,12,14,4,0,3,1,4,5,-1,3,5,3
14291,11320,11326,1,3,4,3,0,1,14,6,8,6,2,9
14292,11733,11739,1,3,10,7,1,2,15,6,9,15,5,22
14293,11733,11739,49,2,10,8,1,1,22,11,11,17,3,25
14294,11733,11739,37,7,10,5,1,4,11,13,-2,11,9,16
14295,11733,11739,14,11,10,4,0,6,19,24,-5,8,12,12
14296,11733,11739,27,4,10,6,1,3,24,16,8,13,7,19
14297,11733,11739,17,9,10,4,3,3,18,15,3,11,9,15
14298,11733,11739,35,13,10,3,1,6,17,24,-7,7,13,10
14299,11733,11739,41,16,10,2,2,6,15,27,-12,6,14,8
14300,11733,11739,6,18,10,1,1,8,8,28,-20,3,17,4
14301,11733,11739,20,10,10,4,2,4,23,18,5,10,10,14
14302,11733,11739,12,17,10,2,1,7,8,18,-10,5,15,7
14303,11733,11739,4,5,10,5,2,3,16,11,5,12,8,17
14304,11733,11739,21,6,10,5,1,4,18,18,0,11,9,16
14305,11733,11739,43,1,10,8,1,1,26,10,16,17,3,25
14306,11733,11739,24,8,10,5,0,5,15,14,1,10,10,15
14307,11733,11739,22,14,10,2,3,5,9,10,-1,7,13,9
14308,11733,11739,57,15,10,2,3,5,24,26,-2,7,13,9
14309,11733,11739,52,12,10,2,6,2,13,12,1,10,10,12
14310,11740,11753,52,11,11,3,6,2,17,12,5,12,10,15
14311,11740,11753,43,1,11,9,1,1,27,10,17,19,3,28
14312,11740,11753,24,6,11,6,0,5,18,15,3,12,10,18
14313,11740,11753,22,13,11,3,3,5,11,10,1,9,13,12
14314,11740,11753,57,17,11,2,3,6,26,31,-5,7,15,9
14315,4593,4599,24,7,26,9,13,4,32,24,8,31,21,40
14316,4593,4599,57,10,26,8,9,9,30,36,-6,25,27,33
14317,4593,4599,26,16,26,2,6,18,15,50,-35,10,42,12
14318,4593,4599,41,12,26,7,9,10,24,31,-7,23,29,30
14319,4593,4599,39,14,26,4,10,12,16,33,-17,18,34,22
14320,4404,4417,39,15,4,0,2,2,2,4,-2,2,6,2
14321,4404,4417,41,13,4,1,1,2,4,5,-1,3,5,4
14322,4404,4417,49,2,4,3,0,1,4,1,3,6,2,9
14323,4404,4417,43,3,4,2,1,1,4,3,1,5,3,7
14324,4404,4417,24,8,4,1,2,1,4,4,0,4,4,5
14325,4404,4417,57,9,4,1,2,1,3,3,0,4,4,5
14326,4404,4417,26,9,4,1,2,1,3,3,0,4,4,5
14327,4404,4417,17,3,4,2,1,1,4,3,1,5,3,7
14328,4404,4417,8,12,4,1,2,1,3,4,-1,4,4,5
14329,4404,4417,53,5,4,2,0,2,6,5,1,4,4,6
14330,4404,4417,48,7,4,1,3,0,3,2,1,5,3,6
14331,4404,4417,52,11,4,1,2,1,2,2,0,4,4,5
14332,4404,4417,28,14,4,1,1,2,2,3,-1,3,5,4
14333,4404,4417,36,16,4,0,0,4,3,9,-6,0,8,0
14334,4404,4417,21,6,4,2,0,2,3,3,0,4,4,6
14335,4404,4417,1,1,4,3,1,0,7,3,4,7,1,10
14336,4859,4872,1,4,14,6,4,4,26,14,12,16,12,22
14337,4859,4872,21,8,14,5,4,5,16,17,-1,14,14,19
14338,4859,4872,28,16,14,1,7,6,10,20,-10,9,19,10
14339,4859,4872,53,14,14,2,6,6,14,24,-10,10,18,12
14340,4859,4872,17,11,14,3,6,5,18,23,-5,12,16,15
14341,4859,4872,8,13,14,3,3,8,12,30,-18,9,19,12
14342,4859,4872,49,5,14,6,4,4,19,17,2,16,12,22
14343,4859,4872,37,6,14,5,7,2,16,10,6,17,11,22
14344,4859,4872,52,2,14,7,6,1,22,7,15,20,8,27
14345,4859,4872,48,12,14,3,4,7,16,27,-11,10,18,13
14346,4859,4872,36,15,14,2,5,7,18,25,-7,9,19,11
14347,4859,4872,43,1,14,9,3,2,33,13,20,21,7,30
14348,4859,4872,24,7,14,5,7,2,16,11,5,17,11,22
14349,4859,4872,57,9,14,5,3,6,24,24,0,13,15,18
14350,4859,4872,20,3,14,6,6,2,22,21,1,18,10,24
14351,4859,4872,41,10,14,4,5,5,20,19,1,13,15,17
14352,4873,4879,20,3,15,7,6,2,23,21,2,20,10,27
14353,4873,4879,41,10,15,4,5,6,21,22,-1,13,17,17
14354,4873,4879,43,1,15,9,4,2,34,14,20,22,8,31
14355,4873,4879,24,8,15,5,7,3,16,12,4,17,13,22
14356,4873,4879,57,9,15,5,3,7,25,27,-2,13,17,18
14357,4873,4879,37,4,15,5,8,2,17,11,6,18,12,23
14358,4873,4879,49,7,15,6,4,5,19,19,0,16,14,22
14359,4873,4879,17,12,15,3,7,5,19,24,-5,13,17,16
14360,4873,4879,8,13,15,4,3,8,14,31,-17,11,19,15
14361,4873,4879,53,14,15,3,6,6,17,25,-8,12,18,15
14362,4873,4879,52,2,15,7,7,1,23,8,15,21,9,28
14363,4873,4879,48,11,15,4,4,7,19,28,-9,12,18,16
14364,4873,4879,36,15,15,3,5,7,20,25,-5,11,19,14
14365,4873,4879,28,16,15,1,7,7,11,22,-11,9,21,10
14366,4873,4879,21,6,15,6,4,5,20,17,3,16,14,22
14367,4873,4879,1,5,15,6,4,5,26,18,8,16,14,22
14368,4894,4900,1,9,18,6,5,7,31,26,5,17,19,23
14369,4894,4900,21,2,18,9,4,5,30,21,9,22,14,31
14370,4894,4900,17,13,18,4,8,6,24,29,-5,16,20,20
14371,4894,4900,8,14,18,4,5,9,14,33,-19,13,23,17
14372,4894,4900,52,3,18,8,7,3,29,15,14,23,13,31
14373,4894,4900,48,12,18,5,6,7,23,30,-7,16,20,21
14374,4894,4900,36,15,18,3,6,9,26,34,-8,12,24,15
14375,4894,4900,28,16,18,1,9,8,15,30,-15,11,25,12
14376,4894,4900,53,11,18,5,6,7,24,29,-5,16,20,21
14377,4894,4900,49,6,18,7,5,6,23,23,0,19,17,26
14378,4894,4900,37,8,18,5,9,4,19,17,2,19,17,24
14379,4894,4900,20,4,18,7,7,4,29,32,-3,21,15,28
14380,4894,4900,41,5,18,7,5,6,32,26,6,19,17,26
14381,4894,4900,43,1,18,12,4,2,43,18,25,28,8,40
14382,4894,4900,24,7,18,6,8,4,21,18,3,20,16,26
14383,4894,4900,57,10,18,6,4,8,29,31,-2,16,20,22
14384,4915,4928,43,1,21,13,6,2,48,21,27,32,10,45
14385,4915,4928,24,4,21,9,8,4,26,19,7,26,16,35
14386,4915,4928,57,10,21,6,7,8,31,33,-2,19,23,25
14387,4915,4928,41,5,21,8,7,6,36,29,7,23,19,31
14388,4915,4928,20,7,21,7,8,6,32,39,-7,22,20,29
14389,4915,4928,49,8,21,7,7,7,25,27,-2,21,21,28
14390,4915,4928,37,11,21,5,9,7,19,21,-2,19,23,24
14391,4915,4928,53,14,21,5,6,10,26,36,-10,16,26,21
14392,4915,4928,52,3,21,9,9,3,33,17,16,27,15,36
14393,4915,4928,48,9,21,7,7,7,26,30,-4,21,21,28
14394,4915,4928,36,12,21,5,7,9,32,36,-4,17,25,22
14395,12552,12558,17,4,18,9,4,5,31,24,7,22,14,31
14396,12552,12558,27,13,18,5,7,6,16,22,-6,17,19,22
14397,12552,12558,28,14,18,5,7,6,16,23,-7,17,19,22
14398,12552,12558,35,6,18,6,7,5,32,21,11,19,17,25
14399,12552,12558,13,7,18,6,7,5,28,22,6,19,17,25
14400,12552,12558,6,9,18,6,5,7,22,23,-1,17,19,23
14401,12552,12558,52,12,18,5,7,6,19,23,-4,17,19,22
14402,12552,12558,41,18,18,1,6,11,19,37,-18,8,28,9
14403,12552,12558,57,15,18,5,5,8,23,28,-5,15,21,20
14404,12552,12558,49,3,18,11,4,3,28,15,13,26,10,37
14405,12552,12558,37,10,18,6,5,7,23,27,-4,17,19,23
14406,12552,12558,43,1,18,12,4,2,41,17,24,28,8,40
14407,12552,12558,34,5,18,8,4,6,39,37,2,20,16,28
14408,12552,12558,24,8,18,7,3,8,21,24,-3,17,19,24
14409,12552,12558,21,11,18,6,4,8,28,27,1,16,20,22
14410,12552,12558,4,16,18,5,3,10,23,37,-14,13,23,18
14411,12552,12558,9,17,18,3,4,11,18,42,-24,10,26,13
14412,12440,12446,27,16,6,1,2,3,3,7,-4,4,8,5
14413,12440,12446,49,1,6,4,2,0,12,3,9,10,2,14
14414,12440,12446,37,9,6,3,0,3,8,8,0,6,6,9
14415,12440,12446,21,5,6,3,2,1,13,8,5,8,4,11
14416,12440,12446,4,7,6,3,1,2,9,9,0,7,5,10
14417,12440,12446,9,13,6,2,0,4,7,13,-6,4,8,6
14418,12440,12446,43,2,6,4,1,1,17,10,7,9,3,13
14419,12440,12446,24,8,6,3,0,3,9,9,0,6,6,9
14420,12440,12446,34,11,6,2,1,3,10,15,-5,5,7,7
14421,12440,12446,57,12,6,2,1,3,5,10,-5,5,7,7
14422,12440,12446,13,6,6,3,1,2,12,8,4,7,5,10
14423,12440,12446,35,14,6,1,3,2,11,11,0,5,7,6
14424,12440,12446,6,17,6,1,1,4,7,14,-7,3,9,4
14425,12440,12446,41,18,6,0,3,3,4,13,-9,3,9,3
14426,12440,12446,52,10,6,2,2,2,8,9,-1,6,6,8
14427,12440,12446,28,15,6,1,2,3,6,8,-2,4,8,5
14428,12440,12446,17,3,6,4,0,2,17,12,5,8,4,12
14429,12440,12446,1,4,6,3,2,1,15,6,9,8,4,11
14430,12846,12859,1,1,15,9,4,2,34,13,21,22,8,31
14431,12846,12859,49,7,15,5,7,3,21,15,6,17,13,22
14432,12846,12859,37,13,15,4,4,7,15,19,-4,12,18,16
14433,12846,12859,17,3,15,8,5,2,26,15,11,21,9,29
14434,12846,12859,27,8,15,5,6,4,28,30,-2,16,14,21
14435,12846,12859,52,4,15,7,6,2,18,13,5,20,10,27
14436,12846,12859,28,15,15,4,4,7,18,26,-8,12,18,16
14437,12846,12859,35,11,15,4,6,5,23,18,5,14,16,18
14438,12846,12859,6,16,15,3,3,9,16,27,-11,9,21,12
14439,12846,12859,13,17,15,3,3,9,17,31,-14,9,21,12
14440,12846,12859,20,18,15,3,3,9,14,29,-15,9,21,12
14441,12846,12859,43,2,15,9,3,3,33,16,17,21,9,30
14442,12846,12859,34,6,15,6,5,4,24,20,4,17,13,23
14443,12846,12859,24,9,15,5,5,5,20,25,-5,15,15,20
14444,12846,12859,57,12,15,3,9,3,19,24,-5,15,15,18
14445,12846,12859,21,10,15,5,3,7,22,23,-1,13,17,18
14446,12846,12859,4,14,15,4,4,7,18,24,-6,12,18,16
14447,12846,12859,47,5,15,7,2,6,19,17,2,16,14,23
14448,13035,13118,47,12,34,13,4,17,40,48,-8,30,38,43
14449,13035,13118,35,3,34,15,8,11,53,37,16,38,30,53
14450,13035,13118,6,9,34,14,6,14,40,45,-5,34,34,48
14451,13035,13118,21,13,34,11,9,14,38,46,-8,31,37,42
14452,13035,13118,4,14,34,10,11,13,39,49,-10,31,37,41
14453,13035,13118,27,7,34,13,11,10,59,53,6,37,31,50
14454,13035,13118,37,17,34,6,9,19,38,57,-19,21,47,27
14455,13035,13118,49,6,34,13,12,9,51,46,5,38,30,51
14456,13035,13118,43,2,34,22,5,7,83,37,46,49,19,71
14457,13035,13118,57,8,34,13,10,11,51,47,4,36,32,49
14458,13035,13118,34,10,34,12,10,12,55,50,5,34,34,46
14459,13035,13118,24,11,34,12,8,14,40,46,-6,32,36,44
14460,13035,13118,28,15,34,11,7,16,42,60,-18,29,39,40
14461,13035,13118,13,16,34,8,5,21,35,79,-44,21,47,29
14462,13035,13118,20,18,34,4,9,21,30,70,-40,17,51,21
14463,13035,13118,52,4,34,13,14,7,43,29,14,40,28,53
14464,13035,13118,17,5,34,14,10,10,54,45,9,38,30,52
14465,13035,13118,1,1,34,25,6,3,83,30,53,56,12,81
14466,13189,13195,1,2,10,6,3,1,21,9,12,15,5,21
14467,13189,13195,52,9,10,3,4,3,10,11,-1,10,10,13
14468,13189,13195,28,16,10,2,2,6,16,27,-11,6,14,8
14469,13189,13195,17,6,10,3,6,1,15,9,6,12,8,15
14470,13189,13195,27,8,10,4,1,5,16,14,2,9,11,13
14471,13189,13195,33,3,10,5,4,1,19,9,10,14,6,19
14472,13189,13195,6,10,10,3,4,3,15,18,-3,10,10,13
14473,13189,13195,12,11,10,3,3,4,14,14,0,9,11,12
14474,15352,15358,25,13,5,1,0,4,2,9,-7,2,8,3
14475,15352,15358,33,2,5,3,1,1,15,7,8,7,3,10
14476,15352,15358,28,5,4,3,0,1,13,5,8,6,2,9
14477,15352,15358,35,11,4,1,1,2,7,11,-4,3,5,4
14478,15352,15358,17,8,4,2,1,1,8,2,6,5,3,7
14479,15352,15358,42,10,5,2,1,2,4,6,-2,5,5,7
14480,15352,15358,1,1,5,5,0,0,13,2,11,10,0,15
14481,15814,15841,1,5,17,8,4,5,32,22,10,20,14,28
14482,15814,15841,33,4,17,8,6,3,32,19,13,22,12,30
14483,15814,15841,28,6,17,7,6,4,21,21,0,20,14,27
14484,15814,15841,4,10,17,5,8,4,19,15,4,18,16,23
14485,15814,15841,31,15,17,3,4,10,14,28,-14,10,24,13
14486,15814,15841,21,17,17,3,3,11,12,35,-23,9,25,12
14487,15814,15841,37,7,17,8,0,9,24,27,-3,16,18,24
14488,15814,15841,25,8,17,6,6,5,19,23,-4,18,16,24
14489,15814,15841,12,14,17,3,4,10,18,30,-12,10,24,13
14490,15814,15841,17,13,17,4,7,6,17,20,-3,15,19,19
14491,15814,15841,42,16,17,2,7,8,14,27,-13,11,23,13
14492,15814,15841,27,18,17,2,5,10,9,19,-10,9,25,11
14493,15814,15841,49,2,17,12,2,3,34,13,21,26,8,38
14494,15814,15841,43,1,17,15,1,1,45,14,31,31,3,46
14495,15814,15841,22,3,17,9,4,4,35,21,14,22,12,31
14496,15814,15841,40,11,17,4,8,5,21,22,-1,16,18,20
14497,15814,15841,57,12,17,4,8,5,13,21,-8,16,18,20
14498,15814,15841,35,9,17,6,5,6,16,18,-2,17,17,23
14499,15877,15883,35,7,23,8,8,7,21,24,-3,24,22,32
14500,15877,15883,4,10,23,6,9,8,22,24,-2,21,25,27
14501,15877,15883,31,17,23,4,6,13,22,41,-19,14,32,18
14502,15877,15883,43,1,23,20,2,1,57,18,39,42,4,62
14503,15877,15883,22,5,23,11,6,6,43,30,13,28,18,39
14504,15877,15883,40,11,23,5,11,7,28,32,-4,21,25,26
14505,15877,15883,57,12,23,5,9,9,20,41,-21,19,27,24
14506,15877,15883,27,16,23,4,7,12,21,31,-10,15,31,19
14507,15877,15883,17,13,23,4,11,8,22,30,-8,19,27,23
14508,15877,15883,42,15,23,4,9,10,22,32,-10,17,29,21
14509,15877,15883,25,6,23,10,8,5,30,25,5,28,18,38
14510,15877,15883,12,14,23,5,7,11,26,35,-9,17,29,22
14511,15877,15883,21,18,23,4,4,15,17,46,-29,12,34,16
14512,15877,15883,33,4,23,11,9,3,46,29,17,31,15,42
14513,15877,15883,28,8,23,8,7,8,27,33,-6,23,23,31
14514,15877,15883,1,3,23,13,4,6,48,24,24,30,16,43
14515,15877,15883,49,2,23,13,7,3,48,20,28,33,13,46
14516,15877,15883,37,9,23,9,2,12,33,38,-5,20,26,29
14517,15940,15946,4,12,31,7,14,10,29,32,-3,28,34,35
14518,15940,15946,21,16,31,7,5,19,26,59,-33,19,43,26
14519,15940,15946,31,18,31,6,7,18,32,61,-29,19,43,25
14520,15940,15946,35,7,31,10,11,10,29,34,-5,31,31,41
14521,15940,15946,17,10,31,7,15,9,28,35,-7,29,33,36
14522,15940,15946,42,14,31,7,12,12,29,40,-11,26,36,33
14523,15940,15946,1,2,31,19,6,6,64,31,33,44,18,63
14524,15940,15946,33,4,31,14,13,4,60,38,22,41,21,55
14525,15940,15946,28,11,31,8,11,12,33,45,-12,27,35,35
14526,15940,15946,49,3,31,17,10,4,65,28,37,44,18,61
14527,15940,15946,37,13,31,10,4,17,37,52,-15,24,38,34
14528,15940,15946,25,6,31,13,9,9,48,42,6,35,27,48
14529,15940,15946,12,8,31,10,7,14,42,50,-8,27,35,37
14530,15940,15946,43,1,31,23,5,3,72,25,47,51,11,74
14531,15940,15946,22,5,31,15,8,8,53,36,17,38,24,53
14532,15940,15946,40,9,31,8,13,10,39,42,-3,29,33,37
14533,15940,15946,57,15,31,7,12,12,26,48,-22,26,36,33
14534,15940,15946,27,17,31,6,8,17,32,46,-14,20,42,26
14535,15716,15722,27,15,5,0,2,3,0,4,-4,2,8,2
14536,15716,15722,42,17,5,0,2,3,5,12,-7,2,8,2
14537,15716,15722,17,6,5,2,2,1,5,3,2,6,4,8
14538,15716,15722,37,14,5,1,0,4,7,13,-6,2,8,3
14539,15716,15722,49,4,5,3,1,1,8,4,4,7,3,10
14540,15716,15722,28,7,5,2,2,1,5,4,1,6,4,8
14541,15716,15722,33,10,5,1,3,1,10,8,2,5,5,6
14542,15716,15722,43,1,5,5,0,0,16,2,14,10,0,15
14543,15716,15722,22,3,5,3,1,1,8,3,5,7,3,10
14544,15716,15722,40,9,5,1,4,0,5,3,2,6,4,7
14545,15716,15722,57,13,5,1,2,2,1,6,-5,4,6,5
14546,15716,15722,21,8,5,2,1,2,4,8,-4,5,5,7
14547,15716,15722,1,2,5,3,2,0,11,4,7,8,2,11
14548,15716,15722,35,12,5,1,3,1,3,3,0,5,5,6
14549,15716,15722,25,11,5,1,3,1,6,6,0,5,5,6
14550,15716,15722,12,18,5,0,2,3,2,10,-8,2,8,2
14551,15716,15722,4,5,5,2,2,1,10,8,2,6,4,8
14552,15716,15722,31,16,5,0,2,3,0,5,-5,2,8,2
14553,16045,16051,35,18,1,0,0,1,0,5,-5,0,2,0
14554,5972,5978,17,6,17,8,4,5,23,20,3,20,14,28
14555,5972,5978,8,13,17,5,3,9,23,28,-5,13,21,18
14556,5972,5978,49,9,17,6,7,4,17,13,4,19,15,25
14557,5972,5978,37,14,17,3,8,6,15,22,-7,14,20,17
14558,5972,5978,5,18,17,2,4,11,20,35,-15,8,26,10
14559,5972,5978,57,4,17,8,5,4,36,21,15,21,13,29
14560,5972,5978,43,5,17,8,5,4,37,24,13,21,13,29
14561,5972,5978,22,12,17,5,5,7,20,19,1,15,19,20
14562,5972,5978,24,15,17,3,5,9,14,26,-12,11,23,14
14563,5972,5978,56,7,17,8,4,5,24,22,2,20,14,28
14564,5972,5978,20,11,17,6,2,9,23,27,-4,14,20,20
14565,5972,5978,41,17,17,3,4,10,12,42,-30,10,24,13
14566,5972,5978,53,3,17,9,4,4,35,24,11,22,12,31
14567,5972,5978,12,10,17,5,6,6,20,19,1,16,18,21
14568,5972,5978,52,2,17,10,5,2,27,13,14,25,9,35
14569,5972,5978,21,7,17,8,4,5,24,22,2,20,14,28
14570,5972,5978,1,1,17,11,4,2,36,15,21,26,8,37
14571,5972,5978,27,16,17,3,5,9,11,25,-14,11,23,14
14572,5860,5862,27,9,2,1,0,1,2,2,0,2,2,3
14573,5860,5862,1,1,2,2,0,0,5,2,3,4,0,6
14574,5860,5862,17,11,2,1,0,1,3,6,-3,2,2,3
14575,5860,5862,8,17,2,0,0,2,1,3,-2,0,4,0
14576,5860,5862,52,7,2,1,1,0,1,0,1,3,1,4
14577,5860,5862,49,7,2,1,1,0,1,0,1,3,1,4
14578,5860,5862,37,13,2,0,1,1,2,3,-1,1,3,1
14579,5860,5862,5,16,2,0,0,2,2,4,-2,0,4,0
14580,5860,5862,53,2,2,1,1,0,8,4,4,3,1,4
14581,5860,5862,12,10,2,1,0,1,1,1,0,2,2,3
14582,5860,5862,56,4,2,1,1,0,2,1,1,3,1,4
14583,5860,5862,41,14,2,0,1,1,1,2,-1,1,3,1
14584,5860,5862,20,15,2,0,1,1,2,4,-2,1,3,1
14585,5860,5862,21,3,2,1,1,0,3,2,1,3,1,4
14586,5860,5862,57,4,2,1,1,0,2,1,1,3,1,4
14587,5860,5862,24,4,2,1,1,0,2,1,1,3,1,4
14588,5860,5862,43,12,2,0,2,0,2,2,0,2,2,2
14589,5860,5862,22,18,2,0,0,2,0,2,-2,0,4,0
14590,6091,6097,20,6,32,14,6,12,46,38,8,34,30,48
14591,6091,6097,56,12,32,10,10,12,38,43,-5,30,34,40
14592,6091,6097,41,16,32,8,5,19,32,75,-43,21,43,29
14593,6091,6097,17,7,32,14,5,13,43,42,1,33,31,47
14594,6091,6097,8,14,32,8,9,15,38,53,-15,25,39,33
14595,6091,6097,43,2,32,19,6,7,66,35,31,44,20,63
14596,6091,6097,57,10,32,11,10,11,53,50,3,32,32,43
14597,6091,6097,22,11,32,11,8,13,40,41,-1,30,34,41
14598,6091,6097,24,18,32,6,7,19,36,62,-26,19,45,25
14599,6091,6097,49,4,32,16,9,7,46,26,20,41,23,57
14600,6091,6097,37,13,32,10,9,13,31,40,-9,29,35,39
14601,6091,6097,5,17,32,6,8,18,38,62,-24,20,44,26
14602,6091,6097,21,8,32,12,9,11,39,45,-6,33,31,45
14603,6091,6097,52,3,32,17,8,7,56,34,22,42,22,59
14604,6091,6097,12,5,32,15,6,11,51,37,14,36,28,51
14605,6091,6097,53,9,32,11,11,10,56,49,7,33,31,44
14606,6091,6097,27,15,32,8,9,15,26,41,-15,25,39,33
14607,6091,6097,1,1,32,22,5,5,65,27,38,49,15,71
14608,6570,6573,27,14,1,0,0,1,0,1,-1,0,2,0
14609,6570,6573,1,7,1,0,1,0,1,1,0,1,1,1
14610,6570,6573,21,1,1,1,0,0,3,0,3,2,0,3
14611,6570,6573,48,7,1,0,1,0,1,1,0,1,1,1
14612,6570,6573,52,17,1,0,0,1,0,3,-3,0,2,0
14613,6570,6573,53,13,1,0,0,1,1,2,-1,0,2,0
14614,6570,6573,12,14,1,0,0,1,0,1,-1,0,2,0
14615,6570,6573,8,5,1,1,0,0,1,0,1,2,0,3
14616,6570,6573,19,9,1,0,1,0,0,0,0,1,1,1
14617,6570,6573,17,17,1,0,0,1,0,3,-3,0,2,0
14618,6570,6573,20,5,1,1,0,0,1,0,1,2,0,3
14619,6570,6573,56,9,1,0,1,0,0,0,0,1,1,1
14620,6570,6573,43,4,1,1,0,0,2,1,1,2,0,3
14621,6570,6573,40,9,1,0,1,0,0,0,0,1,1,1
14622,6570,6573,22,16,1,0,0,1,0,2,-2,0,2,0
14623,6570,6573,37,1,1,1,0,0,3,0,3,2,0,3
14624,6570,6573,49,9,1,0,1,0,0,0,0,1,1,1
14625,6570,6573,41,3,1,1,0,0,2,0,2,2,0,3
14626,6801,6804,43,2,28,18,2,8,63,30,33,38,18,56
14627,6801,6804,22,13,28,7,10,11,36,43,-7,24,32,31
14628,6801,6804,40,15,28,7,7,14,40,63,-23,21,35,28
14629,6801,6804,20,14,28,6,13,9,26,34,-8,25,31,31
14630,6801,6804,41,16,28,7,6,15,34,45,-11,20,36,27
14631,6801,6804,56,18,28,4,9,15,20,47,-27,17,39,21
14632,6801,6804,52,3,28,14,6,8,43,32,11,34,22,48
14633,6801,6804,48,17,28,5,12,11,20,35,-15,22,34,27
14634,4915,4928,28,16,21,2,10,9,19,38,-19,14,28,16
14635,4915,4928,17,13,21,4,10,7,25,32,-7,18,24,22
14636,4915,4928,8,15,21,4,6,11,18,39,-21,14,28,18
14637,4915,4928,21,2,21,10,6,5,31,21,10,26,16,36
14638,4915,4928,1,6,21,8,5,8,41,30,11,21,21,29
14639,4957,4963,1,5,26,11,5,10,55,38,17,27,25,38
14640,4957,4963,17,15,26,4,12,10,28,41,-13,20,32,24
14641,4957,4963,8,16,26,5,8,13,22,47,-25,18,34,23
14642,4957,4963,21,2,26,13,8,5,41,26,15,34,18,47
14643,4957,4963,52,3,26,11,11,4,41,21,20,33,19,44
14644,4957,4963,36,10,26,7,9,10,38,43,-5,23,29,30
14645,4957,4963,48,11,26,7,9,10,31,42,-11,23,29,30
14646,4957,4963,28,13,26,6,10,10,26,42,-16,22,30,28
14647,4957,4963,53,14,26,6,9,11,33,44,-11,21,31,27
14648,4957,4963,49,7,26,9,9,8,33,29,4,27,25,36
14649,4957,4963,37,12,26,6,12,8,20,23,-3,24,28,30
14650,4957,4963,43,1,26,16,6,4,64,31,33,38,14,54
14651,4957,4963,24,4,26,10,9,7,32,30,2,29,23,39
14652,4957,4963,57,8,26,8,9,9,42,41,1,25,27,33
14653,4957,4963,41,6,26,10,7,9,40,39,1,27,25,37
14654,4957,4963,20,9,26,7,11,8,35,44,-9,25,27,32
14655,4817,4830,41,4,9,4,3,2,19,13,6,11,7,15
14656,4817,4830,20,6,9,4,3,2,14,16,-2,11,7,15
14657,4817,4830,43,1,9,6,1,2,24,11,13,13,5,19
14658,4817,4830,24,5,9,4,3,2,13,9,4,11,7,15
14659,4817,4830,57,11,9,2,3,4,13,15,-2,7,11,9
14660,4817,4830,21,9,9,3,3,3,10,8,2,9,9,12
14661,4817,4830,49,7,9,4,2,3,10,9,1,10,8,14
14662,4817,4830,37,8,9,3,5,1,11,7,4,11,7,14
14663,4817,4830,52,2,9,5,4,0,18,6,12,14,4,19
14664,4817,4830,48,12,9,2,2,5,9,20,-11,6,12,8
14665,4817,4830,28,14,9,1,5,3,8,12,-4,7,11,8
14666,4817,4830,36,15,9,1,3,5,12,16,-4,5,13,6
14667,4817,4830,53,16,9,0,4,5,7,19,-12,4,14,4
14668,4817,4830,17,10,9,2,4,3,10,14,-4,8,10,10
14669,4817,4830,8,13,9,2,2,5,6,17,-11,6,12,8
14670,4817,4830,1,3,9,4,3,2,16,8,8,11,7,15
14671,5258,5264,1,6,22,10,7,5,43,22,21,27,17,37
14672,5258,5264,18,16,22,5,9,8,21,36,-15,19,25,24
14673,5258,5264,17,7,22,9,4,9,31,34,-3,22,22,31
14674,5258,5264,8,10,22,7,6,9,26,32,-6,20,24,27
14675,5258,5264,21,3,22,11,7,4,36,20,16,29,15,40
14676,5258,5264,53,5,22,11,5,6,35,22,13,27,17,38
14677,5258,5264,12,8,22,8,7,7,31,32,-1,23,21,31
14678,5258,5264,52,1,22,14,8,0,59,22,37,36,8,50
14679,5258,5264,48,14,22,5,11,6,17,19,-2,21,23,26
14680,5258,5264,36,19,22,4,6,12,16,41,-25,14,30,18
14681,5258,5264,49,2,22,12,5,5,38,20,18,29,15,41
14682,5258,5264,5,11,22,6,8,8,37,39,-2,20,24,26
14683,5258,5264,37,12,22,6,8,8,18,21,-3,20,24,26
14684,5258,5264,20,17,22,5,7,10,20,31,-11,17,27,22
14685,5258,5264,41,18,22,5,6,11,22,31,-9,16,28,21
14686,5258,5264,43,4,22,10,10,2,39,15,24,30,14,40
14687,5258,5264,57,9,22,7,8,7,23,27,-4,22,22,29
14688,5258,5264,24,13,22,6,8,8,14,18,-4,20,24,26
14689,5258,5264,22,20,22,1,8,13,19,47,-28,10,34,11
14690,5258,5264,27,15,22,6,6,10,21,37,-16,18,26,24
14691,5342,5348,27,14,35,9,12,14,35,56,-21,30,40,39
14692,5342,5348,52,1,35,22,11,2,83,34,49,55,15,77
14693,5342,5348,43,2,35,19,12,4,69,21,48,50,20,69
14694,5342,5348,57,11,35,11,12,12,35,40,-5,34,36,45
14695,5342,5348,24,15,35,9,10,16,23,37,-14,28,42,37
14696,5342,5348,22,20,35,4,11,20,26,68,-42,19,51,23
14697,5342,5348,21,3,35,19,8,8,67,29,38,46,24,65
14698,5342,5348,20,9,35,12,11,12,44,39,5,35,35,47
14699,5342,5348,41,10,35,13,7,15,46,51,-5,33,37,46
14700,5342,5348,49,5,35,18,7,10,58,38,20,43,27,61
14701,5342,5348,37,13,35,9,12,14,25,39,-14,30,40,39
14702,5342,5348,5,17,35,8,11,16,52,73,-21,27,43,35
14703,5342,5348,17,7,35,17,6,12,50,46,4,40,30,57
14704,5342,5348,8,12,35,10,10,15,43,53,-10,30,40,40
14705,5342,5348,48,16,35,7,15,13,30,43,-13,29,41,36
14706,5342,5348,36,18,35,8,7,20,31,64,-33,23,47,31
14707,5342,5348,53,6,35,17,9,9,52,33,19,43,27,60
14708,5342,5348,12,8,35,13,11,11,48,48,0,37,33,50
14709,5342,5348,1,4,35,17,11,7,69,33,36,45,25,62
14710,5342,5348,18,19,35,6,11,18,28,69,-41,23,47,29
14711,5545,5558,1,2,12,7,3,2,25,11,14,17,7,24
14712,13189,13195,43,4,10,4,5,1,17,8,9,13,7,17
14713,13189,13195,22,13,10,2,6,2,9,10,-1,10,10,12
14714,13189,13195,34,15,10,2,4,4,12,15,-3,8,12,10
14715,13189,13195,24,17,10,1,5,4,12,18,-6,7,13,8
14716,13189,13195,57,18,10,0,3,7,10,24,-14,3,17,3
14717,13189,13195,49,1,10,8,0,2,19,11,8,16,4,24
14718,13189,13195,21,5,10,5,1,4,17,18,-1,11,9,16
14719,13189,13195,4,7,10,4,2,4,18,19,-1,10,10,14
14720,13189,13195,35,14,10,3,2,5,9,13,-4,8,12,11
14721,13189,13195,47,12,10,3,3,4,11,13,-2,9,11,12
14722,13315,13321,47,6,23,11,5,7,36,24,12,27,19,38
14723,13315,13321,1,2,23,14,4,5,45,27,18,32,14,46
14724,13315,13321,49,8,23,11,2,10,37,35,2,24,22,35
14725,13315,13321,43,4,23,10,9,4,37,18,19,29,17,39
14726,13315,13321,22,9,23,7,8,8,28,29,-1,22,24,29
14727,13315,13321,24,16,23,5,8,10,24,36,-12,18,28,23
14728,13315,13321,34,17,23,4,9,10,27,39,-12,17,29,21
14729,13315,13321,57,18,23,3,6,14,26,49,-23,12,34,15
14730,13315,13321,52,13,23,7,5,11,23,30,-7,19,27,26
14731,13315,13321,28,14,23,6,6,11,32,43,-11,18,28,24
14732,13315,13321,6,7,23,10,6,7,33,34,-1,26,20,36
14733,13315,13321,35,15,23,6,5,12,30,38,-8,17,29,23
14734,13315,13321,27,12,23,7,5,11,27,33,-6,19,27,26
14735,13315,13321,17,3,23,12,9,2,40,23,17,33,13,45
14736,13315,13321,12,11,23,7,6,10,32,37,-5,20,26,27
14737,13315,13321,33,1,23,14,7,2,43,19,24,35,11,49
14738,13315,13321,21,5,23,12,2,9,38,35,3,26,20,38
14739,13315,13321,4,10,23,8,4,11,34,43,-9,20,26,28
14740,13133,13139,1,1,3,2,1,0,9,3,6,5,1,7
14741,13133,13139,33,3,3,2,1,0,5,2,3,5,1,7
14742,13133,13139,52,7,3,1,2,0,4,2,2,4,2,5
14743,13133,13139,28,18,3,0,0,3,1,10,-9,0,6,0
14744,13133,13139,12,13,3,1,0,2,2,3,-1,2,4,3
14745,13133,13139,17,14,3,0,3,0,3,3,0,3,3,3
14746,13133,13139,49,4,3,2,0,1,4,3,1,4,2,6
14747,13133,13139,43,6,3,1,2,0,7,1,6,4,2,5
14748,13133,13139,22,8,3,1,1,1,5,4,1,3,3,4
14749,13133,13139,34,10,3,1,1,1,3,3,0,3,3,4
14750,13133,13139,24,15,3,0,2,1,3,4,-1,2,4,2
14751,13133,13139,57,16,3,0,2,1,2,3,-1,2,4,2
14752,13133,13139,4,2,3,2,1,0,6,3,3,5,1,7
14753,13133,13139,21,5,3,2,0,1,5,6,-1,4,2,6
14754,13133,13139,27,11,3,1,0,2,4,4,0,2,4,3
14755,13133,13139,47,12,3,1,0,2,3,4,-1,2,4,3
14756,13133,13139,35,9,3,1,1,1,5,5,0,3,3,4
14757,13133,13139,6,17,3,0,1,2,1,9,-8,1,5,1
14758,13182,13188,47,14,9,2,3,4,9,12,-3,7,11,9
14759,13182,13188,21,5,9,5,1,3,16,16,0,11,7,16
14760,13182,13188,4,6,9,4,2,3,17,17,0,10,8,14
14761,13182,13188,43,4,9,4,5,0,17,4,13,13,5,17
14762,13182,13188,22,10,9,2,5,2,9,10,-1,9,9,11
14763,13182,13188,34,11,9,2,4,3,12,13,-1,8,10,10
14764,13182,13188,24,16,9,1,5,3,12,16,-4,7,11,8
14765,13182,13188,57,18,9,0,3,6,8,20,-12,3,15,3
14766,13182,13188,49,1,9,7,0,2,16,10,6,14,4,21
14767,13182,13188,6,8,9,3,4,2,14,15,-1,10,8,13
14768,13182,13188,35,15,9,2,2,5,8,13,-5,6,12,8
14769,13182,13188,33,2,9,5,3,1,19,9,10,13,5,18
14770,13182,13188,52,12,9,2,4,3,8,11,-3,8,10,10
14771,13182,13188,28,17,9,1,2,6,12,27,-15,4,14,5
14772,13182,13188,12,13,9,2,3,4,12,13,-1,7,11,9
14773,13182,13188,27,7,9,4,1,4,16,13,3,9,9,13
14774,13182,13188,17,9,9,2,6,1,11,7,4,10,8,12
14775,13182,13188,1,2,9,5,3,1,19,9,10,13,5,18
14776,13658,13664,1,1,19,16,3,0,49,13,36,35,3,51
14777,13658,13664,28,10,19,6,6,7,18,23,-5,18,20,24
14778,13658,13664,33,15,19,5,5,9,19,26,-7,15,23,20
14779,13658,13664,52,16,19,4,3,12,22,51,-29,11,27,15
14780,13658,13664,17,8,19,7,5,7,31,27,4,19,19,26
14781,13658,13664,27,11,19,6,5,8,25,35,-10,17,21,23
14782,13658,13664,49,13,19,5,7,7,26,27,-1,17,21,22
14783,13658,13664,37,17,19,3,6,10,19,33,-14,12,26,15
14784,13658,13664,22,2,19,12,3,4,41,23,18,27,11,39
14785,13658,13664,43,6,19,8,5,6,27,23,4,21,17,29
14786,13658,13664,34,9,19,7,4,8,32,32,0,18,20,25
14787,13658,13664,4,12,19,5,8,6,29,28,1,18,20,23
14788,13658,13664,21,18,19,2,4,13,21,38,-17,8,30,10
14789,13658,13664,12,7,19,9,0,10,36,40,-4,18,20,27
14790,13658,13664,25,14,19,5,7,7,29,36,-7,17,21,22
14791,13658,13664,47,3,19,9,8,2,36,20,16,26,12,35
14792,8597,8603,49,4,26,13,5,8,43,30,13,31,21,44
14793,8597,8603,19,10,26,9,6,11,33,38,-5,24,28,33
14794,8597,8603,17,16,26,7,5,14,32,50,-18,19,33,26
14795,8597,8603,8,17,26,7,4,15,25,52,-27,18,34,25
14796,8597,8603,21,7,26,10,9,7,43,32,11,29,23,39
14797,8597,8603,4,15,26,7,5,14,27,37,-10,19,33,26
14798,8597,8603,13,3,26,14,5,7,49,32,17,33,19,47
14799,8597,8603,20,6,26,11,6,9,43,35,8,28,24,39
14800,8597,8603,56,11,26,8,8,10,28,31,-3,24,28,32
14801,8597,8603,41,13,26,8,6,12,29,38,-9,22,30,30
14802,8597,8603,53,14,26,6,9,11,34,54,-20,21,31,27
14803,8597,8603,1,5,26,12,8,6,45,31,14,32,20,44
14804,8604,8610,1,5,27,13,8,6,50,31,19,34,20,47
14805,8604,8610,12,12,27,9,7,11,34,39,-5,25,29,34
14806,8604,8610,53,16,27,6,9,12,35,58,-23,21,33,27
14807,8604,8610,13,3,27,14,5,8,53,37,16,33,21,47
14808,8604,8610,20,6,27,11,6,10,43,38,5,28,26,39
14809,8604,8610,56,11,27,9,8,10,30,32,-2,26,28,35
14810,8604,8610,41,13,27,8,6,13,29,39,-10,22,32,30
14811,8604,8610,21,7,27,10,9,8,43,37,6,29,25,39
14812,8604,8610,4,15,27,7,6,14,28,38,-10,20,34,27
14813,8604,8610,19,10,27,10,6,11,34,38,-4,26,28,36
14814,8604,8610,17,14,27,8,5,14,33,50,-17,21,33,29
14815,8604,8610,8,17,27,7,5,15,26,53,-27,19,35,26
14816,8604,8610,37,1,27,16,7,4,48,30,18,39,15,55
14817,8604,8610,49,4,27,14,5,8,48,34,14,33,21,47
14818,8604,8610,52,18,27,4,10,13,25,36,-11,18,36,22
14819,8604,8610,43,2,27,15,7,5,62,33,29,37,17,52
14820,8604,8610,24,8,27,9,11,7,36,36,0,29,25,38
14821,8604,8610,57,9,27,10,6,11,27,25,2,26,28,36
14822,8954,8960,43,1,22,17,5,0,69,17,52,39,5,56
14823,8954,8960,57,8,22,7,7,8,25,28,-3,21,23,28
14824,8954,8960,24,13,22,5,8,9,25,35,-10,18,26,23
14825,8954,8960,2,18,22,3,4,15,23,52,-29,10,34,13
14826,8954,8960,37,5,22,10,6,6,37,18,19,26,18,36
14827,8954,8960,49,11,22,6,8,8,27,26,1,20,24,26
14828,8954,8960,1,4,22,11,7,4,38,28,10,29,15,40
14829,8954,8960,4,6,22,10,6,6,45,27,18,26,18,36
14830,8954,8960,21,9,22,6,10,6,22,32,-10,22,22,28
14831,8954,8960,19,14,22,5,8,9,18,30,-12,18,26,23
14832,8954,8960,17,16,22,5,5,12,17,39,-22,15,29,20
14833,8954,8960,20,2,22,15,3,4,50,26,24,33,11,48
14834,8954,8960,41,3,22,12,7,3,42,20,22,31,13,43
14835,8954,8960,13,10,22,7,6,9,29,40,-11,20,24,27
14836,8954,8960,56,12,22,6,6,10,26,40,-14,18,26,24
14837,8954,8960,12,7,22,8,4,10,35,39,-4,20,24,28
14838,8954,8960,53,15,22,5,5,12,28,45,-17,15,29,20
14839,8954,8960,11,17,22,4,7,11,26,40,-14,15,29,19
14840,8961,8974,12,8,23,8,5,10,35,39,-4,21,25,29
14841,8961,8974,53,14,23,6,5,12,31,46,-15,17,29,23
14842,8961,8974,11,17,23,4,7,12,27,43,-16,15,31,19
14843,8961,8974,20,2,23,15,4,4,51,27,24,34,12,49
14844,8961,8974,41,3,23,12,7,4,43,23,20,31,15,43
14845,8961,8974,13,11,23,7,6,10,29,41,-12,20,26,27
14846,8961,8974,56,13,23,6,6,11,26,45,-19,18,28,24
14847,8961,8974,19,15,23,5,8,10,18,31,-13,18,28,23
14848,8961,8974,17,16,23,5,6,12,18,40,-22,16,30,21
14849,8961,8974,4,6,23,10,7,6,45,27,18,27,19,37
14850,8961,8974,21,7,23,7,10,6,24,32,-8,24,22,31
14851,8961,8974,1,4,23,11,8,4,39,29,10,30,16,41
14852,8961,8974,37,5,23,11,6,6,42,18,24,28,18,39
14853,8961,8974,49,9,23,7,8,8,28,26,2,22,24,29
14854,8961,8974,43,1,23,18,5,0,70,17,53,41,5,59
14855,8961,8974,57,10,23,7,7,9,25,30,-5,21,25,28
14856,8961,8974,24,12,23,6,8,9,28,36,-8,20,26,26
14857,8961,8974,2,18,23,3,5,15,24,53,-29,11,35,14
14858,8978,8981,43,1,25,20,5,0,76,17,59,45,5,65
14859,8978,8981,57,8,25,8,8,9,27,31,-4,24,26,32
14860,8978,8981,24,11,25,7,8,10,29,37,-8,22,28,29
14861,8978,8981,2,18,25,3,6,16,27,58,-31,12,38,15
14862,8978,8981,37,5,25,13,6,6,48,18,30,32,18,45
14863,8978,8981,49,10,25,7,9,9,29,31,-2,23,27,30
14864,8978,8981,1,4,25,13,8,4,44,29,15,34,16,47
14865,8978,8981,4,6,25,10,8,7,46,29,17,28,22,38
14866,8978,8981,21,7,25,8,11,6,28,34,-6,27,23,35
14867,8978,8981,17,14,25,6,7,12,20,41,-21,19,31,25
14868,8978,8981,19,15,25,5,10,10,18,31,-13,20,30,25
14869,8978,8981,20,2,25,15,4,6,51,29,22,34,16,49
14870,16045,16051,40,2,1,1,0,0,5,2,3,2,0,3
14871,16045,16051,22,4,1,1,0,0,1,0,1,2,0,3
14872,16045,16051,57,7,1,0,1,0,2,2,0,1,1,1
14873,16045,16051,43,16,1,0,0,1,0,2,-2,0,2,0
14874,16045,16051,49,9,1,0,1,0,1,1,0,1,1,1
14875,16045,16051,1,9,1,0,1,0,1,1,0,1,1,1
14876,16045,16051,33,3,1,1,0,0,2,0,2,2,0,3
14877,16045,16051,28,13,1,0,1,0,0,0,0,1,1,1
14878,16045,16051,4,1,1,1,0,0,5,0,5,2,0,3
14879,16045,16051,9,5,1,0,1,0,3,3,0,1,1,1
14880,16045,16051,37,9,1,0,1,0,1,1,0,1,1,1
14881,16045,16051,46,15,1,0,0,1,0,1,-1,0,2,0
14882,16045,16051,17,9,1,0,1,0,1,1,0,1,1,1
14883,16045,16051,42,13,1,0,1,0,0,0,0,1,1,1
14884,16045,16051,25,5,1,0,1,0,3,3,0,1,1,1
14885,16045,16051,12,7,1,0,1,0,2,2,0,1,1,1
14886,16045,16051,27,17,1,0,0,1,2,5,-3,0,2,0
14887,16143,16156,17,10,13,5,3,5,22,21,1,13,13,18
14888,16143,16156,27,6,13,7,2,4,16,16,0,16,10,23
14889,16143,16156,12,9,13,5,4,4,15,15,0,14,12,19
14890,16143,16156,25,11,13,5,2,6,12,17,-5,12,14,17
14891,16143,16156,49,5,13,7,2,4,18,15,3,16,10,23
14892,16143,16156,37,12,13,4,4,5,18,16,2,12,14,16
14893,16143,16156,46,16,13,2,2,9,10,25,-15,6,20,8
14894,16143,16156,33,13,13,4,3,6,13,16,-3,11,15,15
14895,16143,16156,28,15,13,3,3,7,10,18,-8,9,17,12
14896,16143,16156,4,3,13,8,1,4,25,18,7,17,9,25
14897,16143,16156,9,18,13,0,5,8,12,25,-13,5,21,5
14898,16143,16156,1,1,13,11,2,0,33,5,28,24,2,35
14899,16143,16156,43,2,13,9,1,3,28,15,13,19,7,28
14900,16143,16156,40,4,13,7,2,4,22,12,10,16,10,23
14901,16143,16156,22,7,13,5,6,2,15,13,2,16,10,21
14902,16143,16156,57,8,13,6,2,5,23,28,-5,14,12,20
14903,16143,16156,35,14,13,4,1,8,14,18,-4,9,17,13
14904,16143,16156,42,17,13,1,3,9,12,25,-13,5,21,6
14905,16269,16282,35,13,26,7,6,13,26,31,-5,20,32,27
14906,16269,16282,4,5,26,15,4,7,38,25,13,34,18,49
14907,16269,16282,9,16,26,5,7,14,25,48,-23,17,35,22
14908,16269,16282,27,6,26,13,7,6,32,26,6,33,19,46
14909,16269,16282,1,1,26,20,4,2,66,18,48,44,8,64
14910,16269,16282,43,2,26,18,4,4,56,24,32,40,12,58
14911,16269,16282,22,4,26,15,6,5,40,28,12,36,16,51
14912,16269,16282,40,8,26,10,7,9,34,25,9,27,25,37
14913,16269,16282,57,10,26,9,4,13,37,61,-24,22,30,31
14914,16269,16282,33,14,26,6,6,14,32,38,-6,18,34,24
14915,16269,16282,28,15,26,6,6,14,28,42,-14,18,34,24
14916,16269,16282,49,3,26,16,5,5,45,22,23,37,15,53
14917,16269,16282,37,11,26,8,6,12,37,43,-6,22,30,30
14918,16269,16282,46,17,26,6,2,18,23,51,-28,14,38,20
14919,16269,16282,25,7,26,11,4,11,28,39,-11,26,26,37
14920,16269,16282,12,9,26,8,10,8,27,28,-1,26,26,34
14921,16269,16282,17,12,26,8,5,13,40,49,-9,21,31,29
14922,16269,16282,42,18,26,5,3,18,31,47,-16,13,39,18
14923,16059,16065,17,9,3,1,1,1,4,3,1,3,3,4
14924,16059,16065,42,13,3,0,2,1,3,4,-1,2,4,2
14925,16059,16065,25,4,3,2,1,0,6,4,2,5,1,7
14926,16059,16065,27,11,3,1,0,2,4,7,-3,2,4,3
14927,16059,16065,4,6,3,2,0,1,7,6,1,4,2,6
14928,16059,16065,9,17,3,0,1,2,4,9,-5,1,5,1
14929,16059,16065,49,8,3,1,1,1,5,4,1,3,3,4
14930,16059,16065,37,13,3,0,2,1,3,4,-1,2,4,2
14931,16059,16065,46,15,3,0,1,2,1,3,-2,1,5,1
14932,16059,16065,1,1,3,2,1,0,8,2,6,5,1,7
14933,16059,16065,33,2,3,2,1,0,6,0,6,5,1,7
14934,16059,16065,28,18,3,0,1,2,1,6,-5,1,5,1
14935,16059,16065,40,3,3,2,1,0,8,4,4,5,1,7
14936,16059,16065,22,5,3,2,1,0,3,1,2,5,1,7
14937,16059,16065,43,7,3,2,0,1,3,3,0,4,2,6
14938,16059,16065,57,16,3,0,1,2,4,7,-3,1,5,1
14939,16059,16065,35,11,3,1,0,2,4,7,-3,2,4,3
14940,16059,16065,12,10,3,1,1,1,4,4,0,3,3,4
14941,16528,16534,35,16,16,4,3,9,20,31,-11,11,21,15
14942,16528,16534,4,11,16,5,4,7,18,21,-3,14,18,19
14943,16528,16534,49,1,16,11,2,3,27,15,12,24,8,35
14944,16528,16534,17,18,16,1,6,9,7,29,-22,8,24,9
14945,16528,16534,1,3,16,9,4,3,25,15,10,22,10,31
14946,16528,16534,33,9,16,6,1,9,24,28,-4,13,19,19
14947,16528,16534,28,17,16,4,1,11,17,28,-11,9,23,13
14948,16528,16534,46,8,16,6,6,4,20,16,4,18,14,24
14949,16528,16534,37,15,16,5,1,10,19,26,-7,11,21,16
14950,16528,16534,43,2,16,9,5,2,38,16,22,23,9,32
14951,12160,12180,24,9,18,5,10,3,22,16,6,20,16,25
14952,12160,12180,57,15,18,3,6,9,26,42,-16,12,24,15
14953,12160,12180,22,18,18,1,5,12,22,46,-24,7,29,8
14954,12545,12551,13,7,17,6,6,5,26,20,6,18,16,24
14955,12545,12551,6,9,17,6,4,7,22,23,-1,16,18,22
14956,12545,12551,35,10,17,5,7,5,29,21,8,17,17,22
14957,12545,12551,41,18,17,1,6,10,19,36,-17,8,26,9
14958,12545,12551,49,3,17,10,4,3,27,15,12,24,10,34
14959,12545,12551,37,12,17,5,5,7,19,27,-8,15,19,20
14960,12545,12551,52,11,17,5,7,5,18,20,-2,17,17,22
14961,12545,12551,28,14,17,4,7,6,15,23,-8,15,19,19
14962,12545,12551,43,1,17,12,3,2,40,16,24,27,7,39
14963,12545,12551,34,5,17,8,4,5,39,34,5,20,14,28
14964,12545,12551,24,6,17,7,3,7,20,21,-1,17,17,24
14965,12545,12551,57,13,17,5,4,8,22,27,-5,14,20,19
14966,12545,12551,21,8,17,6,4,7,28,26,2,16,18,22
14967,12545,12551,4,16,17,5,3,9,23,33,-10,13,21,18
14968,12545,12551,9,17,17,3,3,11,16,40,-24,9,25,12
14969,12545,12551,27,15,17,4,7,6,13,21,-8,15,19,19
14970,12545,12551,17,4,17,9,3,5,31,24,7,21,13,30
14971,12545,12551,1,2,17,10,4,3,37,17,20,24,10,34
14972,12559,12565,6,6,19,7,5,7,23,23,0,19,19,26
14973,12559,12565,35,7,19,6,7,6,34,24,10,19,19,25
14974,12559,12565,13,8,19,6,7,6,28,23,5,19,19,25
14975,12559,12565,41,18,19,2,6,11,21,37,-16,10,28,12
14976,12559,12565,17,4,19,9,4,6,31,26,5,22,16,31
14977,12559,12565,27,15,19,5,7,7,16,26,-10,17,21,22
14978,12559,12565,1,2,19,12,4,3,46,19,27,28,10,40
14979,12559,12565,49,3,19,12,4,3,31,16,15,28,10,40
14980,12559,12565,37,13,19,6,5,8,23,29,-6,17,21,23
14981,12559,12565,21,14,19,6,4,9,29,30,-1,16,22,22
14982,12559,12565,4,16,19,6,3,10,24,37,-13,15,23,21
14983,12559,12565,9,17,19,3,4,12,19,48,-29,10,28,13
14984,12559,12565,52,9,19,6,7,6,22,24,-2,19,19,25
14985,12559,12565,28,10,19,6,7,6,20,23,-3,19,19,25
14986,12559,12565,43,1,19,13,4,2,44,19,25,30,8,43
14987,12559,12565,34,5,19,8,4,7,39,38,1,20,18,28
14988,12559,12565,24,11,19,7,3,9,22,27,-5,17,21,24
14989,12559,12565,57,12,19,6,5,8,25,28,-3,17,21,23
14990,12580,12586,43,1,22,16,4,2,58,24,34,36,8,52
14991,12580,12586,34,5,22,9,5,8,46,45,1,23,21,32
14992,12580,12586,24,8,22,8,5,9,24,28,-4,21,23,29
14993,12580,12586,57,16,22,6,5,11,27,38,-11,17,27,23
14994,12580,12586,52,10,22,7,7,8,23,27,-4,21,23,28
14995,12580,12586,28,13,22,6,9,7,22,26,-4,21,23,27
14996,12580,12586,21,9,22,8,4,10,34,34,0,20,24,28
14997,12580,12586,4,15,22,7,4,11,28,41,-13,18,26,25
14998,12580,12586,9,17,22,3,6,13,22,52,-30,12,32,15
14999,12580,12586,49,3,22,14,5,3,35,17,18,33,11,47
15000,12580,12586,37,14,22,6,8,8,27,33,-6,20,24,26
15001,12580,12586,1,2,22,14,5,3,53,21,32,33,11,47
15002,12580,12586,27,11,22,7,7,8,22,29,-7,21,23,28
15003,12580,12586,17,4,22,9,6,7,36,38,-2,24,20,33
15004,12580,12586,13,6,22,8,7,7,36,27,9,23,21,31
15005,12580,12586,35,7,22,7,9,6,38,26,12,23,21,30
15006,12580,12586,6,12,22,7,6,9,26,30,-4,20,24,27
15007,12580,12586,41,18,22,2,6,14,24,45,-21,10,34,12
15008,12608,12614,35,5,26,10,9,7,45,29,16,29,23,39
15009,12608,12614,6,7,26,9,8,9,31,32,-1,26,26,35
15010,12608,12614,13,12,26,8,8,10,39,36,3,24,28,32
15011,12608,12614,41,17,26,4,6,16,28,54,-26,14,38,18
15012,12608,12614,27,11,26,8,9,9,25,32,-7,25,27,33
15013,12608,12614,1,3,26,16,5,5,55,23,32,37,15,53
15014,12608,12614,49,2,26,18,5,3,42,18,24,41,11,59
15015,12608,12614,37,10,26,8,9,9,32,36,-4,25,27,33
15016,12608,12614,4,14,26,8,6,12,29,42,-13,22,30,30
15017,12608,12614,21,15,26,8,5,13,37,43,-6,21,31,29
15018,12608,12614,9,18,26,3,8,15,26,60,-34,14,38,17
15019,12608,12614,28,8,26,8,11,7,28,30,-2,27,25,35
15020,12608,12614,52,13,26,8,8,10,30,32,-2,24,28,32
15021,12608,12614,43,1,26,18,5,3,66,25,41,41,11,59
15022,12608,12614,34,4,26,12,5,9,54,52,2,29,23,41
15023,12608,12614,24,9,26,9,6,11,30,34,-4,24,28,33
15024,12608,12614,57,16,26,6,6,14,31,46,-15,18,34,24
15025,12608,12614,17,6,26,10,7,9,39,43,-4,27,25,37
15026,12615,12628,17,5,27,11,7,9,40,43,-3,29,25,40
15027,12615,12628,43,1,27,19,5,3,69,26,43,43,11,62
15028,12615,12628,34,4,27,12,6,9,55,53,2,30,24,42
15029,13658,13664,35,4,19,10,4,5,32,22,10,24,14,34
15030,13658,13664,6,5,19,8,5,6,31,26,5,21,17,29
15031,13665,13671,35,3,20,11,4,5,36,25,11,26,14,37
15032,13665,13671,6,6,20,8,5,7,32,28,4,21,19,29
15033,13665,13671,47,4,20,9,8,3,37,22,15,26,14,35
15034,13665,13671,12,7,20,9,0,11,37,43,-6,18,22,27
15035,13665,13671,25,14,20,5,7,8,29,37,-8,17,23,22
15036,13665,13671,4,10,20,6,8,6,30,28,2,20,20,26
15037,13665,13671,21,18,20,3,4,13,23,39,-16,10,30,13
15038,13665,13671,22,2,20,12,3,5,44,27,17,27,13,39
15039,13665,13671,43,5,20,9,5,6,29,23,6,23,17,32
15040,13665,13671,34,11,20,7,4,9,32,34,-2,18,22,25
15041,13665,13671,49,12,20,6,7,7,29,28,1,19,21,25
15042,13665,13671,37,17,20,3,7,10,19,33,-14,13,27,16
15043,13665,13671,27,9,20,7,5,8,28,35,-7,19,21,26
15044,13665,13671,17,8,20,7,5,8,31,29,2,19,21,26
15045,13665,13671,28,13,20,6,7,7,18,23,-5,19,21,25
15046,13665,13671,33,15,20,5,5,10,19,29,-10,15,25,20
15047,13665,13671,52,16,20,5,3,12,24,51,-27,13,27,18
15048,13665,13671,1,1,20,17,3,0,51,14,37,37,3,54
15049,13714,13727,1,1,27,22,4,1,61,21,40,48,6,70
15050,13714,13727,28,10,27,8,9,10,24,29,-5,25,29,33
15051,13714,13727,33,15,27,7,7,13,29,40,-11,21,33,28
15052,13714,13727,52,17,27,6,4,17,29,63,-34,16,38,22
15053,13714,13727,49,9,27,8,10,9,38,36,2,26,28,34
15054,13714,13727,37,16,27,5,8,14,23,42,-19,18,36,23
15055,13714,13727,17,7,27,12,6,9,43,34,9,30,24,42
15056,13714,13727,12,5,27,14,1,12,55,54,1,29,25,43
15057,13714,13727,25,14,27,7,10,10,40,45,-5,24,30,31
15058,13714,13727,22,2,27,18,4,5,58,29,29,40,14,58
15059,13714,13727,43,6,27,12,7,8,43,31,12,31,23,43
15060,13714,13727,34,12,27,8,7,12,40,50,-10,23,31,31
15061,13714,13727,27,13,27,8,7,12,37,49,-12,23,31,31
15062,13714,13727,4,11,27,7,12,8,36,37,-1,26,28,33
15063,13714,13727,21,18,27,4,6,17,26,50,-24,14,40,18
15064,13714,13727,47,4,27,12,9,6,43,26,17,33,21,45
15065,13714,13727,35,3,27,14,5,8,50,39,11,33,21,47
15066,13714,13727,6,8,27,10,6,11,41,41,0,26,28,36
15067,14064,14070,35,10,25,10,5,10,37,37,0,25,25,35
15068,14064,14070,6,15,25,5,4,16,23,42,-19,14,36,19
15069,14064,14070,56,17,25,3,6,16,34,63,-29,12,38,15
15070,14064,14070,47,13,25,7,9,9,32,37,-5,23,27,30
15071,14064,14070,1,2,25,16,4,5,48,27,21,36,14,52
15072,14064,14070,4,6,25,12,8,5,45,40,5,32,18,44
15073,14064,14070,9,18,25,2,9,14,23,56,-33,13,37,15
15074,14064,14070,22,1,25,17,5,3,56,28,28,39,11,56
15075,14064,14070,43,3,25,14,5,6,50,33,17,33,17,47
15076,14064,14070,34,12,25,8,6,11,35,42,-7,22,28,30
15077,14064,14070,12,7,25,12,5,8,50,40,10,29,21,41
15078,14064,14070,25,11,25,9,4,12,44,46,-2,22,28,31
15079,14064,14070,27,14,25,4,10,11,29,39,-10,18,32,22
15080,14064,14070,17,9,25,12,3,10,50,39,11,27,23,39
15081,14064,14070,49,5,25,14,2,9,45,27,18,30,20,44
15082,14064,14070,37,16,25,4,5,16,25,51,-26,13,37,17
15083,14064,14070,33,4,25,13,7,5,54,38,16,33,17,46
15084,14064,14070,28,8,25,11,7,7,34,29,5,29,21,40
15085,13903,13909,28,5,8,4,2,2,12,8,4,10,6,14
15086,13903,13909,33,7,8,3,4,1,12,10,2,10,6,13
15087,13903,13909,4,9,8,3,3,2,13,11,2,9,7,12
15088,13903,13909,9,16,8,1,3,4,6,21,-15,5,11,6
15089,13903,13909,17,10,8,3,1,4,16,15,1,7,9,10
15090,13903,13909,27,6,8,3,4,1,12,7,5,10,6,13
15091,13903,13909,25,1,8,6,0,2,25,13,12,12,4,18
15092,13903,13909,12,2,8,5,2,1,19,7,12,12,4,17
15093,13903,13909,22,3,8,5,2,1,13,7,6,12,4,17
15094,13903,13909,34,11,8,3,1,4,15,16,-1,7,9,10
15095,13903,13909,43,15,8,1,4,3,11,16,-5,6,10,7
15096,13903,13909,49,8,8,4,0,4,15,9,6,8,8,12
15097,13903,13909,37,12,8,3,1,4,12,13,-1,7,9,10
15098,13903,13909,1,4,8,5,1,2,12,8,4,11,5,16
15099,13903,13909,47,17,8,1,2,5,6,13,-7,4,12,5
15100,13903,13909,35,13,8,3,1,4,9,15,-6,7,9,10
15101,13903,13909,6,14,8,2,1,5,8,13,-5,5,11,7
15102,13903,13909,56,18,8,1,0,7,11,25,-14,2,14,3
15103,14218,14224,6,8,1,1,0,0,1,0,1,2,0,3
15104,14218,14224,35,15,1,0,0,1,1,3,-2,0,2,0
15105,14218,14224,47,12,1,0,0,1,1,2,-1,0,2,0
15106,14218,14224,17,3,1,1,0,0,3,1,2,2,0,3
15107,14218,14224,1,2,1,1,0,0,4,0,4,2,0,3
15108,11880,11886,35,13,26,8,6,12,45,50,-5,22,30,30
15109,11880,11886,6,17,26,4,4,18,29,64,-35,12,40,16
15110,11880,11886,12,18,26,3,7,16,22,47,-25,13,39,16
15111,11880,11886,27,10,26,10,7,9,39,37,2,27,25,37
15112,11880,11886,17,8,26,11,5,10,38,36,2,27,25,38
15113,11880,11886,1,3,26,13,6,7,40,25,15,32,20,45
15114,11880,11886,43,1,26,21,4,1,64,19,45,46,6,67
15115,11880,11886,24,6,26,12,5,9,38,29,9,29,23,41
15116,11880,11886,22,14,26,6,10,10,26,33,-7,22,30,28
15117,11677,11690,4,7,4,2,1,1,4,2,2,5,3,7
15118,11677,11690,21,8,4,2,0,2,8,8,0,4,4,6
15119,11677,11690,1,3,4,3,0,1,8,4,4,6,2,9
15120,11677,11690,12,10,4,2,0,2,4,6,-2,4,4,6
15121,11677,11690,17,11,4,1,1,2,9,6,3,3,5,4
15122,11677,11690,27,3,4,3,0,1,8,4,4,6,2,9
15123,11677,11690,41,12,4,1,1,2,7,7,0,3,5,4
15124,11677,11690,20,14,4,1,0,3,6,8,-2,2,6,3
15125,11677,11690,35,15,4,1,0,3,8,12,-4,2,6,3
15126,11677,11690,6,18,4,0,0,4,2,16,-14,0,8,0
15127,11677,11690,49,5,4,3,0,1,6,4,2,6,2,9
15128,11677,11690,37,6,4,3,0,1,6,5,1,6,2,9
15129,11677,11690,14,8,4,2,0,2,8,8,0,4,4,6
15130,11677,11690,43,1,4,4,0,0,10,2,8,8,0,12
15131,11677,11690,24,2,4,3,0,1,9,3,6,6,2,9
15132,11677,11690,22,13,4,1,1,2,4,5,-1,3,5,4
15133,11677,11690,57,17,4,0,1,3,6,12,-6,1,7,1
15134,11677,11690,52,16,4,0,3,1,4,5,-1,3,5,3
15135,12062,12068,52,16,7,1,2,4,9,16,-7,4,10,5
15136,12062,12068,43,1,7,6,1,0,25,9,16,13,1,19
15137,12062,12068,24,11,7,1,4,2,7,7,0,6,8,7
15138,12062,12068,57,13,7,1,4,2,10,13,-3,6,8,7
15139,12062,12068,22,18,7,0,2,5,9,20,-11,2,12,2
15140,12062,12068,49,4,7,3,2,2,7,3,4,8,6,11
15141,12062,12068,37,15,7,0,6,1,4,6,-2,6,8,6
15142,12062,12068,35,8,7,2,3,2,8,9,-1,7,7,9
15143,12062,12068,13,10,7,2,2,3,8,6,2,6,8,8
15144,12062,12068,41,14,7,1,4,2,6,12,-6,6,8,7
15145,12062,12068,20,17,7,1,2,4,8,15,-7,4,10,5
15146,12062,12068,4,9,7,1,6,0,9,7,2,8,6,9
15147,12062,12068,6,2,7,4,2,1,13,7,6,10,4,14
15148,12062,12068,21,5,7,3,2,2,9,10,-1,8,6,11
15149,12062,12068,9,6,7,2,5,0,10,5,5,9,5,11
15150,12062,12068,27,7,7,3,1,3,8,7,1,7,7,10
15151,12062,12068,17,12,7,1,4,2,5,6,-1,6,8,7
15152,12062,12068,1,3,7,3,4,0,8,5,3,10,4,13
15153,12475,12488,17,4,10,5,2,3,23,16,7,12,8,17
15154,12475,12488,4,8,10,4,3,3,15,15,0,11,9,15
15155,12475,12488,21,14,10,3,2,5,15,19,-4,8,12,11
15156,12475,12488,9,16,10,3,1,6,12,21,-9,7,13,10
15157,12475,12488,13,5,10,5,2,3,18,12,6,12,8,17
15158,12475,12488,35,10,10,3,3,4,20,15,5,9,11,12
15159,12475,12488,6,17,10,2,1,7,8,18,-10,5,15,7
15160,12475,12488,41,18,10,0,4,6,12,24,-12,4,16,4
15161,12475,12488,49,1,10,7,2,1,18,6,12,16,4,23
15162,12475,12488,37,7,10,5,0,5,16,18,-2,10,10,15
15163,12475,12488,27,12,10,3,3,4,9,14,-5,9,11,12
15164,12475,12488,43,2,10,7,2,1,25,14,11,16,4,23
15165,12475,12488,24,6,10,5,2,3,14,11,3,12,8,17
15166,12475,12488,34,9,10,4,2,4,19,22,-3,10,10,14
15167,12475,12488,57,15,10,3,2,5,9,14,-5,8,12,11
15168,12475,12488,1,3,10,5,2,3,23,12,11,12,8,17
15169,12475,12488,28,11,10,3,3,4,10,14,-4,9,11,12
15170,12475,12488,52,13,10,2,6,2,12,13,-1,10,10,12
15171,12412,12418,28,11,2,0,2,0,1,1,0,2,2,2
15172,12412,12418,52,17,2,0,1,1,1,3,-2,1,3,1
15173,12412,12418,34,4,2,1,1,0,4,3,1,3,1,4
15174,12412,12418,57,7,2,1,0,1,2,2,0,2,2,3
15175,12412,12418,24,9,2,1,0,1,1,2,-1,2,2,3
15176,12412,12418,43,13,2,0,1,1,3,4,-1,1,3,1
15177,12412,12418,49,2,2,2,0,0,5,1,4,4,0,6
15178,12412,12418,37,7,2,1,0,1,2,2,0,2,2,3
15179,12412,12418,13,2,2,2,0,0,5,1,4,4,0,6
15180,12412,12418,35,12,2,0,1,1,4,5,-1,1,3,1
15181,12412,12418,6,13,2,0,1,1,3,4,-1,1,3,1
15182,12412,12418,41,18,2,0,1,1,1,6,-5,1,3,1
15183,12412,12418,9,5,2,1,0,1,4,4,0,2,2,3
15184,12412,12418,21,6,2,1,0,1,3,3,0,2,2,3
15185,12412,12418,4,10,2,1,0,1,2,4,-2,2,2,3
15186,12412,12418,17,1,2,2,0,0,8,2,6,4,0,6
15187,12412,12418,27,16,2,0,1,1,0,1,-1,1,3,1
15188,12412,12418,1,13,2,0,1,1,3,4,-1,1,3,1
15189,12678,12754,1,3,34,21,7,6,68,31,37,49,19,70
15190,6941,6944,27,3,3,2,1,0,4,1,3,5,1,7
15191,6941,6944,59,7,3,1,2,0,4,3,1,4,2,5
15192,6941,6944,1,5,3,2,0,1,3,2,1,4,2,6
15193,6941,6944,49,2,3,2,1,0,7,3,4,5,1,7
15194,6941,6944,37,11,3,1,1,1,4,3,1,3,3,4
15195,6941,6944,57,4,3,2,0,1,5,4,1,4,2,6
15196,6941,6944,22,14,3,0,2,1,1,4,-3,2,4,2
15197,6941,6944,43,18,3,0,0,3,4,9,-5,0,6,0
15198,6941,6944,52,6,3,2,0,1,3,4,-1,4,2,6
15199,6941,6944,48,7,3,1,2,0,4,3,1,4,2,5
15200,6941,6944,21,13,3,0,2,1,0,1,-1,2,4,2
15201,6941,6944,17,12,3,1,0,2,5,5,0,2,4,3
15202,6941,6944,8,15,3,0,1,2,1,3,-2,1,5,1
15203,6941,6944,19,16,3,0,1,2,2,5,-3,1,5,1
15204,6941,6944,20,10,3,1,1,1,4,2,2,3,3,4
15205,6941,6944,41,17,3,0,0,3,2,6,-4,0,6,0
15206,6941,6944,12,1,3,3,0,0,5,1,4,6,0,9
15207,6941,6944,53,7,3,1,2,0,4,3,1,4,2,5
15208,6952,6958,12,1,5,4,1,0,9,2,7,9,1,13
15209,6952,6958,20,14,5,1,2,2,5,8,-3,4,6,5
15210,6952,6958,41,17,5,0,1,4,3,10,-7,1,9,1
15211,6952,6958,17,9,5,2,0,3,11,10,1,4,6,6
15212,6952,6958,8,15,5,1,1,3,8,5,3,3,7,4
15213,6952,6958,19,18,5,0,1,4,3,11,-8,1,9,1
15214,6952,6958,21,16,5,0,3,2,1,4,-3,3,7,3
15215,6952,6958,52,5,5,3,1,1,5,4,1,7,3,10
15216,6952,6958,48,13,5,1,2,2,7,9,-2,4,6,5
15217,6952,6958,57,2,5,4,0,1,11,5,6,8,2,12
15218,6952,6958,43,10,5,2,0,3,11,11,0,4,6,6
15219,6952,6958,22,12,5,1,3,1,3,5,-2,5,5,6
15220,6952,6958,49,3,5,3,2,0,13,7,6,8,2,11
15221,6952,6958,37,11,5,1,3,1,7,6,1,5,5,6
15222,6952,6958,1,4,5,3,1,1,7,2,5,7,3,10
15223,6952,6958,59,6,5,2,2,1,7,7,0,6,4,8
15224,6952,6958,27,7,5,2,1,2,4,10,-6,5,5,7
15225,6952,6958,53,8,5,1,4,0,5,4,1,6,4,7
15226,7358,7371,12,4,10,6,1,3,19,9,10,13,7,19
15227,7358,7371,53,17,10,2,1,7,11,18,-7,5,15,7
15228,7358,7371,52,3,10,6,2,2,16,11,5,14,6,20
15229,7358,7371,48,9,10,4,3,3,14,16,-2,11,9,15
15230,7358,7371,1,10,10,4,2,4,16,16,0,10,10,14
15231,7358,7371,37,2,10,6,2,2,19,9,10,14,6,20
15232,7358,7371,49,5,10,5,3,2,24,15,9,13,7,18
15233,7358,7371,56,6,10,5,1,4,14,15,-1,11,9,16
15234,7358,7371,20,12,10,4,1,5,15,16,-1,9,11,13
15235,7358,7371,41,18,10,1,1,8,12,21,-9,3,17,4
15236,7358,7371,43,1,10,8,1,1,26,9,17,17,3,25
15237,7358,7371,22,7,10,5,0,5,16,15,1,10,10,15
15238,7358,7371,57,14,10,3,2,5,18,24,-6,8,12,11
15239,7358,7371,21,13,10,3,3,4,10,20,-10,9,11,12
15240,7358,7371,4,15,10,2,3,5,7,15,-8,7,13,9
15241,7358,7371,17,8,10,4,3,3,19,15,4,11,9,15
15242,7358,7371,19,11,10,4,1,5,20,20,0,9,11,13
15243,7358,7371,8,16,10,2,2,6,11,23,-12,6,14,8
15244,7505,7511,17,10,26,9,9,8,44,38,6,27,25,36
15245,7505,7511,19,15,26,7,4,15,42,59,-17,18,34,25
15246,7505,7511,8,16,26,6,7,13,31,51,-20,19,33,25
15247,7505,7511,21,6,26,10,9,7,37,39,-2,29,23,39
15248,7505,7511,4,9,26,10,7,9,40,34,6,27,25,37
15249,7505,7511,52,7,26,11,5,10,37,38,-1,27,25,38
15250,7505,7511,48,18,26,4,9,13,22,62,-40,17,35,21
15251,7505,7511,43,1,26,20,4,2,52,16,36,44,8,64
15252,7505,7511,22,8,26,11,5,10,34,37,-3,27,25,38
15253,7505,7511,57,14,26,8,5,13,40,55,-15,21,31,29
15254,7505,7511,20,11,26,8,8,10,33,35,-2,24,28,32
15255,7505,7511,41,12,26,8,6,12,37,34,3,22,30,30
15256,7505,7511,56,13,26,8,6,12,30,40,-10,22,30,30
15257,7505,7511,37,2,26,15,5,6,42,22,20,35,17,50
15258,7505,7511,49,4,26,13,5,8,50,38,12,31,21,44
15259,7505,7511,1,5,26,12,4,10,56,40,16,28,24,40
15260,7505,7511,12,3,26,13,6,7,52,30,22,32,20,45
15261,7505,7511,53,17,26,6,6,14,26,37,-11,18,34,24
15262,7512,7518,12,3,27,14,6,7,54,30,24,34,20,48
15263,7512,7518,53,17,27,6,6,15,27,39,-12,18,36,24
15264,7512,7518,1,5,27,13,4,10,60,43,17,30,24,43
15265,7512,7518,37,2,27,16,5,6,44,23,21,37,17,53
15266,7512,7518,49,4,27,14,5,8,51,38,13,33,21,47
15267,7512,7518,41,12,27,8,6,13,40,38,2,22,32,30
15268,7512,7518,56,13,27,8,6,13,30,46,-16,22,32,30
15269,7512,7518,20,11,27,9,8,10,35,35,0,26,28,35
15270,7512,7518,43,1,27,21,4,2,58,16,42,46,8,67
15271,11740,11753,4,8,11,5,2,4,16,12,4,12,10,17
15272,11740,11753,21,9,11,5,1,5,18,22,-4,11,11,16
15273,11740,11753,12,15,11,3,1,7,10,19,-9,7,15,10
15274,11740,11753,20,7,11,5,2,4,28,19,9,12,10,17
15275,11740,11753,41,14,11,3,2,6,16,27,-11,8,14,11
15276,11740,11753,35,16,11,3,1,7,18,29,-11,7,15,10
15277,11740,11753,6,18,11,1,1,9,9,30,-21,3,19,4
15278,11740,11753,17,10,11,4,3,4,18,17,1,11,11,15
15279,11740,11753,27,4,11,6,1,4,25,19,6,13,9,19
15280,11740,11753,49,2,11,9,1,1,27,13,14,19,3,28
15281,11740,11753,37,5,11,6,1,4,14,14,0,13,9,19
15282,11740,11753,14,12,11,4,0,7,20,27,-7,8,14,12
15283,11740,11753,1,3,11,7,1,3,15,7,8,15,7,22
15284,11670,11672,1,3,2,2,0,0,6,2,4,4,0,6
15285,11670,11672,52,11,2,0,1,1,3,4,-1,1,3,1
15286,11670,11672,17,15,2,0,0,2,3,5,-2,0,4,0
15287,11670,11672,37,4,2,2,0,0,4,1,3,4,0,6
15288,11670,11672,14,7,2,1,0,1,4,4,0,2,2,3
15289,11670,11672,49,10,2,1,0,1,3,4,-1,2,2,3
15290,11670,11672,6,18,2,0,0,2,0,5,-5,0,4,0
15291,11670,11672,27,6,2,2,0,0,3,1,2,4,0,6
15292,11670,11672,12,5,2,2,0,0,4,2,2,4,0,6
15293,11670,11672,24,1,2,2,0,0,7,2,5,4,0,6
15294,11670,11672,43,1,2,2,0,0,7,2,5,4,0,6
15295,11670,11672,22,13,2,0,1,1,2,3,-1,1,3,1
15296,11670,11672,57,14,2,0,1,1,4,8,-4,1,3,1
15297,11670,11672,41,11,2,0,1,1,3,4,-1,1,3,1
15298,11670,11672,20,16,2,0,0,2,1,3,-2,0,4,0
15299,11670,11672,35,17,2,0,0,2,2,6,-4,0,4,0
15300,11670,11672,21,8,2,1,0,1,3,3,0,2,2,3
15301,11670,11672,4,9,2,1,0,1,1,1,0,2,2,3
15302,11873,11879,21,6,25,12,4,9,46,38,8,28,22,40
15303,11873,11879,4,8,25,10,7,8,36,31,5,27,23,37
15304,11873,11879,43,1,25,20,4,1,59,19,40,44,6,64
15305,11873,11879,24,5,25,12,4,9,37,28,9,28,22,40
15306,11873,11879,22,13,25,6,10,9,26,28,-2,22,28,28
15307,11873,11879,57,15,25,6,8,11,48,57,-9,20,30,26
15308,11873,11879,27,11,25,9,7,9,38,37,1,25,25,34
15309,11873,11879,20,3,25,12,6,7,61,35,26,30,20,42
15310,11873,11879,41,12,25,8,7,10,34,50,-16,23,27,31
15311,11873,11879,35,14,25,7,6,12,40,48,-8,20,30,27
15312,11873,11879,6,17,25,4,4,17,29,60,-31,12,38,16
15313,11873,11879,49,2,25,14,6,5,47,29,18,34,16,48
15314,11873,11879,37,7,25,11,5,9,33,31,2,27,23,38
15315,11873,11879,14,16,25,5,4,16,33,74,-41,14,36,19
15316,11873,11879,17,10,25,10,5,10,36,35,1,25,25,35
15317,11873,11879,52,9,25,9,10,6,35,28,7,28,22,37
15318,11873,11879,12,18,25,3,7,15,21,44,-23,13,37,16
15319,11873,11879,1,4,25,12,6,7,37,24,13,30,20,42
15320,11901,11907,12,18,28,3,8,17,26,52,-26,14,42,17
15321,11901,11907,1,4,28,14,6,8,41,27,14,34,22,48
15322,11901,11907,52,11,28,10,11,7,37,29,8,31,25,41
15323,11901,11907,17,8,28,12,5,11,41,39,2,29,27,41
15324,11901,11907,49,2,28,15,7,6,53,33,20,37,19,52
15325,11901,11907,37,7,28,13,5,10,40,36,4,31,25,44
15326,11901,11907,14,16,28,5,5,18,34,82,-48,15,41,20
15327,11901,11907,20,3,28,14,6,8,66,40,26,34,22,48
15328,11901,11907,41,12,28,9,7,12,37,54,-17,25,31,34
15329,11901,11907,35,13,28,9,6,13,47,54,-7,24,32,33
15330,11901,11907,6,17,28,5,4,19,32,68,-36,14,42,19
15331,11901,11907,27,10,28,11,8,9,43,39,4,30,26,41
15332,11901,11907,21,5,28,13,5,10,50,40,10,31,25,44
15333,11901,11907,4,9,28,11,8,9,41,35,6,30,26,41
15334,11901,11907,43,1,28,22,5,1,67,20,47,49,7,71
15335,11901,11907,24,6,28,13,5,10,40,31,9,31,25,44
15336,11901,11907,22,14,28,7,10,11,30,35,-5,24,32,31
15337,11901,11907,57,15,28,6,9,13,53,64,-11,21,35,27
15338,11673,11676,41,9,3,1,1,1,7,5,2,3,3,4
15339,11673,11676,20,16,3,0,0,3,2,7,-5,0,6,0
15340,11673,11676,35,17,3,0,0,3,3,11,-8,0,6,0
15341,11673,11676,6,18,3,0,0,3,1,11,-10,0,6,0
15342,11673,11676,24,1,3,3,0,0,9,2,7,6,0,9
15343,11673,11676,43,1,3,3,0,0,9,2,7,6,0,9
15344,11673,11676,22,14,3,0,1,2,2,5,-3,1,5,1
15345,11673,11676,57,15,3,0,1,2,4,9,-5,1,5,1
15346,11673,11676,4,10,3,1,1,1,2,2,0,3,3,4
15347,11673,11676,21,12,3,1,0,2,5,6,-1,2,4,3
15348,11673,11676,37,4,3,3,0,0,5,1,4,6,0,9
15349,11673,11676,14,6,3,2,0,1,7,6,1,4,2,6
15350,11673,11676,49,7,3,2,0,1,4,4,0,4,2,6
15351,16528,16534,22,5,16,8,5,3,27,17,10,21,11,29
15352,16528,16534,27,12,16,4,6,6,17,22,-5,14,18,18
15353,16528,16534,45,4,16,9,3,4,32,24,8,21,11,30
15354,16528,16534,25,6,16,8,4,4,22,12,10,20,12,28
15355,16528,16534,12,7,16,8,4,4,24,21,3,20,12,28
15356,16528,16534,51,10,16,5,4,7,26,22,4,14,18,19
15357,16528,16534,57,13,16,5,2,9,19,27,-8,12,20,17
15358,16528,16534,40,14,16,4,5,7,17,29,-12,13,19,17
15359,16584,16590,43,3,20,10,7,3,42,21,21,27,13,37
15360,16584,16590,22,5,20,9,7,4,34,23,11,25,15,34
15361,16584,16590,51,11,20,6,7,7,31,25,6,19,21,25
15362,16584,16590,57,13,20,6,4,10,26,33,-7,16,24,22
15363,16584,16590,40,16,20,4,7,9,19,37,-18,15,25,19
15364,16584,16590,17,18,20,2,7,11,10,34,-24,11,29,13
15365,16584,16590,45,4,20,10,4,6,38,31,7,24,16,34
15366,16584,16590,27,10,20,7,6,7,21,25,-4,20,20,27
15367,16584,16590,4,7,20,9,4,7,27,24,3,22,18,31
15368,16584,16590,49,1,20,12,3,5,31,19,12,27,13,39
15369,16584,16590,46,9,20,7,8,5,24,21,3,22,18,29
15370,16584,16590,37,15,20,6,2,12,24,33,-9,14,26,20
15371,16584,16590,1,2,20,11,6,3,32,18,14,28,12,39
15372,16584,16590,35,12,20,7,3,10,27,34,-7,17,23,24
15373,16584,16590,25,6,20,9,5,6,28,19,9,23,17,32
15374,16584,16590,12,8,20,8,7,5,29,27,2,23,17,31
15375,16584,16590,33,14,20,6,2,12,26,34,-8,14,26,20
15376,16584,16590,28,17,20,4,5,11,19,30,-11,13,27,17
15377,16626,16632,12,7,26,10,9,7,37,34,3,29,23,39
15378,16626,16632,25,8,26,11,5,10,35,34,1,27,25,38
15379,16626,16632,35,12,26,8,5,13,32,41,-9,21,31,29
15380,16626,16632,17,18,26,5,7,14,17,44,-27,17,35,22
15381,16626,16632,28,15,26,6,8,12,29,37,-8,20,32,26
15382,16626,16632,1,3,26,14,8,4,41,25,16,36,16,50
15383,16626,16632,33,13,26,8,4,14,37,36,1,20,32,28
15384,16626,16632,4,6,26,12,5,9,35,30,5,29,23,41
15385,16626,16632,49,2,26,15,6,5,45,23,22,36,16,51
15386,16626,16632,46,10,26,8,10,8,25,25,0,26,26,34
15387,16626,16632,37,16,26,7,3,16,30,45,-15,17,35,24
15388,16626,16632,45,4,26,14,5,7,46,34,12,33,19,47
15389,16626,16632,27,9,26,9,7,10,28,31,-3,25,27,34
15390,16626,16632,43,1,26,15,7,4,54,25,29,37,15,52
15391,16626,16632,22,5,26,12,8,6,40,30,10,32,20,44
15392,16626,16632,51,11,26,8,8,10,39,36,3,24,28,32
15393,16626,16632,57,14,26,7,6,13,30,50,-20,20,32,27
15394,16626,16632,40,17,26,4,11,11,21,41,-20,19,33,23
15395,16423,16429,17,13,3,1,0,2,3,7,-4,2,4,3
15396,16423,16429,12,3,3,2,1,0,4,1,3,5,1,7
15397,16423,16429,25,3,3,2,1,0,4,1,3,5,1,7
15398,16423,16429,27,6,3,2,1,0,3,0,3,5,1,7
15399,16423,16429,45,7,3,1,1,1,4,3,1,3,3,4
15400,16423,16429,49,2,3,3,0,0,7,2,5,6,0,9
15401,16423,16429,46,8,3,1,1,1,3,2,1,3,3,4
15402,16423,16429,37,10,3,1,0,2,4,4,0,2,4,3
15403,16423,16429,1,3,3,2,1,0,4,1,3,5,1,7
15404,16423,16429,43,1,3,3,0,0,11,1,10,6,0,9
15405,16423,16429,51,11,3,1,0,2,1,2,-1,2,4,3
15406,16423,16429,22,14,3,0,3,0,2,2,0,3,3,3
15407,16423,16429,40,15,3,0,2,1,1,7,-6,2,4,2
15408,16423,16429,57,17,3,0,0,3,0,5,-5,0,6,0
15409,16423,16429,35,16,3,0,0,3,1,6,-5,0,6,0
15410,16423,16429,28,12,3,1,0,2,1,3,-2,2,4,3
15411,16423,16429,33,17,3,0,0,3,0,5,-5,0,6,0
15412,16423,16429,4,9,3,1,1,1,3,4,-1,3,3,4
15413,16458,16464,28,11,8,3,0,5,5,8,-3,6,10,9
15414,16458,16464,33,15,8,2,0,6,6,15,-9,4,12,6
15415,16458,16464,1,7,8,4,2,2,8,6,2,10,6,14
15416,16458,16464,43,2,8,5,3,0,23,7,16,13,3,18
15417,16458,16464,35,16,8,1,2,5,7,15,-8,4,12,5
15418,16458,16464,22,8,8,3,4,1,14,11,3,10,6,13
15419,16458,16464,51,12,8,2,2,4,8,11,-3,6,10,8
15420,16458,16464,57,17,8,1,1,6,6,15,-9,3,13,4
15421,16458,16464,40,18,8,0,4,4,7,16,-9,4,12,4
15422,16458,16464,49,1,8,6,1,1,18,9,9,13,3,19
15423,16458,16464,37,10,8,3,1,4,10,9,1,7,9,10
15424,16458,16464,46,13,8,1,4,3,8,11,-3,6,10,7
15425,16458,16464,4,6,8,4,2,2,11,9,2,10,6,14
15426,16458,16464,45,5,8,4,2,2,16,11,5,10,6,14
15427,16458,16464,27,9,8,2,5,1,7,5,2,9,7,11
15428,16458,16464,25,3,8,5,2,1,10,2,8,12,4,17
15429,16458,16464,12,4,8,5,1,2,9,8,1,11,5,16
15430,16458,16464,17,14,8,1,4,3,4,9,-5,6,10,7
15431,14218,14224,49,6,1,1,0,0,2,1,1,2,0,3
15432,14218,14224,37,16,1,0,0,1,0,2,-2,0,2,0
15433,14218,14224,4,1,1,1,0,0,5,1,4,2,0,3
15434,14218,14224,34,4,1,1,0,0,2,0,2,2,0,3
15435,14218,14224,43,5,1,1,0,0,3,2,1,2,0,3
15436,14218,14224,22,9,1,0,1,0,6,6,0,1,1,1
15437,14218,14224,24,12,1,0,0,1,1,2,-1,0,2,0
15438,14218,14224,25,9,1,0,1,0,6,6,0,1,1,1
15439,14218,14224,12,14,1,0,0,1,0,1,-1,0,2,0
15440,14218,14224,58,17,1,0,0,1,1,5,-4,0,2,0
15441,14218,14224,27,6,1,1,0,0,2,1,1,2,0,3
15442,14218,14224,33,11,1,0,0,1,2,3,-1,0,2,0
15443,14218,14224,28,18,1,0,0,1,0,4,-4,0,2,0
15444,14323,14329,33,7,14,6,3,5,26,20,6,15,13,21
15445,14323,14329,28,16,14,2,3,9,16,36,-20,7,21,9
15446,14323,14329,1,4,14,8,1,5,32,16,16,17,11,25
15447,14323,14329,27,12,14,4,5,5,20,22,-2,13,15,17
15448,14323,14329,17,2,14,9,3,2,29,14,15,21,7,30
15449,14323,14329,25,8,14,6,3,5,29,30,-1,15,13,21
15450,14323,14329,12,13,14,3,5,6,22,29,-7,11,17,14
15451,14323,14329,58,15,14,1,7,6,9,26,-17,9,19,10
15452,14323,14329,43,1,14,12,2,0,43,16,27,26,2,38
15453,14323,14329,22,3,14,8,5,1,36,16,20,21,7,29
15454,14323,14329,34,9,14,6,2,6,28,23,5,14,14,20
15455,14323,14329,24,11,14,6,1,7,20,32,-12,13,15,19
15456,14323,14329,49,10,14,6,1,7,22,27,-5,13,15,19
15457,14323,14329,37,18,14,1,5,8,17,32,-15,7,21,8
15458,14323,14329,4,5,14,8,0,6,38,28,10,16,12,24
15459,14323,14329,47,14,14,3,4,7,19,24,-5,10,18,13
15460,14323,14329,35,6,14,7,2,5,24,23,1,16,12,23
15461,14323,14329,6,17,14,1,6,7,14,30,-16,8,20,9
15462,14428,14434,35,8,25,12,6,7,43,36,7,30,20,42
15463,14428,14434,6,18,25,1,10,14,23,53,-30,12,38,13
15464,14428,14434,47,13,25,7,4,14,42,52,-10,18,32,25
15465,14428,14434,1,4,25,14,4,7,54,25,29,32,18,46
15466,14428,14434,49,2,25,16,2,7,57,36,21,34,16,50
15467,14428,14434,37,14,25,6,6,13,35,48,-13,18,32,24
15468,14428,14434,43,1,25,18,6,1,67,24,43,42,8,60
15469,14428,14434,22,7,25,12,6,7,51,42,9,30,20,42
15470,14428,14434,24,10,25,10,3,12,40,56,-16,23,27,33
15471,14428,14434,34,12,25,10,2,13,45,51,-6,22,28,32
15472,14428,14434,17,5,25,13,5,7,53,31,22,31,19,44
15473,14428,14434,27,16,25,5,6,14,29,50,-21,16,34,21
15474,14428,14434,25,9,25,10,6,9,45,55,-10,26,24,36
15475,14428,14434,12,11,25,9,6,10,44,50,-6,24,26,33
15476,14428,14434,58,17,25,3,9,13,20,45,-25,15,35,18
15477,14428,14434,33,6,25,13,4,8,53,37,16,30,20,43
15478,14428,14434,28,15,25,6,4,15,27,53,-26,16,34,22
15479,14428,14434,4,3,25,15,1,9,61,45,16,31,19,46
15480,14267,14273,4,5,7,4,0,3,18,13,5,8,6,12
15481,14267,14273,33,11,7,2,2,3,13,15,-2,6,8,8
15482,14267,14273,28,15,7,1,2,4,7,16,-9,4,10,5
15483,14267,14273,1,3,7,5,1,1,20,5,15,11,3,16
15484,14267,14273,27,9,7,3,1,3,11,10,1,7,7,10
15485,14267,14273,17,2,7,6,0,1,18,8,10,12,2,18
15486,14267,14273,43,1,7,6,1,0,21,10,11,13,1,19
15487,14267,14273,22,6,7,3,3,1,20,12,8,9,5,12
15488,14267,14273,34,8,7,3,1,3,15,12,3,7,7,10
15489,14267,14273,24,10,7,3,0,4,8,17,-9,6,8,9
15490,14267,14273,49,12,7,2,1,4,7,13,-6,5,9,7
15491,14267,14273,37,17,7,1,1,5,11,20,-9,3,11,4
15492,14267,14273,25,7,7,3,2,2,15,16,-1,8,6,11
15493,14267,14273,58,16,7,0,5,2,4,11,-7,5,9,5
15494,14267,14273,12,18,7,0,3,4,6,12,-6,3,11,3
15495,14267,14273,47,14,7,1,3,3,7,11,-4,5,9,6
15496,14267,14273,35,4,7,4,1,2,15,11,4,9,5,13
15497,14267,14273,6,13,7,1,3,3,10,14,-4,5,9,6
15498,14288,14294,35,4,9,5,2,2,18,13,5,12,6,17
15499,14288,14294,6,16,9,1,3,5,12,21,-9,5,13,6
15500,14288,14294,47,14,9,1,3,5,9,15,-6,5,13,6
15501,14288,14294,25,9,9,4,2,3,17,18,-1,10,8,14
15502,14288,14294,12,15,9,1,3,5,9,16,-7,5,13,6
15503,14288,14294,58,18,9,0,5,4,5,16,-11,5,13,5
15504,14288,14294,49,12,9,3,1,5,10,15,-5,7,11,10
15505,14288,14294,37,17,9,1,2,6,13,24,-11,4,14,5
15506,14288,14294,43,1,9,7,2,0,26,14,12,16,2,23
15507,14288,14294,22,6,9,4,4,1,23,14,9,12,6,16
15508,14288,14294,24,7,9,5,0,4,13,19,-6,10,8,15
15509,14288,14294,34,10,9,4,1,4,18,15,3,9,9,13
15510,14288,14294,17,2,9,7,1,1,21,10,11,15,3,22
15511,5608,5614,57,9,19,6,9,4,28,23,5,21,17,27
15512,5608,5614,24,14,19,3,7,9,23,32,-9,13,25,16
15513,5608,5614,40,15,19,2,9,8,16,29,-13,13,25,15
15514,5608,5614,20,7,19,8,7,4,31,19,12,23,15,31
15515,5608,5614,41,12,19,7,5,7,33,35,-2,19,19,26
15516,5608,5614,52,2,19,11,4,4,36,19,17,26,12,37
15517,5608,5614,48,18,19,2,7,10,12,31,-19,11,27,13
15518,5608,5614,54,19,18,4,2,12,10,33,-23,10,26,14
15519,5608,5614,37,6,19,8,7,4,23,10,13,23,15,31
15520,5608,5614,49,10,19,8,5,6,24,22,2,21,17,29
15521,5608,5614,5,13,19,3,8,8,20,29,-9,14,24,17
15522,5608,5614,12,4,19,11,2,6,37,22,15,24,14,35
15523,5608,5614,53,8,19,8,6,5,32,31,1,22,16,30
15524,5608,5614,17,5,19,10,3,6,37,24,13,23,15,33
15525,5608,5614,8,16,19,5,3,11,14,33,-19,13,25,18
15526,5608,5614,21,11,19,8,5,6,23,27,-4,21,17,29
15527,5608,5614,1,1,19,11,4,4,38,20,18,26,12,37
15528,5608,5614,27,17,19,3,5,11,19,31,-12,11,27,14
15529,5468,5474,27,17,3,0,1,2,0,5,-5,1,5,1
15530,5468,5474,48,7,2,1,1,0,2,0,2,3,1,4
15531,5468,5474,54,19,3,0,0,3,1,11,-10,0,6,0
15532,5468,5474,1,16,2,0,1,1,2,3,-1,1,3,1
15533,5468,5474,21,4,3,2,1,0,4,0,4,5,1,7
15534,5468,5474,52,1,3,3,0,0,8,1,7,6,0,9
15535,5468,5474,20,3,3,2,1,0,7,0,7,5,1,7
15536,5468,5474,41,15,3,1,0,2,3,6,-3,2,4,3
15537,5468,5474,12,2,3,3,0,0,9,3,6,6,0,9
15538,5468,5474,53,8,3,1,1,1,5,4,1,3,3,4
15539,5468,5474,24,10,2,0,2,0,0,0,0,2,2,2
15540,5468,5474,57,11,3,0,2,1,3,4,-1,2,4,2
15541,5468,5474,40,12,3,0,2,1,1,2,-1,2,4,2
15542,5468,5474,43,13,3,0,2,1,3,5,-2,2,4,2
15543,5468,5474,17,5,3,2,0,1,7,2,5,4,2,6
15544,5468,5474,8,18,3,0,1,2,0,8,-8,1,5,1
15545,5468,5474,37,6,3,1,2,0,1,0,1,4,2,5
15546,5468,5474,5,9,3,1,1,1,3,3,0,3,3,4
15547,5468,5474,49,14,3,1,0,2,1,3,-2,2,4,3
15548,5916,5922,56,5,10,5,3,2,14,11,3,13,7,18
15549,5916,5922,20,13,10,3,1,6,14,17,-3,7,13,10
15550,5916,5922,41,16,10,2,2,6,10,20,-10,6,14,8
15551,5916,5922,49,4,10,5,3,2,13,8,5,13,7,18
15552,5916,5922,37,15,10,2,4,4,9,16,-7,8,12,10
15553,5916,5922,5,17,10,2,1,7,17,26,-9,5,15,7
15554,5916,5922,53,7,10,5,2,3,23,17,6,12,8,17
15555,5916,5922,12,9,10,4,3,3,13,10,3,11,9,15
15556,5916,5922,43,3,10,5,4,1,25,12,13,14,6,19
15557,5916,5922,57,10,10,3,4,3,13,19,-6,10,10,13
15558,5916,5922,22,12,10,3,1,6,11,13,-2,7,13,10
15559,5916,5922,24,18,10,1,4,5,9,18,-9,6,14,7
15560,5916,5922,21,6,10,5,3,2,12,11,1,13,7,18
15561,5916,5922,17,8,10,5,2,3,14,13,1,12,8,17
15562,5916,5922,8,11,10,3,1,6,15,15,0,7,13,10
15563,5916,5922,52,2,10,6,2,2,17,8,9,14,6,20
15564,5916,5922,27,14,10,3,1,6,9,16,-7,7,13,10
15565,5916,5922,1,1,10,6,3,1,20,8,12,15,5,21
15566,5923,5929,1,1,11,7,3,1,23,9,14,17,5,24
15567,5923,5929,27,13,11,3,2,6,9,16,-7,8,14,11
15568,5923,5929,52,2,11,6,3,2,18,9,9,15,7,21
15569,5923,5929,17,4,11,6,2,3,16,14,2,14,8,20
15570,5923,5929,8,12,11,3,2,6,16,16,0,8,14,11
15571,5923,5929,21,8,11,5,3,3,13,13,0,13,9,18
15572,5923,5929,43,5,11,5,5,1,26,13,13,15,7,20
15573,5923,5929,57,10,11,4,4,3,15,19,-4,12,10,16
15574,5923,5929,22,11,11,4,1,6,13,13,0,9,13,13
15575,5923,5929,24,18,11,1,4,6,10,21,-11,6,16,7
15576,5923,5929,53,3,11,6,2,3,26,18,8,14,8,20
15577,5923,5929,12,9,11,4,4,3,13,10,3,12,10,16
15578,5923,5929,49,6,11,5,4,2,14,9,5,14,8,19
15579,5923,5929,37,14,11,2,5,4,10,17,-7,9,13,11
15580,5923,5929,5,17,11,2,1,8,17,28,-11,5,17,7
15581,5923,5929,56,7,11,5,3,3,15,14,1,13,9,18
15582,5923,5929,20,15,11,3,1,7,14,19,-5,7,15,10
15583,5923,5929,41,16,11,2,3,6,11,21,-10,7,15,9
15584,5993,5999,43,3,20,10,6,4,45,25,20,26,14,36
15585,5993,5999,57,5,20,8,7,5,39,27,12,23,17,31
15586,5993,5999,22,12,20,7,6,7,24,21,3,20,20,27
15587,5993,5999,24,15,20,4,6,10,21,32,-11,14,26,18
15588,5993,5999,53,4,20,9,7,4,40,29,11,25,15,34
15589,5993,5999,12,7,20,8,6,6,26,20,6,22,18,30
15590,5993,5999,56,8,20,8,6,6,28,27,1,22,18,30
15591,11673,11676,27,3,3,3,0,0,8,2,6,6,0,9
15592,11673,11676,12,7,3,2,0,1,4,4,0,4,2,6
15593,11673,11676,17,11,3,1,0,2,9,6,3,2,4,3
15594,11673,11676,52,13,3,0,2,1,4,5,-1,2,4,2
15595,11673,11676,1,5,3,2,0,1,6,3,3,4,2,6
15596,12181,12187,1,2,19,10,8,1,30,14,16,28,10,38
15597,12181,12187,4,12,19,4,9,6,25,29,-4,17,21,21
15598,12181,12187,52,14,19,4,4,11,20,32,-12,12,26,16
15599,12181,12187,49,6,19,8,5,6,23,13,10,21,17,29
15600,12181,12187,37,11,19,4,9,6,21,23,-2,17,21,21
15601,12181,12187,27,3,19,11,3,5,39,26,13,25,13,36
15602,12181,12187,17,16,19,2,9,8,16,28,-12,13,25,15
15603,12181,12187,13,4,19,8,8,3,30,17,13,24,14,32
15604,12181,12187,35,8,19,7,6,6,27,25,2,20,18,27
15605,12181,12187,6,9,19,7,6,6,27,26,1,20,18,27
15606,12181,12187,41,13,19,4,8,7,21,32,-11,16,22,20
15607,12181,12187,20,17,19,3,4,12,16,38,-22,10,28,13
15608,12181,12187,43,1,19,14,4,1,51,20,31,32,6,46
15609,12181,12187,24,7,19,6,10,3,24,16,8,22,16,28
15610,12181,12187,57,15,19,3,7,9,27,43,-16,13,25,16
15611,12181,12187,22,18,19,1,5,13,22,48,-26,7,31,8
15612,12181,12187,21,5,19,8,8,3,26,18,8,24,14,32
15613,12181,12187,9,10,19,5,11,3,27,24,3,21,17,26
15614,12188,12194,43,1,20,15,4,1,53,21,32,34,6,49
15615,12188,12194,24,7,20,6,10,4,25,19,6,22,18,28
15616,12188,12194,57,15,20,4,7,9,30,43,-13,15,25,19
15617,12188,12194,22,18,20,1,5,14,22,51,-29,7,33,8
15618,12188,12194,13,4,20,9,8,3,31,17,14,26,14,35
15619,12188,12194,35,8,20,7,6,7,28,28,0,20,20,27
15620,12188,12194,6,9,20,7,6,7,27,27,0,20,20,27
15621,12188,12194,41,13,20,4,8,8,22,34,-12,16,24,20
15622,12188,12194,20,17,20,3,5,12,18,40,-22,11,29,14
15623,12188,12194,17,16,20,3,9,8,19,28,-9,15,25,18
15624,12188,12194,27,3,20,12,3,5,42,27,15,27,13,39
15625,12188,12194,49,6,20,8,5,7,23,14,9,21,19,29
15626,12188,12194,37,11,20,5,9,6,24,24,0,19,21,24
15627,12188,12194,52,14,20,5,4,11,21,32,-11,14,26,19
15628,12188,12194,21,5,20,8,8,4,26,21,5,24,16,32
15629,12188,12194,9,10,20,5,11,4,27,25,2,21,19,26
15630,12188,12194,4,12,20,4,10,6,27,31,-4,18,22,22
15631,12188,12194,1,2,20,11,8,1,31,14,17,30,10,41
15632,12279,12285,1,2,30,18,11,1,45,16,29,47,13,65
15633,12279,12285,20,17,30,4,7,19,27,57,-30,15,45,19
15634,12279,12285,49,6,30,12,10,8,39,18,21,34,26,46
15635,12279,12285,37,9,30,9,10,11,37,35,2,28,32,37
15636,12279,12285,27,3,30,16,5,9,54,43,11,37,23,53
15637,12279,12285,17,15,30,6,12,12,26,38,-12,24,36,30
15638,12279,12285,21,5,30,13,11,6,42,32,10,37,23,50
15639,12279,12285,9,7,30,10,14,6,42,34,8,34,26,44
15640,12279,12285,4,16,30,6,11,13,37,52,-15,23,37,29
15641,12279,12285,43,1,30,20,7,3,72,30,42,47,13,67
15642,12279,12285,24,8,30,8,14,8,34,36,-2,30,30,38
15643,12279,12285,57,12,30,8,10,12,46,57,-11,26,34,34
15644,12279,12285,22,18,30,3,9,18,32,71,-39,15,45,18
15645,12279,12285,52,14,30,7,10,13,29,39,-10,24,36,31
15646,12279,12285,13,4,30,13,12,5,45,24,21,38,22,51
15647,12279,12285,6,10,30,9,10,11,36,43,-7,28,32,37
15648,12279,12285,35,11,30,9,9,12,42,45,-3,27,33,36
15649,12279,12285,41,13,30,8,10,12,36,51,-15,26,34,34
15650,12510,12516,43,1,14,9,3,2,32,16,16,21,7,30
15651,12510,12516,24,6,14,6,3,5,18,17,1,15,13,21
15652,12510,12516,34,8,14,5,4,5,24,28,-4,14,14,19
15653,12510,12516,57,14,14,4,3,7,13,21,-8,11,17,15
15654,12510,12516,21,9,14,5,3,6,26,24,2,13,15,18
15655,12510,12516,4,10,14,5,3,6,21,25,-4,13,15,18
15656,12510,12516,9,17,14,3,2,9,15,31,-16,8,20,11
15657,12510,12516,13,5,14,6,5,3,24,16,8,17,11,23
15658,12510,12516,35,7,14,5,4,5,27,19,8,14,14,19
15659,12510,12516,6,12,14,5,2,7,16,19,-3,12,16,17
15660,12510,12516,41,18,14,1,5,8,16,30,-14,7,21,8
15661,12510,12516,27,16,14,3,5,6,9,19,-10,11,17,14
15662,12510,12516,49,2,14,9,3,2,24,11,13,21,7,30
15663,12510,12516,37,11,14,5,3,6,17,23,-6,13,15,18
15664,12510,12516,17,4,14,8,2,4,29,18,11,18,10,26
15665,12510,12516,52,13,14,3,7,4,14,17,-3,13,15,16
15666,12510,12516,28,15,14,3,6,5,13,19,-6,12,16,15
15667,12510,12516,1,3,14,8,3,3,30,15,15,19,9,27
15668,12587,12593,1,3,23,14,5,4,53,22,31,33,13,47
15669,12587,12593,21,12,23,8,4,11,34,36,-2,20,26,28
15670,12615,12628,24,10,27,9,7,11,31,35,-4,25,29,34
15671,12615,12628,57,16,27,6,7,14,31,46,-15,19,35,25
15672,12615,12628,28,9,27,8,11,8,28,31,-3,27,27,35
15673,12615,12628,52,12,27,8,9,10,30,32,-2,25,29,33
15674,12615,12628,4,11,27,9,6,12,34,42,-8,24,30,33
15675,12615,12628,21,15,27,8,5,14,38,46,-8,21,33,29
15676,12615,12628,9,18,27,3,8,16,26,65,-39,14,40,17
15677,12615,12628,49,2,27,18,6,3,43,19,24,42,12,60
15678,12615,12628,37,13,27,8,9,10,32,38,-6,25,29,33
15679,12615,12628,1,3,27,17,5,5,57,23,34,39,15,56
15680,12615,12628,27,14,27,8,9,10,25,34,-9,25,29,33
15681,12615,12628,35,6,27,10,10,7,46,30,16,30,24,40
15682,12615,12628,6,7,27,10,8,9,33,32,1,28,26,38
15683,12615,12628,13,8,27,9,8,10,40,36,4,26,28,35
15684,12615,12628,41,17,27,4,6,17,28,55,-27,14,40,18
15685,12958,12964,17,3,25,10,9,6,38,30,8,29,21,39
15686,12958,12964,1,1,25,18,5,2,62,23,39,41,9,59
15687,12958,12964,21,11,25,9,6,10,31,32,-1,24,26,33
15688,12958,12964,4,12,25,8,8,9,30,37,-7,24,26,32
15689,12958,12964,27,10,25,8,10,7,43,41,2,26,24,34
15690,12958,12964,52,7,25,9,10,6,27,24,3,28,22,37
15691,12958,12964,28,15,25,7,6,12,29,45,-16,20,30,27
15692,12958,12964,49,5,25,9,10,6,37,30,7,28,22,37
15693,12958,12964,37,17,25,4,7,14,24,41,-17,15,35,19
15694,12958,12964,35,4,25,10,7,8,39,30,9,27,23,37
15695,12958,12964,6,9,25,10,5,10,29,35,-6,25,25,35
15696,12958,12964,13,16,25,6,4,15,29,52,-23,16,34,22
15697,12958,12964,20,18,25,3,7,15,22,52,-30,13,37,16
15698,12958,12964,43,2,25,17,3,5,67,26,41,37,13,54
15699,12958,12964,57,6,25,9,10,6,40,35,5,28,22,37
15700,12958,12964,24,8,25,10,5,10,30,36,-6,25,25,35
15701,12958,12964,34,13,25,8,7,10,37,38,-1,23,27,31
15702,12958,12964,47,14,25,9,3,13,28,35,-7,21,29,30
15703,13007,13013,47,9,31,13,4,14,37,42,-5,30,32,43
15704,13007,13013,43,2,31,21,4,6,79,34,45,46,16,67
15705,13007,13013,24,10,31,11,7,13,34,42,-8,29,33,40
15706,13007,13013,57,11,31,10,10,11,44,44,0,30,32,40
15707,13007,13013,34,14,31,9,10,12,44,47,-3,28,34,37
15708,13007,13013,35,5,31,13,8,10,45,35,10,34,28,47
15709,13007,13013,49,8,31,11,11,9,45,42,3,33,29,44
15710,13007,13013,37,17,31,6,8,17,34,49,-15,20,42,26
15711,13007,13013,52,3,31,13,11,7,42,28,14,37,25,50
15712,13007,13013,28,13,31,10,7,14,39,53,-14,27,35,37
15713,13007,13013,27,7,31,11,11,9,51,48,3,33,29,44
15714,13007,13013,21,12,31,10,8,13,36,44,-8,28,34,38
15715,13007,13013,4,15,31,8,11,12,35,47,-12,27,35,35
15716,13007,13013,1,1,31,24,5,2,79,26,53,53,9,77
15717,13007,13013,17,4,31,13,10,8,50,38,12,36,26,49
15718,13007,13013,6,6,31,13,5,13,38,42,-4,31,31,44
15719,13007,13013,13,16,31,8,5,18,33,66,-33,21,41,29
15720,13007,13013,20,18,31,3,9,19,27,65,-38,15,47,18
15721,13217,13223,6,9,14,6,4,4,25,24,1,16,12,22
15722,13217,13223,35,13,14,4,3,7,18,21,-3,11,17,15
15723,13217,13223,12,10,14,5,3,6,23,24,-1,13,15,18
15724,13217,13223,27,12,14,5,2,7,22,23,-1,12,16,17
15725,13217,13223,49,1,14,10,0,4,28,16,12,20,8,30
15726,13217,13223,21,7,14,7,1,6,23,23,0,15,13,22
15727,13217,13223,4,14,14,4,3,7,23,30,-7,11,17,15
15728,13217,13223,33,3,14,7,5,2,23,13,10,19,9,26
15729,13217,13223,52,8,14,6,4,4,15,13,2,16,12,22
15730,13217,13223,28,17,14,2,4,8,19,33,-14,8,20,10
15731,13217,13223,43,6,14,6,5,3,22,12,10,17,11,23
15732,13217,13223,22,11,14,4,6,4,16,19,-3,14,14,18
15733,13217,13223,24,15,14,3,5,6,16,23,-7,11,17,14
15734,13217,13223,34,16,14,2,6,6,16,25,-9,10,18,12
15735,13217,13223,57,18,14,0,4,10,13,33,-20,4,24,4
15736,13217,13223,47,4,14,7,3,4,25,17,8,17,11,24
15737,13217,13223,17,5,14,6,6,2,22,13,9,18,10,24
15738,13217,13223,1,2,14,8,4,2,27,14,13,20,8,28
15739,13490,13496,47,7,1,0,1,0,1,1,0,1,1,1
15740,13490,13496,35,5,1,1,0,0,3,1,2,2,0,3
15741,13490,13496,6,7,1,0,1,0,1,1,0,1,1,1
15742,13490,13496,33,7,1,0,1,0,1,1,0,1,1,1
15743,13490,13496,52,14,1,0,0,1,1,3,-2,0,2,0
15744,13490,13496,28,15,1,0,0,1,1,4,-3,0,2,0
15745,13490,13496,22,1,1,1,0,0,4,0,4,2,0,3
15746,13490,13496,43,6,1,1,0,0,1,0,1,2,0,3
15747,13490,13496,34,11,1,0,1,0,0,0,0,1,1,1
15748,13490,13496,21,13,1,0,0,1,0,1,-1,0,2,0
15749,16899,16905,42,13,16,4,4,8,13,20,-7,12,20,16
15750,16899,16905,17,18,16,0,3,13,9,33,-24,3,29,3
15751,16899,16905,12,16,16,3,7,6,12,19,-7,13,19,16
15752,16899,16905,27,5,16,8,5,3,23,16,7,21,11,29
15753,16899,16905,45,11,16,4,6,6,19,23,-4,14,18,18
15754,16899,16905,22,1,16,11,4,1,35,15,20,26,6,37
15755,16899,16905,43,2,16,10,4,2,29,16,13,24,8,34
15756,16899,16905,51,9,16,5,5,6,26,28,-2,15,17,20
15757,16899,16905,49,6,16,8,4,4,30,20,10,20,12,28
15758,16899,16905,37,14,16,4,4,8,14,23,-9,12,20,16
15759,16899,16905,46,15,16,3,7,6,15,19,-4,13,19,16
15760,16899,16905,33,10,16,4,7,5,23,27,-4,15,17,19
15761,16899,16905,57,17,16,4,3,9,13,18,-5,11,21,15
15762,16899,16905,1,3,16,9,4,3,35,18,17,22,10,31
15763,16899,16905,28,12,16,5,2,9,21,25,-4,12,20,17
15764,16899,16905,35,8,16,6,4,6,19,23,-4,16,16,22
15765,16899,16905,25,7,16,7,4,5,22,20,2,18,14,25
15766,16899,16905,4,4,16,9,3,4,27,22,5,21,11,30
15767,16773,16786,4,18,2,0,0,2,1,8,-7,0,4,0
15768,16773,16786,35,11,2,1,0,1,1,1,0,2,2,3
15769,16773,16786,42,9,2,1,0,1,2,1,1,2,2,3
15770,16773,16786,17,13,2,0,1,1,0,3,-3,1,3,1
15771,16773,16786,33,3,2,2,0,0,5,2,3,4,0,6
15772,16773,16786,28,16,2,0,0,2,2,6,-4,0,4,0
15773,16773,16786,1,8,2,1,0,1,7,3,4,2,2,3
15774,16773,16786,46,5,2,2,0,0,2,0,2,4,0,6
15775,16773,16786,49,14,2,0,0,2,2,4,-2,0,4,0
15776,16773,16786,37,17,2,0,0,2,0,4,-4,0,4,0
15777,16773,16786,22,1,2,2,0,0,6,1,5,4,0,6
15778,16773,16786,43,3,2,2,0,0,5,2,3,4,0,6
15779,16773,16786,51,10,2,1,0,1,4,4,0,2,2,3
15780,16773,16786,57,12,2,0,1,1,1,2,-1,1,3,1
15781,16773,16786,27,6,2,1,1,0,2,1,1,3,1,4
15782,16773,16786,45,15,2,0,0,2,1,4,-3,0,4,0
15783,16773,16786,25,2,2,2,0,0,5,1,4,4,0,6
15784,16773,16786,12,6,2,1,1,0,2,1,1,3,1,4
15785,16962,16968,25,7,21,9,4,8,26,26,0,22,20,31
15786,16962,16968,12,16,21,4,8,9,17,27,-10,16,26,20
15787,16962,16968,42,15,21,5,5,11,18,29,-11,15,27,20
15788,16962,16968,17,18,21,3,3,15,14,39,-25,9,33,12
15789,16962,16968,27,6,21,9,6,6,27,24,3,24,18,33
15790,16962,16968,45,10,21,6,7,8,25,29,-4,19,23,25
15791,16962,16968,49,3,21,12,4,5,43,27,16,28,14,40
15792,16962,16968,46,12,21,5,9,7,23,26,-3,19,23,24
15793,16962,16968,37,17,21,4,5,12,18,34,-16,13,29,17
15794,16962,16968,1,5,21,10,6,5,39,22,17,26,16,36
15795,16962,16968,22,1,21,14,5,2,47,20,27,33,9,47
15796,16962,16968,43,2,21,14,5,2,41,20,21,33,9,47
15797,16962,16968,51,8,21,8,7,6,33,31,2,23,19,31
15798,16962,16968,57,13,21,6,4,11,16,24,-8,16,26,22
15799,16962,16968,4,4,21,12,4,5,35,24,11,28,14,40
15800,16962,16968,35,9,21,7,6,8,26,32,-6,20,22,27
15801,16962,16968,28,11,21,7,3,11,28,33,-5,17,25,24
15802,16962,16968,33,14,21,5,7,9,29,38,-9,17,25,22
15803,16787,16793,4,17,3,0,1,2,2,9,-7,1,5,1
15804,16787,16793,35,8,3,2,0,1,3,2,1,4,2,6
15805,16787,16793,42,11,3,1,0,2,3,3,0,2,4,3
15806,16787,16793,17,16,3,0,1,2,1,5,-4,1,5,1
15807,16787,16793,1,6,3,2,0,1,9,3,6,4,2,6
15808,16787,16793,33,3,3,2,1,0,7,4,3,5,1,7
15809,16787,16793,28,15,3,0,1,2,4,8,-4,1,5,1
15810,16787,16793,46,4,3,2,1,0,4,2,2,5,1,7
15811,16787,16793,49,13,3,0,1,2,3,5,-2,1,5,1
15812,16787,16793,37,18,3,0,0,3,0,6,-6,0,6,0
15813,16787,16793,27,4,3,2,1,0,4,2,2,5,1,7
15814,16787,16793,45,12,3,1,0,2,3,5,-2,2,4,3
15815,16787,16793,43,1,3,3,0,0,9,5,4,6,0,9
15816,16787,16793,22,2,3,2,1,0,7,2,5,5,1,7
15817,16787,16793,51,10,3,1,1,1,6,6,0,3,3,4
15818,16787,16793,57,14,3,0,1,2,2,4,-2,1,5,1
15819,16787,16793,25,7,3,2,0,1,8,5,3,4,2,6
15820,16787,16793,12,9,3,1,2,0,3,2,1,4,2,5
15821,16829,16842,25,5,8,4,2,2,12,8,4,10,6,14
15822,16829,16842,12,14,8,2,3,3,7,9,-2,7,9,9
15823,16829,16842,42,7,8,3,2,3,8,6,2,8,8,11
15824,16829,16842,17,18,8,0,1,7,4,17,-13,1,15,1
15825,16829,16842,49,8,8,3,2,3,11,10,1,8,8,11
15826,16829,16842,46,11,8,3,1,4,7,8,-1,7,9,10
15827,16829,16842,37,17,8,2,1,5,6,12,-6,5,11,7
15828,16829,16842,33,9,8,3,2,3,12,15,-3,8,8,11
15829,16829,16842,28,16,8,2,1,5,9,13,-4,5,11,7
15830,5993,5999,20,11,20,8,3,9,30,29,1,19,21,27
15831,5993,5999,41,17,20,3,4,13,12,49,-37,10,30,13
15832,5993,5999,49,10,20,7,7,6,19,18,1,21,19,28
15833,5993,5999,37,13,20,5,8,7,19,25,-6,18,22,23
15834,5993,5999,17,9,20,8,5,7,25,24,1,21,19,29
15835,5993,5999,8,14,20,6,4,10,26,32,-6,16,24,22
15836,5993,5999,5,18,20,2,5,13,23,42,-19,9,31,11
15837,5993,5999,21,6,20,8,7,5,29,27,2,23,17,31
15838,5993,5999,52,2,20,11,5,4,30,19,11,27,13,38
15839,5993,5999,27,16,20,4,6,10,15,27,-12,14,26,18
15840,5993,5999,1,1,20,13,4,3,42,20,22,30,10,43
15841,5863,5866,27,13,3,1,0,2,3,4,-1,2,4,3
15842,5863,5866,21,4,3,2,1,0,5,3,2,5,1,7
15843,5863,5866,17,10,3,1,1,1,3,6,-3,3,3,4
15844,5863,5866,8,18,3,0,0,3,2,6,-4,0,6,0
15845,5863,5866,1,2,3,2,1,0,5,2,3,5,1,7
15846,5863,5866,49,11,3,1,1,1,2,5,-3,3,3,4
15847,5863,5866,5,12,3,1,0,2,7,5,2,2,4,3
15848,5863,5866,37,15,3,0,2,1,2,3,-1,2,4,2
15849,5863,5866,52,6,3,1,2,0,2,1,1,4,2,5
15850,5863,5866,53,1,3,2,1,0,11,5,6,5,1,7
15851,5863,5866,12,5,3,2,0,1,3,1,2,4,2,6
15852,5863,5866,57,3,3,2,1,0,4,1,3,5,1,7
15853,5863,5866,24,9,3,1,1,1,2,3,-1,3,3,4
15854,5863,5866,43,14,3,0,3,0,3,3,0,3,3,3
15855,5863,5866,22,17,3,0,0,3,1,4,-3,0,6,0
15856,5863,5866,56,6,3,1,2,0,2,1,1,4,2,5
15857,5863,5866,41,8,3,1,1,1,3,3,0,3,3,4
15858,5863,5866,20,16,3,0,1,2,2,6,-4,1,5,1
15859,6241,6244,43,3,10,5,3,2,18,7,11,13,7,18
15860,6241,6244,22,4,10,5,3,2,19,11,8,13,7,18
15861,6241,6244,40,10,10,4,1,5,13,17,-4,9,11,13
15862,6241,6244,57,16,10,2,3,5,9,19,-10,7,13,9
15863,6241,6244,56,8,10,4,2,4,12,14,-2,10,10,14
15864,6241,6244,20,15,10,3,1,6,13,17,-4,7,13,10
15865,6241,6244,41,17,10,2,2,6,11,17,-6,6,14,8
15866,6241,6244,37,2,10,6,1,3,18,10,8,13,7,19
15867,6241,6244,49,5,10,5,3,2,20,13,7,13,7,18
15868,6241,6244,14,18,10,1,1,8,13,31,-18,3,17,4
15869,6241,6244,1,1,10,7,1,2,25,17,8,15,5,22
15870,6241,6244,17,7,10,4,4,2,11,7,4,12,8,16
15871,6241,6244,8,11,10,4,1,5,6,11,-5,9,11,13
15872,6241,6244,21,12,10,3,4,3,13,10,3,10,10,13
15873,6241,6244,27,6,10,5,1,4,13,16,-3,11,9,16
15874,6241,6244,52,13,10,3,4,3,18,17,1,10,10,13
15875,6241,6244,12,9,10,4,1,5,14,11,3,9,11,13
15876,6241,6244,53,14,10,2,6,2,16,17,-1,10,10,12
15877,6420,6426,12,12,30,9,9,12,43,39,4,27,33,36
15878,6420,6426,52,7,30,13,6,11,51,43,8,32,28,45
15879,6420,6426,27,13,30,9,5,16,33,51,-18,23,37,32
15880,6420,6426,1,1,30,20,6,4,68,43,25,46,14,66
15881,6420,6426,21,6,30,13,7,10,43,32,11,33,27,46
15882,6420,6426,17,4,30,17,5,8,57,39,18,39,21,56
15883,6420,6426,8,11,30,11,7,12,32,37,-5,29,31,40
15884,6420,6426,49,3,30,17,8,5,59,30,29,42,18,59
15885,6420,6426,37,5,30,13,9,8,38,25,13,35,25,48
15886,6420,6426,14,18,30,4,7,19,28,76,-48,15,45,19
15887,6420,6426,43,2,30,18,6,6,59,23,36,42,18,60
15888,6420,6426,22,8,30,12,8,10,45,48,-3,32,28,44
15889,6420,6426,40,16,30,7,7,16,26,58,-32,21,39,28
15890,6420,6426,57,17,30,4,8,18,21,55,-34,16,44,20
15891,6420,6426,53,9,30,10,13,7,53,38,15,33,27,43
15892,6420,6426,20,10,30,11,7,12,41,43,-2,29,31,40
15893,6420,6426,41,14,30,7,9,14,39,44,-5,23,37,30
15894,6420,6426,56,15,30,6,11,13,33,45,-12,23,37,29
15895,6217,6223,22,1,5,4,0,1,10,4,6,8,2,12
15896,6217,6223,43,2,5,3,2,0,15,5,10,8,2,11
15897,6217,6223,40,12,5,2,0,3,8,11,-3,4,6,6
15898,6217,6223,57,16,5,1,2,2,4,9,-5,4,6,5
15899,6217,6223,56,8,5,2,1,2,5,6,-1,5,5,7
15900,6217,6223,20,11,5,2,0,3,9,9,0,4,6,6
15901,6217,6223,41,17,5,0,1,4,3,8,-5,1,9,1
15902,6217,6223,49,3,5,3,1,1,13,8,5,7,3,10
15903,6217,6223,37,4,5,3,1,1,8,4,4,7,3,10
15904,6217,6223,14,18,5,0,1,4,6,12,-6,1,9,1
15905,6217,6223,52,13,5,1,3,1,7,6,1,5,5,6
15906,6217,6223,8,7,5,2,1,2,2,2,0,5,5,7
15907,6217,6223,17,9,5,2,1,2,3,5,-2,5,5,7
15908,6217,6223,21,15,5,1,2,2,4,6,-2,4,6,5
15909,6217,6223,27,10,5,2,1,2,5,8,-3,5,5,7
15910,6217,6223,12,6,5,2,1,2,5,5,0,5,5,7
15911,12587,12593,4,15,23,7,5,11,28,41,-13,19,27,26
15912,12587,12593,9,17,23,3,7,13,23,53,-30,13,33,16
15913,12587,12593,17,4,23,9,7,7,36,38,-2,25,21,34
15914,12587,12593,49,2,23,15,5,3,37,18,19,35,11,50
15915,12587,12593,37,10,23,7,8,8,30,34,-4,22,24,29
15916,12587,12593,27,11,23,7,8,8,23,30,-7,22,24,29
15917,12587,12593,35,5,23,8,9,6,40,26,14,25,21,33
15918,12587,12593,13,7,23,8,8,7,36,27,9,24,22,32
15919,12587,12593,6,8,23,8,6,9,27,30,-3,22,24,30
15920,12587,12593,41,18,23,2,6,15,24,49,-25,10,36,12
15921,12587,12593,43,1,23,17,4,2,62,24,38,38,8,55
15922,12587,12593,34,6,23,9,5,9,47,48,-1,23,23,32
15923,12587,12593,24,9,23,8,6,9,26,30,-4,22,24,30
15924,12587,12593,57,16,23,6,6,11,29,40,-11,18,28,24
15925,12587,12593,52,13,23,7,7,9,24,29,-5,21,25,28
15926,12587,12593,28,14,23,6,10,7,22,26,-4,22,24,28
15927,12664,12670,28,12,32,9,13,10,29,35,-6,31,33,40
15928,12664,12670,52,14,32,9,10,13,32,40,-8,28,36,37
15929,12664,12670,34,4,32,13,10,9,59,55,4,36,28,49
15930,12664,12670,24,13,32,10,9,13,35,43,-8,29,35,39
15931,12664,12670,57,15,32,9,9,14,41,49,-8,27,37,36
15932,12664,12670,43,1,32,21,6,5,75,31,44,48,16,69
15933,12664,12670,35,5,32,12,12,8,54,34,20,36,28,48
15934,12664,12670,13,6,32,12,9,11,52,43,9,33,31,45
15935,12664,12670,6,8,32,12,8,12,41,39,2,32,32,44
15936,12664,12670,41,17,32,5,7,20,33,64,-31,17,47,22
15937,12664,12670,27,11,32,10,10,12,31,40,-9,30,34,40
15938,12664,12670,17,7,32,12,9,11,46,49,-3,33,31,45
15939,12664,12670,49,2,32,20,8,4,49,22,27,48,16,68
15940,12664,12670,37,10,32,10,11,11,38,43,-5,31,33,41
15941,12664,12670,4,9,32,11,8,13,40,48,-8,30,34,41
15942,12664,12670,21,16,32,8,7,17,40,53,-13,23,41,31
15943,12664,12670,9,18,32,4,9,19,32,77,-45,17,47,21
15944,12664,12670,1,3,32,20,7,5,65,27,38,47,17,67
15945,12804,12810,21,14,10,3,1,6,13,17,-4,7,13,10
15946,12804,12810,4,16,10,2,3,5,14,18,-4,7,13,9
15947,12804,12810,1,1,10,7,2,1,24,8,16,16,4,23
15948,12804,12810,47,7,10,5,1,4,14,12,2,11,9,16
15949,12804,12810,49,5,10,4,5,1,18,9,9,13,7,17
15950,12804,12810,37,9,10,4,1,5,14,14,0,9,11,13
15951,12804,12810,52,6,10,4,5,1,10,8,2,13,7,17
15952,12804,12810,28,13,10,3,2,5,13,20,-7,8,12,11
15953,12804,12810,17,2,10,6,2,2,17,11,6,14,6,20
15954,12804,12810,35,10,10,3,4,3,16,13,3,10,10,13
15955,12804,12810,13,15,10,3,1,6,14,20,-6,7,13,10
15956,12804,12810,6,17,10,1,2,7,10,19,-9,4,16,5
15957,12804,12810,20,18,10,1,2,7,8,24,-16,4,16,5
15958,12804,12810,27,8,10,4,4,2,19,16,3,12,8,16
15959,12804,12810,43,3,10,6,1,3,20,11,9,13,7,19
15960,12804,12810,34,4,10,5,3,2,16,9,7,13,7,18
15961,12804,12810,24,11,10,3,3,4,14,22,-8,9,11,12
15962,12804,12810,57,12,10,2,6,2,13,16,-3,10,10,12
15963,12860,12866,43,3,16,9,3,4,35,19,16,21,11,30
15964,12860,12866,34,8,16,6,5,5,24,22,2,17,15,23
15965,12860,12866,24,9,16,6,5,5,21,25,-4,17,15,23
15966,12860,12866,57,11,16,4,9,3,21,24,-3,17,15,21
15967,12860,12866,35,10,16,5,6,5,26,19,7,16,16,21
15968,12860,12866,6,16,16,4,3,9,19,28,-9,11,21,15
15969,12860,12866,13,17,16,3,3,10,19,35,-16,9,23,12
15970,12860,12866,20,18,16,3,3,10,15,32,-17,9,23,12
15971,12860,12866,27,6,16,6,6,4,32,32,0,18,14,24
15972,12860,12866,52,4,16,7,6,3,18,14,4,20,12,27
15973,12860,12866,28,15,16,4,4,8,19,29,-10,12,20,16
15974,12860,12866,49,5,16,6,7,3,23,16,7,19,13,25
15975,12860,12866,37,14,16,4,4,8,15,21,-6,12,20,16
15976,12860,12866,47,7,16,7,2,7,20,19,1,16,16,23
15977,12860,12866,17,2,16,9,5,2,29,17,12,23,9,32
15978,12860,12866,4,12,16,5,4,7,19,24,-5,14,18,19
15979,12860,12866,21,13,16,5,3,8,22,24,-2,13,19,18
15980,12860,12866,1,1,16,10,4,2,36,13,23,24,8,34
15981,12765,12768,1,4,3,2,1,0,5,2,3,5,1,7
15982,12765,12768,21,8,3,1,1,1,5,4,1,3,3,4
15983,12765,12768,4,14,3,0,2,1,4,6,-2,2,4,2
15984,12765,12768,17,11,3,1,0,2,4,5,-1,2,4,3
15985,12765,12768,47,6,3,2,0,1,5,4,1,4,2,6
15986,12765,12768,49,1,3,3,0,0,9,2,7,6,0,9
15987,12765,12768,37,18,3,0,0,3,1,6,-5,0,6,0
15988,12765,12768,28,7,3,1,1,1,6,5,1,3,3,4
15989,12765,12768,52,9,3,1,1,1,3,4,-1,3,3,4
15990,13490,13496,4,17,1,0,0,1,0,4,-4,0,2,0
15991,13490,13496,27,17,1,0,0,1,0,4,-4,0,2,0
15992,13490,13496,49,7,1,0,1,0,1,1,0,1,1,1
15993,13490,13496,37,11,1,0,1,0,0,0,0,1,1,1
15994,13490,13496,1,1,1,1,0,0,4,0,4,2,0,3
15995,13490,13496,25,3,1,1,0,0,4,1,3,2,0,3
15996,13490,13496,12,16,1,0,0,1,0,3,-3,0,2,0
15997,13490,13496,17,4,1,1,0,0,3,0,3,2,0,3
15998,13742,13748,17,7,30,12,7,11,47,40,7,31,29,43
15999,13742,13748,35,3,30,16,6,8,55,41,14,38,22,54
16000,13742,13748,6,9,30,10,8,12,44,46,-2,28,32,38
16001,13742,13748,1,1,30,23,5,2,66,27,39,51,9,74
16002,13742,13748,27,14,30,8,9,13,40,53,-13,25,35,33
16003,13742,13748,49,10,30,9,10,11,44,43,1,28,32,37
16004,13742,13748,37,16,30,6,9,15,26,46,-20,21,39,27
16005,13742,13748,4,8,30,9,13,8,40,38,2,31,29,40
16006,13742,13748,21,18,30,5,7,18,33,58,-25,17,43,22
16007,13742,13748,22,2,30,19,6,5,62,31,31,44,16,63
16008,13742,13748,43,4,30,14,8,8,49,34,15,36,24,50
16009,13742,13748,34,13,30,8,9,13,44,55,-11,25,35,33
16010,13742,13748,12,6,30,14,4,12,61,60,1,32,28,46
16011,13742,13748,25,11,30,8,12,10,46,50,-4,28,32,36
16012,13742,13748,47,5,30,13,10,7,45,27,18,36,24,49
16013,13742,13748,28,12,30,8,11,11,27,33,-6,27,33,35
16014,13742,13748,33,15,30,8,8,14,32,43,-11,24,36,32
16015,13742,13748,52,17,30,6,6,18,31,67,-36,18,42,24
16016,13752,13755,28,14,32,8,12,12,29,36,-7,28,36,36
16017,13752,13755,33,15,32,9,8,15,35,45,-10,26,38,35
16018,13752,13755,52,17,32,7,6,19,33,72,-39,20,44,27
16019,13752,13755,47,4,32,14,10,8,48,29,19,38,26,52
16020,13752,13755,12,6,32,15,4,13,62,63,-1,34,30,49
16021,13752,13755,25,12,32,8,13,11,48,53,-5,29,35,37
16022,13752,13755,22,2,32,20,6,6,65,35,30,46,18,66
16023,13752,13755,43,5,32,14,9,9,51,37,14,37,27,51
16024,13752,13755,34,13,32,9,9,14,48,61,-13,27,37,36
16025,13752,13755,4,8,32,10,13,9,43,40,3,33,31,43
16026,13752,13755,21,18,32,5,7,20,35,64,-29,17,47,22
16027,13752,13755,49,9,32,10,10,12,49,46,3,30,34,40
16028,13752,13755,37,16,32,7,10,15,29,46,-17,24,40,31
16029,13752,13755,27,11,32,9,10,13,44,55,-11,28,36,37
16030,13752,13755,35,3,32,17,6,9,57,44,13,40,24,57
16031,13752,13755,6,10,32,10,9,13,44,48,-4,29,35,39
16032,13752,13755,1,1,32,25,5,2,71,28,43,55,9,80
16033,13752,13755,17,7,32,14,7,11,53,42,11,35,29,49
16034,13966,13972,35,12,16,6,3,7,26,26,0,15,17,21
16035,13966,13972,6,16,16,4,2,10,17,27,-10,10,22,14
16036,13966,13972,56,18,16,1,4,11,23,44,-21,6,26,7
16037,13966,13972,17,8,16,8,1,7,30,27,3,17,15,25
16038,13966,13972,12,3,16,9,4,3,36,19,17,22,10,31
16039,13966,13972,25,6,16,8,2,6,36,27,9,18,14,26
16040,13966,13972,4,9,16,6,6,4,27,31,-4,18,14,24
16041,13966,13972,27,15,16,3,6,7,22,24,-2,12,20,15
16042,13966,13972,9,17,16,1,5,10,12,39,-27,7,25,8
16043,13966,13972,49,4,16,9,1,6,23,16,7,19,13,28
16044,13966,13972,37,14,16,4,3,9,18,26,-8,11,21,15
16045,13966,13972,22,2,16,10,3,3,35,19,16,23,9,33
16046,13966,13972,43,10,16,6,5,5,26,25,1,17,15,23
16047,13966,13972,34,11,16,6,4,6,28,30,-2,16,16,22
16048,13966,13972,47,13,16,4,5,7,20,27,-7,13,19,17
16049,13966,13972,1,1,16,11,3,2,32,15,17,25,7,36
16050,13966,13972,33,5,16,7,6,3,29,25,4,20,12,27
16051,13966,13972,28,7,16,7,5,4,23,16,7,19,13,26
16052,13980,13986,33,5,18,8,7,3,36,28,8,23,13,31
16053,13980,13986,28,8,18,8,5,5,25,21,4,21,15,29
16054,13980,13986,47,13,18,4,7,7,22,29,-7,15,21,19
16055,13980,13986,22,2,18,11,4,3,40,22,18,26,10,37
16056,13980,13986,43,7,18,8,5,5,32,25,7,21,15,29
16057,13980,13986,34,12,18,6,5,7,29,34,-5,17,19,23
16058,13980,13986,4,6,18,8,6,4,30,32,-2,22,14,30
16059,13980,13986,9,17,18,2,5,11,16,43,-27,9,27,11
16060,13980,13986,27,16,18,3,7,8,23,27,-4,13,23,16
16061,13980,13986,6,15,18,4,4,10,18,28,-10,12,24,16
16062,13980,13986,56,18,18,1,5,12,23,48,-25,7,29,8
16063,13980,13986,49,3,18,10,2,6,28,18,10,22,14,32
16064,13980,13986,37,14,18,4,4,10,18,27,-9,12,24,16
16065,13980,13986,1,1,18,12,4,2,34,16,18,28,8,40
16066,13980,13986,12,4,18,9,4,5,38,24,14,22,14,31
16067,13980,13986,25,9,18,8,2,8,39,33,6,18,18,26
16068,14288,14294,27,8,9,4,2,3,14,12,2,10,8,14
16069,14288,14294,1,5,9,5,1,3,21,9,12,11,7,16
16070,14288,14294,33,11,9,3,2,4,18,18,0,8,10,11
16071,14288,14294,28,13,9,2,2,5,11,20,-9,6,12,8
16072,14288,14294,4,3,9,6,0,3,27,16,11,12,6,18
16073,14659,14665,4,8,10,5,1,4,25,20,5,11,9,16
16074,14659,14665,21,12,10,4,0,6,9,15,-6,8,12,12
16075,14659,14665,33,7,10,5,1,4,22,12,10,11,9,16
16076,14659,14665,28,15,10,1,3,6,9,20,-11,5,15,6
16077,14659,14665,27,5,10,6,0,4,18,20,-2,12,8,18
16078,14659,14665,17,4,10,6,1,3,21,14,7,13,7,19
16079,14659,14665,25,6,10,5,2,3,19,18,1,12,8,17
16080,14659,14665,43,2,10,8,2,0,30,13,17,18,2,26
16081,14659,14665,22,10,10,3,4,3,14,11,3,10,10,13
16082,14659,14665,37,13,10,3,2,5,9,19,-10,8,12,11
16083,14659,14665,12,11,10,3,4,3,12,12,0,10,10,13
16084,14659,14665,40,16,10,1,3,6,8,21,-13,5,15,6
16085,14659,14665,24,17,10,1,2,7,14,26,-12,4,16,5
16086,14659,14665,34,18,10,1,1,8,7,29,-22,3,17,4
16087,14659,14665,47,14,10,2,1,7,13,31,-18,5,15,7
16088,14659,14665,35,9,10,5,0,5,18,17,1,10,10,15
16089,14659,14665,49,3,10,7,1,2,31,12,19,15,5,22
16090,14659,14665,1,1,10,10,0,0,39,8,31,20,0,30
16091,14666,14679,35,9,11,5,0,6,19,19,0,10,12,15
16092,14666,14679,47,15,11,2,1,8,15,35,-20,5,17,7
16093,14666,14679,43,2,11,9,2,0,38,13,25,20,2,29
16094,14666,14679,22,11,11,3,5,3,15,12,3,11,11,14
16095,14666,14679,49,3,11,8,1,2,33,13,20,17,5,25
16096,14666,14679,37,10,11,4,2,5,11,20,-9,10,12,14
16097,14666,14679,34,16,11,2,1,8,11,31,-20,5,17,7
16098,14666,14679,40,17,11,1,3,7,9,23,-14,5,17,6
16099,14666,14679,24,18,11,1,2,8,14,27,-13,4,18,5
16100,14666,14679,25,8,11,5,2,4,19,20,-1,12,10,17
16101,14666,14679,12,12,11,3,4,4,12,20,-8,10,12,13
16102,14666,14679,17,6,11,6,1,4,22,18,4,13,9,19
16103,14666,14679,27,4,11,7,0,4,20,21,-1,14,8,21
16104,14666,14679,33,5,11,6,1,4,26,13,13,13,9,19
16105,14666,14679,28,14,11,2,3,6,10,20,-10,7,15,9
16106,14666,14679,1,1,11,11,0,0,41,8,33,22,0,33
16107,14666,14679,4,7,11,5,2,4,26,21,5,12,10,17
16108,14666,14679,21,13,11,4,0,7,10,17,-7,8,14,12
16109,14757,14763,33,6,20,10,4,6,44,29,15,24,16,34
16110,14757,14763,28,16,20,3,4,13,20,39,-19,10,30,13
16111,14757,14763,27,7,20,10,3,7,36,34,2,23,17,33
16112,14757,14763,25,5,20,10,5,5,37,30,7,25,15,35
16113,14757,14763,12,10,20,7,7,6,29,30,-1,21,19,28
16114,14757,14763,49,3,20,11,5,4,50,24,26,27,13,38
16115,14757,14763,37,11,20,7,5,8,19,40,-21,19,21,26
16116,14757,14763,4,4,20,10,5,5,40,31,9,25,15,35
16117,14757,14763,21,13,20,7,2,11,25,30,-5,16,24,23
16118,14757,14763,43,2,20,16,4,0,58,18,40,36,4,52
16119,14757,14763,22,12,20,6,6,8,26,27,-1,18,22,24
16120,14757,14763,34,14,20,4,4,12,21,46,-25,12,28,16
16121,14757,14763,24,17,20,2,5,13,27,48,-21,9,31,11
16122,14757,14763,40,18,20,1,6,13,13,40,-27,8,32,9
16123,14757,14763,47,15,20,4,1,15,24,60,-36,9,31,13
16124,14757,14763,35,9,20,9,2,9,35,30,5,20,20,29
16125,14757,14763,17,8,20,9,4,7,32,27,5,22,18,31
16126,14757,14763,1,1,20,17,2,1,61,14,47,36,4,53
16127,14603,14612,35,12,3,1,0,2,1,5,-4,2,4,3
16128,14603,14612,47,16,3,0,1,2,5,11,-6,1,5,1
16129,14603,14612,43,3,3,2,1,0,6,3,3,5,1,7
16130,14603,14612,22,9,3,1,2,0,5,3,2,4,2,5
16131,14603,14612,40,14,3,0,2,1,2,5,-3,2,4,2
16132,14603,14612,24,15,3,0,1,2,2,7,-5,1,5,1
16133,14603,14612,34,18,3,0,0,3,3,10,-7,0,6,0
16134,14603,14612,4,8,3,2,0,1,8,8,0,4,2,6
16135,14603,14612,21,17,3,0,0,3,1,4,-3,0,6,0
16136,14603,14612,25,7,3,2,0,1,5,4,1,4,2,6
16137,14603,14612,12,10,3,1,1,1,3,3,0,3,3,4
16138,14603,14612,27,2,3,3,0,0,8,1,7,6,0,9
16139,14603,14612,17,6,3,2,0,1,4,2,2,4,2,6
16140,14603,14612,33,4,3,2,0,1,9,3,6,4,2,6
16141,14603,14612,28,13,3,0,2,1,2,3,-1,2,4,2
16142,14603,14612,1,1,3,3,0,0,11,4,7,6,0,9
16143,14603,14612,49,5,3,2,0,1,7,4,3,4,2,6
16144,14603,14612,37,11,3,1,0,2,3,5,-2,2,4,3
16145,14841,14847,49,3,30,15,10,5,67,36,31,40,20,55
16146,14841,14847,37,13,30,8,8,14,26,56,-30,24,36,32
16147,14841,14847,4,5,30,14,8,8,53,43,10,36,24,50
16148,16829,16842,22,1,8,6,2,0,19,7,12,14,2,20
16149,16829,16842,43,2,8,5,2,1,15,11,4,12,4,17
16150,16829,16842,57,11,8,3,1,4,7,8,-1,7,9,10
16151,16829,16842,51,13,8,2,3,3,16,17,-1,7,9,9
16152,16829,16842,35,6,8,4,1,3,11,8,3,9,7,13
16153,16829,16842,4,10,8,3,2,3,12,16,-4,8,8,11
16154,16829,16842,27,4,8,4,3,1,12,9,3,11,5,15
16155,16829,16842,45,15,8,2,2,4,10,12,-2,6,10,8
16156,16829,16842,1,3,8,5,1,2,15,7,8,11,5,16
16157,17256,17262,35,4,14,7,3,4,21,13,8,17,11,24
16158,17256,17262,12,11,14,5,5,4,12,11,1,15,13,20
16159,17256,17262,25,12,14,5,3,6,18,14,4,13,15,18
16160,17256,17262,42,16,14,2,3,9,16,26,-10,7,21,9
16161,17256,17262,33,7,14,6,4,4,22,15,7,16,12,22
16162,17256,17262,28,18,14,2,1,11,10,29,-19,5,23,7
16163,17256,17262,1,1,14,9,4,1,21,11,10,22,6,31
16164,17256,17262,49,2,14,8,6,0,28,10,18,22,6,30
16165,17256,17262,46,14,14,3,2,9,12,26,-14,8,20,11
16166,17256,17262,23,17,14,2,3,9,10,26,-16,7,21,9
16167,17256,17262,4,9,14,5,6,3,26,16,10,16,12,21
16168,17256,17262,57,3,14,7,4,3,28,14,14,18,10,25
16169,17256,17262,43,5,14,6,6,2,19,13,6,18,10,24
16170,17256,17262,22,6,14,6,5,3,16,17,-1,17,11,23
16171,17256,17262,51,13,14,4,5,5,19,28,-9,13,15,17
16172,17256,17262,24,15,14,2,5,7,19,28,-9,9,19,11
16173,17256,17262,45,8,14,6,3,5,20,21,-1,15,13,21
16174,17256,17262,27,10,14,6,2,6,16,15,1,14,14,20
16175,17354,17360,57,3,25,14,6,5,53,25,28,34,16,48
16176,17354,17360,43,4,25,13,7,5,36,24,12,33,17,46
16177,17354,17360,24,9,25,8,7,10,32,36,-4,23,27,31
16178,17354,17360,22,10,25,8,7,10,34,39,-5,23,27,31
16179,17354,17360,51,13,25,6,9,10,29,40,-11,21,29,27
16180,17354,17360,25,8,25,8,8,9,34,28,6,24,26,32
16181,17354,17360,12,14,25,5,12,8,20,25,-5,22,28,27
16182,17354,17360,49,1,25,15,10,0,47,16,31,40,10,55
16183,17354,17360,23,15,25,7,5,13,26,42,-16,19,31,26
16184,17354,17360,46,18,25,4,4,17,21,53,-32,12,38,16
16185,17354,17360,1,2,25,15,6,4,33,19,14,36,14,51
16186,17354,17360,33,12,25,7,6,12,27,33,-6,20,30,27
16187,17354,17360,28,17,25,4,7,14,21,41,-20,15,35,19
16188,17354,17360,42,16,25,5,7,13,27,39,-12,17,33,22
16189,17354,17360,4,6,25,12,8,5,47,31,16,32,18,44
16190,17354,17360,35,5,25,13,6,6,37,21,16,32,18,45
16191,17354,17360,45,7,25,10,5,10,33,39,-6,25,25,35
16192,17354,17360,27,11,25,8,6,11,25,31,-6,22,28,30
16193,17389,17395,35,5,30,14,6,10,40,29,11,34,26,48
16194,17389,17395,4,7,30,12,8,10,51,44,7,32,28,44
16195,17389,17395,27,8,30,12,6,12,35,37,-2,30,30,42
16196,17389,17395,45,9,30,12,6,12,40,47,-7,30,30,42
16197,17389,17395,42,16,30,7,9,14,35,42,-7,23,37,30
16198,17389,17395,1,3,30,18,6,6,40,28,12,42,18,60
16199,17389,17395,33,14,30,9,6,15,33,41,-8,24,36,33
16200,17389,17395,28,17,30,5,8,17,26,49,-23,18,42,23
16201,17389,17395,49,1,30,19,11,0,53,17,36,49,11,68
16202,17389,17395,23,15,30,8,6,16,31,50,-19,22,38,30
16203,17389,17395,46,18,30,4,6,20,25,60,-35,14,46,18
16204,17389,17395,25,6,30,12,8,10,42,30,12,32,28,44
16205,17389,17395,12,12,30,7,14,9,24,28,-4,28,32,35
16206,17389,17395,43,2,30,18,7,5,51,27,24,43,17,61
16207,17389,17395,57,4,30,15,8,7,56,29,27,38,22,53
16208,17389,17395,22,10,30,10,8,12,48,50,-2,28,32,38
16209,17389,17395,24,11,30,9,9,12,37,43,-6,27,33,36
16210,17389,17395,51,13,30,8,10,12,32,48,-16,26,34,34
16211,17718,17724,25,7,25,10,7,8,28,27,1,27,23,37
16212,17718,17724,12,8,25,9,10,6,31,24,7,28,22,37
16213,17718,17724,43,1,25,18,3,4,60,26,34,39,11,57
16214,17718,17724,22,4,25,13,4,8,40,35,5,30,20,43
16215,17718,17724,57,9,25,10,5,10,36,41,-5,25,25,35
16216,17718,17724,24,11,25,8,9,8,35,40,-5,25,25,33
16217,17718,17724,51,16,25,5,5,15,26,47,-21,15,35,20
16218,17718,17724,32,17,25,5,3,17,25,62,-37,13,37,18
16219,17718,17724,45,6,25,11,5,9,40,31,9,27,23,38
16220,17718,17724,27,14,25,7,6,12,32,40,-8,20,30,27
16221,17718,17724,49,2,25,17,4,4,50,23,27,38,12,55
16222,17718,17724,23,15,25,5,6,14,33,46,-13,16,34,21
16223,17718,17724,1,3,25,14,5,6,44,32,12,33,17,47
16224,17718,17724,42,18,25,3,8,14,26,40,-14,14,36,17
16225,17718,17724,4,5,25,11,6,8,50,35,15,28,22,39
16226,6217,6223,53,14,5,1,3,1,7,7,0,5,5,6
16227,6217,6223,1,5,5,3,1,1,12,11,1,7,3,10
16228,6644,6650,1,9,12,4,6,2,15,11,4,14,10,18
16229,6644,6650,12,11,12,4,4,4,10,13,-3,12,12,16
16230,6644,6650,52,8,12,5,3,4,19,17,2,13,11,18
16231,6644,6650,27,12,12,4,2,6,13,20,-7,10,14,14
16232,6644,6650,21,4,12,5,5,2,14,8,6,15,9,20
16233,6644,6650,19,3,12,5,6,1,12,6,6,16,8,21
16234,6644,6650,17,5,12,6,1,5,18,17,1,13,11,19
16235,6644,6650,8,10,12,4,5,3,15,16,-1,13,11,17
16236,6644,6650,48,17,12,1,6,5,9,19,-10,8,16,9
16237,6644,6650,37,2,12,6,4,2,20,8,12,16,8,22
16238,6644,6650,49,6,12,5,4,3,21,15,6,14,10,19
16239,6644,6650,53,7,12,5,3,4,17,12,5,13,11,18
16240,6644,6650,20,13,12,3,5,4,11,14,-3,11,13,14
16241,6644,6650,43,1,12,7,1,4,27,17,10,15,9,22
16242,6644,6650,41,16,12,3,1,8,13,24,-11,7,17,10
16243,6644,6650,56,18,12,1,4,7,6,18,-12,6,18,7
16244,6644,6650,40,14,12,3,4,5,20,21,-1,10,14,13
16245,6644,6650,22,15,12,3,4,5,11,15,-4,10,14,13
16246,6609,6615,43,1,7,6,0,1,21,7,14,12,2,18
16247,6609,6615,40,11,7,2,3,2,14,11,3,7,7,9
16248,6609,6615,22,16,7,1,2,4,6,11,-5,4,10,5
16249,6609,6615,20,9,7,2,4,1,9,9,0,8,6,10
16250,6609,6615,41,10,7,3,0,4,8,13,-5,6,8,9
16251,6609,6615,56,18,7,0,2,5,3,13,-10,2,12,2
16252,6609,6615,17,7,7,3,1,3,9,10,-1,7,7,10
16253,6609,6615,53,2,7,4,1,2,12,3,9,9,5,13
16254,6609,6615,12,6,7,3,2,2,6,6,0,8,6,11
16255,6609,6615,37,4,7,3,3,1,13,5,8,9,5,12
16256,6609,6615,49,12,7,2,3,2,10,8,2,7,7,9
16257,6609,6615,19,8,7,2,4,1,6,5,1,8,6,10
16258,6609,6615,8,14,7,2,3,2,7,11,-4,7,7,9
16259,6609,6615,21,5,7,3,2,2,10,7,3,8,6,11
16260,6609,6615,27,3,7,4,0,3,10,12,-2,8,6,12
16261,6609,6615,52,15,7,2,1,4,9,14,-5,5,9,7
16262,6609,6615,48,17,7,0,4,3,3,11,-8,4,10,4
16263,6609,6615,1,13,7,2,3,2,9,9,0,7,7,9
16264,7008,7014,12,2,13,9,2,2,24,7,17,20,6,29
16265,7008,7014,53,7,13,6,5,2,17,13,4,17,9,23
16266,7008,7014,27,14,13,3,1,9,8,27,-19,7,19,10
16267,7008,7014,59,17,13,2,2,9,9,27,-18,6,20,8
16268,7008,7014,21,13,13,2,6,5,10,13,-3,10,16,12
16269,7008,7014,17,8,13,6,1,6,22,20,2,13,13,19
16270,7008,7014,8,16,13,2,3,8,12,19,-7,7,19,9
16271,7008,7014,19,18,13,1,5,7,12,24,-12,7,19,8
16272,7008,7014,1,1,13,9,2,2,28,8,20,20,6,29
16273,7008,7014,49,3,13,8,3,2,37,15,22,19,7,27
16274,7008,7014,37,9,13,4,6,3,15,15,0,14,12,18
16275,7008,7014,52,6,13,6,5,2,16,11,5,17,9,23
16276,7008,7014,48,15,13,1,7,5,16,24,-8,9,17,10
16277,7008,7014,57,4,13,7,3,3,25,16,9,17,9,24
16278,7008,7014,43,5,13,7,2,4,26,14,12,16,10,23
16279,7008,7014,22,12,13,3,4,6,11,31,-20,10,16,13
16280,7008,7014,20,10,13,3,8,2,14,13,1,14,12,17
16281,7008,7014,41,11,13,4,3,6,17,22,-5,11,15,15
16282,7120,7126,41,9,25,9,6,10,34,33,1,24,26,33
16283,7120,7126,20,12,25,7,10,8,26,31,-5,24,26,31
16284,7120,7126,17,6,25,12,4,9,48,34,14,28,22,40
16285,7120,7126,19,10,25,8,8,9,31,34,-3,24,26,32
16286,7120,7126,8,15,25,6,6,13,24,39,-15,18,32,24
16287,7120,7126,49,3,25,14,7,4,59,24,35,35,15,49
16288,7120,7126,37,8,25,8,10,7,29,31,-2,26,24,34
16289,7120,7126,43,5,25,14,4,7,50,23,27,32,18,46
16290,7120,7126,57,7,25,12,4,9,42,40,2,28,22,40
16291,7120,7126,22,14,25,7,9,9,24,48,-24,23,27,30
16292,7120,7126,52,4,25,13,8,4,39,22,17,34,16,47
16293,7120,7126,48,17,25,3,10,12,27,45,-18,16,34,19
16294,7120,7126,1,1,25,15,5,5,52,22,30,35,15,50
16295,7120,7126,21,11,25,8,7,10,33,31,2,23,27,31
16296,7120,7126,12,2,25,15,4,6,48,19,29,34,16,49
16297,7120,7126,53,13,25,7,9,9,30,33,-3,23,27,30
16298,7120,7126,27,16,25,5,5,15,15,52,-37,15,35,20
16299,7120,7126,59,18,25,2,4,19,14,64,-50,8,42,10
16300,7127,7133,27,16,26,6,5,15,17,52,-35,17,35,23
16301,7127,7133,59,18,26,2,4,20,14,65,-51,8,44,10
16302,7127,7133,12,2,26,16,4,6,50,19,31,36,16,52
16303,7127,7133,53,14,26,7,9,10,30,35,-5,23,29,30
16304,7127,7133,21,12,26,8,7,11,33,33,0,23,29,31
16305,7127,7133,1,1,26,16,5,5,56,24,32,37,15,53
16306,12765,12768,27,2,3,3,0,0,9,3,6,6,0,9
16307,12765,12768,20,10,3,1,1,1,4,6,-2,3,3,4
16308,12765,12768,35,12,3,0,2,1,4,5,-1,2,4,2
16309,12765,12768,13,16,3,0,1,2,2,7,-5,1,5,1
16310,12765,12768,6,17,3,0,0,3,1,5,-4,0,6,0
16311,12765,12768,34,3,3,3,0,0,7,1,6,6,0,9
16312,12765,12768,57,5,3,2,1,0,4,2,2,5,1,7
16313,12765,12768,24,13,3,0,2,1,5,7,-2,2,4,2
16314,12765,12768,43,15,3,0,1,2,3,7,-4,1,5,1
16315,13028,13034,21,13,33,11,9,13,38,45,-7,31,35,42
16316,13028,13034,4,15,33,9,11,13,37,49,-12,29,37,38
16317,13028,13034,35,4,33,14,8,11,48,37,11,36,30,50
16318,13028,13034,6,7,33,14,6,13,40,43,-3,34,32,48
16319,13028,13034,13,16,33,8,5,20,35,74,-39,21,45,29
16320,13028,13034,27,5,33,13,11,9,58,50,8,37,29,50
16321,13028,13034,52,3,33,13,13,7,43,29,14,39,27,52
16322,13028,13034,28,14,33,11,7,15,41,58,-17,29,37,40
16323,13028,13034,43,2,33,22,4,7,83,37,46,48,18,70
16324,13028,13034,57,9,33,12,10,11,49,46,3,34,32,46
16325,13028,13034,24,10,33,12,8,13,38,43,-5,32,34,44
16326,13028,13034,34,12,33,11,10,12,52,48,4,32,34,43
16327,13028,13034,49,8,33,12,12,9,50,46,4,36,30,48
16328,13028,13034,37,17,33,6,9,18,37,54,-17,21,45,27
16329,13028,13034,47,11,33,13,4,16,39,46,-7,30,36,43
16330,13028,13034,17,6,33,13,10,10,51,44,7,36,30,49
16331,13028,13034,1,1,33,24,6,3,80,29,51,54,12,78
16332,13028,13034,20,18,33,3,9,21,28,69,-41,15,51,18
16333,12797,12799,1,1,8,6,1,1,20,6,14,13,3,19
16334,12797,12799,21,9,8,3,1,4,12,13,-1,7,9,10
16335,12797,12799,4,15,8,1,3,4,10,15,-5,5,11,6
16336,12797,12799,47,3,8,5,1,2,14,7,7,11,5,16
16337,12797,12799,49,4,8,4,4,0,17,6,11,12,4,16
16338,12797,12799,37,10,8,3,1,4,9,12,-3,7,9,10
16339,12797,12799,52,8,8,3,4,1,9,8,1,10,6,13
16340,12797,12799,28,14,8,2,1,5,11,19,-8,5,11,7
16341,12797,12799,17,6,8,4,2,2,13,9,4,10,6,14
16342,12797,12799,35,12,8,2,3,3,12,11,1,7,9,9
16343,12797,12799,13,13,8,2,1,5,10,15,-5,5,11,7
16344,12797,12799,20,17,8,1,2,5,7,18,-11,4,12,5
16345,12797,12799,6,18,8,1,1,6,7,15,-8,3,13,4
16346,12797,12799,27,5,8,4,3,1,17,13,4,11,5,15
16347,12797,12799,34,2,8,5,2,1,15,7,8,12,4,17
16348,12797,12799,43,7,8,4,1,3,15,11,4,9,7,13
16349,12797,12799,57,11,8,2,4,2,10,13,-3,8,8,10
16350,12797,12799,24,16,8,1,3,4,11,21,-10,5,11,6
16351,13308,13314,43,4,22,10,9,3,35,15,20,29,15,39
16352,13308,13314,22,9,22,7,8,7,28,28,0,22,22,29
16353,13308,13314,24,14,22,5,8,9,24,34,-10,18,26,23
16354,13308,13314,34,16,22,4,9,9,26,37,-11,17,27,21
16355,13308,13314,57,18,22,2,6,14,23,48,-25,10,34,12
16356,13308,13314,12,11,22,7,6,9,31,34,-3,20,24,27
16357,13308,13314,27,13,22,6,5,11,26,33,-7,17,27,23
16358,13308,13314,49,6,22,11,2,9,37,31,6,24,20,35
16359,13308,13314,17,3,22,11,9,2,38,22,16,31,13,42
16360,13308,13314,47,5,22,11,5,6,36,23,13,27,17,38
16361,13308,13314,1,2,22,13,4,5,44,27,17,30,14,43
16362,13308,13314,21,7,22,11,2,9,35,33,2,24,20,35
16363,13308,13314,4,10,22,8,4,10,34,40,-6,20,24,28
16364,13308,13314,33,1,22,13,7,2,40,19,21,33,11,46
16365,13308,13314,52,12,22,7,5,10,23,29,-6,19,25,26
16366,13308,13314,28,15,22,5,6,11,30,43,-13,16,28,21
16367,13308,13314,6,8,22,9,6,7,32,34,-2,24,20,33
16368,13308,13314,35,17,22,5,5,12,26,38,-12,15,29,20
16369,13322,13328,21,5,24,12,3,9,38,35,3,27,21,39
16370,13322,13328,4,10,24,8,4,12,35,45,-10,20,28,28
16371,13322,13328,1,2,24,15,4,5,53,29,24,34,14,49
16372,13322,13328,47,6,24,11,6,7,38,26,12,28,20,39
16373,13322,13328,17,3,24,13,9,2,43,25,18,35,13,48
16374,13322,13328,49,7,24,12,2,10,41,36,5,26,22,38
16375,13322,13328,33,1,24,14,8,2,45,21,24,36,12,50
16376,13322,13328,28,11,24,7,6,11,33,43,-10,20,28,27
16377,13322,13328,52,14,24,7,5,12,23,31,-8,19,29,26
16378,13322,13328,27,15,24,7,5,12,28,37,-9,19,29,26
16379,13322,13328,6,8,24,10,6,8,35,37,-2,26,22,36
16380,13322,13328,35,13,24,7,5,12,31,38,-7,19,29,26
16381,13322,13328,12,12,24,7,6,11,34,45,-11,20,28,27
16382,13322,13328,43,4,24,11,9,4,39,19,20,31,17,42
16383,13322,13328,22,9,24,7,8,9,28,30,-2,22,26,29
16384,13322,13328,24,16,24,6,8,10,25,36,-11,20,28,26
16385,13980,13986,17,10,18,8,2,8,32,30,2,18,18,26
16386,13980,13986,35,11,18,7,4,7,32,30,2,18,18,25
16387,14015,14021,17,11,20,8,3,9,35,34,1,19,21,27
16388,14015,14021,12,4,20,10,4,6,41,27,14,24,16,34
16389,14015,14021,25,9,20,9,3,8,41,34,7,21,19,30
16390,14015,14021,1,1,20,13,4,3,37,20,17,30,10,43
16391,14015,14021,49,7,20,10,2,8,30,22,8,22,18,32
16392,14015,14021,37,16,20,4,4,12,19,33,-14,12,28,16
16393,14015,14021,35,8,20,9,4,7,35,30,5,22,18,31
16394,14015,14021,6,15,20,4,4,12,21,33,-12,12,28,16
16395,14015,14021,56,18,20,2,5,13,27,52,-25,9,31,11
16396,14015,14021,27,14,20,4,8,8,26,29,-3,16,24,20
16397,14015,14021,4,6,20,9,7,4,35,36,-1,25,15,34
16398,14015,14021,9,17,20,2,6,12,18,48,-30,10,30,12
16399,14015,14021,22,2,20,12,5,3,44,23,21,29,11,41
16400,14015,14021,43,3,20,10,5,5,38,28,10,25,15,35
16401,14015,14021,34,12,20,7,5,8,30,35,-5,19,21,26
16402,14015,14021,47,13,20,5,8,7,26,30,-4,18,22,23
16403,14015,14021,33,5,20,9,7,4,41,33,8,25,15,34
16404,14015,14021,28,10,20,8,6,6,27,24,3,22,18,30
16405,14106,14112,33,3,29,16,7,6,67,44,23,39,19,55
16406,14106,14112,28,8,29,13,7,9,46,37,9,33,25,46
16407,14106,14112,47,11,29,9,9,11,39,41,-2,27,31,36
16408,14106,14112,22,1,29,18,7,4,61,31,30,43,15,61
16409,14106,14112,43,4,29,16,7,6,55,36,19,39,19,55
16410,14106,14112,34,13,29,8,7,14,39,52,-13,23,35,31
16411,14106,14112,49,5,29,17,2,10,52,30,22,36,22,53
16412,14106,14112,37,15,29,6,5,18,28,54,-26,17,41,23
16413,14106,14112,12,6,29,14,6,9,54,49,5,34,24,48
16414,14106,14112,25,12,29,10,5,14,50,54,-4,25,33,35
16415,14106,14112,27,14,29,6,11,12,36,46,-10,23,35,29
16416,14106,14112,1,2,29,18,5,6,52,31,21,41,17,59
16417,14106,14112,4,7,29,13,8,8,49,51,-2,34,24,47
16418,14106,14112,9,18,29,2,10,17,24,65,-41,14,44,16
16419,14106,14112,17,9,29,13,6,10,57,40,17,32,26,45
16420,14106,14112,35,10,29,12,6,11,42,40,2,30,28,42
16421,14106,14112,6,16,29,5,6,18,25,46,-21,16,42,21
16422,14106,14112,56,17,29,5,6,18,41,70,-29,16,42,21
16423,14134,14217,25,12,34,11,7,16,56,62,-6,29,39,40
16424,14134,14217,4,8,34,14,10,10,55,59,-4,38,30,52
16425,14134,14217,9,18,34,4,10,20,27,79,-52,18,50,22
16426,14134,14217,27,14,34,7,11,16,40,54,-14,25,43,32
16427,14134,14217,12,5,34,17,6,11,69,61,8,40,28,57
16428,14134,14217,22,1,34,22,7,5,74,38,36,51,17,73
16429,14134,14217,43,3,34,21,7,6,76,39,37,49,19,70
16430,14134,14217,34,13,34,9,8,17,48,66,-18,26,42,35
16431,14134,14217,49,6,34,17,3,14,55,47,8,37,31,54
16432,14134,14217,37,15,34,8,6,20,33,60,-27,22,46,30
16433,14134,14217,47,11,34,10,11,13,44,46,-2,31,37,41
16434,14134,14217,1,2,34,22,5,7,65,38,27,49,19,71
16435,14134,14217,17,7,34,16,6,12,72,47,25,38,30,54
16436,14134,14217,33,4,34,19,9,6,76,47,29,47,21,66
16437,14134,14217,28,9,34,14,9,11,52,46,6,37,31,51
16438,14134,14217,35,10,34,14,7,13,48,46,2,35,33,49
16439,14134,14217,6,16,34,7,7,20,33,56,-23,21,47,28
16440,14134,14217,56,17,34,6,7,21,49,81,-32,19,49,25
16441,14379,14385,17,4,19,10,5,4,36,23,13,25,13,35
16442,14379,14385,1,2,19,12,2,5,44,17,27,26,12,38
16443,14379,14385,47,15,19,4,4,11,32,39,-7,12,26,16
16444,14379,14385,33,9,19,8,4,7,38,30,8,20,18,28
16445,14379,14385,28,16,19,4,4,11,20,40,-20,12,26,16
16446,14379,14385,49,6,19,10,2,7,36,33,3,22,16,32
16447,14379,14385,37,13,19,4,6,9,25,37,-12,14,24,18
16448,14379,14385,4,5,19,11,1,7,50,35,15,23,15,34
16449,14379,14385,43,1,19,14,4,1,49,19,30,32,6,46
16450,14379,14385,22,3,19,10,6,3,44,24,20,26,12,36
16451,14379,14385,24,10,19,8,2,9,31,45,-14,18,20,26
16452,14379,14385,34,11,19,7,2,10,36,39,-3,16,22,23
16453,14379,14385,27,14,19,4,5,10,22,37,-15,13,25,17
16454,14379,14385,25,8,19,8,5,6,39,41,-2,21,17,29
16455,14379,14385,12,12,19,6,5,8,34,41,-7,17,21,23
16456,14379,14385,58,18,19,1,9,9,13,36,-23,11,27,12
16457,14379,14385,35,7,19,9,5,5,33,27,6,23,15,32
16458,14379,14385,6,17,19,1,9,9,17,36,-19,11,27,12
16459,14400,14406,35,8,22,10,6,6,38,32,6,26,18,36
16460,14400,14406,6,18,22,1,10,11,22,47,-25,12,32,13
16461,14400,14406,17,5,22,11,5,6,41,29,12,27,17,38
16462,14400,14406,25,9,22,9,6,7,44,46,-2,24,20,33
16463,5545,5558,17,6,13,6,3,4,24,16,8,15,11,21
16464,5545,5558,8,19,12,2,2,8,8,27,-19,6,18,8
16465,5545,5558,21,9,13,5,4,4,15,19,-4,14,12,19
16466,5545,5558,37,5,13,6,4,3,15,6,9,16,10,22
16467,5545,5558,49,10,12,4,5,3,12,10,2,13,11,17
16468,5545,5558,5,12,12,2,7,3,12,13,-1,11,13,13
16469,5545,5558,12,1,13,8,2,3,23,14,9,18,8,26
16470,5545,5558,53,8,12,5,4,3,19,17,2,14,10,19
16471,5545,5558,52,7,12,6,3,3,21,13,8,15,9,21
16472,5545,5558,54,15,12,4,1,7,8,21,-13,9,15,13
16473,5545,5558,48,16,12,1,6,5,7,18,-11,8,16,9
16474,5545,5558,20,3,12,6,5,1,19,9,10,17,7,23
16475,5545,5558,41,13,12,4,3,5,20,24,-4,11,13,15
16476,5545,5558,43,4,12,6,4,2,21,12,9,16,8,22
16477,5545,5558,57,11,12,3,5,4,16,14,2,11,13,14
16478,5545,5558,40,14,13,1,7,5,13,20,-7,9,17,10
16479,5545,5558,24,17,12,1,5,6,13,20,-7,7,17,8
16480,5545,5558,27,18,13,2,3,8,12,19,-7,7,19,9
16481,5671,5677,27,16,26,6,6,14,33,47,-14,18,34,24
16482,5671,5677,52,7,26,12,8,6,39,23,16,32,20,44
16483,5671,5677,57,12,27,7,11,9,35,39,-4,25,29,32
16484,5671,5677,43,2,26,14,6,6,49,30,19,34,18,48
16485,5671,5677,24,14,27,7,8,12,31,42,-11,22,32,29
16486,5671,5677,40,15,26,4,11,11,27,45,-18,19,33,23
16487,5671,5677,41,11,26,9,8,9,44,44,0,26,26,35
16488,5671,5677,21,9,27,10,9,8,29,35,-6,29,25,39
16489,5671,5677,20,6,27,11,10,6,45,29,16,32,22,43
16490,5671,5677,12,3,27,15,3,9,49,29,20,33,21,48
16491,5671,5677,53,10,26,10,8,8,42,42,0,28,24,38
16492,5671,5677,48,18,27,3,10,14,19,43,-24,16,38,19
16493,5671,5677,54,19,26,4,5,17,14,48,-34,13,39,17
16494,5671,5677,37,4,27,11,11,5,28,13,15,33,21,44
16495,5671,5677,49,8,26,12,7,7,40,31,9,31,21,43
16496,5671,5677,5,13,26,8,9,9,32,36,-4,25,27,33
16497,5671,5677,17,5,27,13,6,8,51,34,17,32,22,45
16498,5671,5677,8,17,27,5,8,14,19,44,-25,18,36,23
16499,5671,5677,1,1,27,16,6,5,54,26,28,38,16,54
16500,5513,5516,1,4,8,4,3,1,17,9,8,11,5,15
16501,5513,5516,17,5,9,5,1,3,17,10,7,11,7,16
16502,5513,5516,8,19,8,1,1,6,6,20,-14,3,13,4
16503,5513,5516,21,3,9,5,2,2,15,15,0,12,6,17
16504,5513,5516,37,7,9,3,4,2,10,5,5,10,8,13
16505,5513,5516,49,11,9,3,3,3,7,8,-1,9,9,12
16506,5513,5516,5,12,9,1,6,2,10,11,-1,8,10,9
16507,5513,5516,52,6,8,4,2,2,16,9,7,10,6,14
16508,5513,5516,12,1,9,7,0,2,20,10,10,14,4,21
16509,5513,5516,53,8,9,4,2,3,15,15,0,10,8,14
16510,5513,5516,54,13,8,3,1,4,6,13,-7,7,9,10
16511,5513,5516,48,15,8,1,4,3,6,10,-4,6,10,7
16512,5513,5516,43,10,8,3,3,2,14,10,4,9,7,12
16513,5513,5516,57,14,8,1,4,3,11,12,-1,6,10,7
16514,5513,5516,40,16,9,1,4,4,6,11,-5,6,12,7
16515,5513,5516,24,17,8,0,4,4,4,11,-7,4,12,4
16516,5513,5516,20,2,8,5,3,0,16,5,11,13,3,18
16517,5513,5516,41,9,9,4,2,3,16,17,-1,10,8,14
16518,5513,5516,27,18,9,0,3,6,4,15,-11,3,15,3
16519,5951,5964,27,15,15,3,4,8,11,24,-13,10,20,13
16520,5951,5964,43,5,15,7,5,3,34,21,13,19,11,26
16521,5951,5964,57,8,15,6,5,4,29,21,8,17,13,23
16522,5951,5964,22,11,15,5,4,6,20,16,4,14,16,19
16523,5951,5964,24,14,15,3,4,8,14,25,-11,10,20,13
16524,5951,5964,56,6,15,7,4,4,20,19,1,18,12,25
16525,5951,5964,20,13,15,4,2,9,19,27,-8,10,20,14
16526,5951,5964,41,17,15,3,3,9,12,37,-25,9,21,12
16527,5951,5964,17,4,15,8,3,4,23,17,6,19,11,27
16528,5951,5964,8,12,15,5,3,7,22,20,2,13,17,18
16529,5951,5964,49,9,15,6,5,4,16,12,4,17,13,23
16530,5951,5964,37,16,15,2,7,6,11,21,-10,11,19,13
16531,5951,5964,5,18,15,2,3,10,18,31,-13,7,23,9
16532,5951,5964,52,2,15,8,5,2,25,13,12,21,9,29
16533,5951,5964,53,3,15,8,3,4,33,23,10,19,11,27
16534,5951,5964,12,10,15,5,5,5,18,16,2,15,15,20
16535,5951,5964,21,7,15,7,4,4,18,18,0,18,12,25
16536,5951,5964,1,1,15,10,3,2,30,12,18,23,7,33
16537,6294,6300,17,9,15,6,4,5,18,16,2,16,14,22
16538,6294,6300,8,13,15,5,2,8,12,20,-8,12,18,17
16539,6294,6300,53,7,15,5,8,2,27,21,6,18,12,23
16540,6294,6300,12,12,15,5,2,8,19,18,1,12,18,17
16541,6294,6300,49,2,15,9,3,3,32,20,12,21,9,30
16542,17718,17724,35,10,25,8,9,8,34,29,5,25,25,33
16543,17718,17724,56,13,25,7,9,9,26,38,-12,23,27,30
16544,17718,17724,33,12,25,8,8,9,33,33,0,24,26,32
16545,17963,17976,4,6,13,6,2,5,22,15,7,14,12,20
16546,17963,17976,35,5,13,6,3,4,17,16,1,15,11,21
16547,17963,17976,56,9,13,4,5,4,14,13,1,13,13,17
16548,17963,17976,45,10,13,4,5,4,20,20,0,13,13,17
16549,17963,17976,27,12,14,3,5,6,16,25,-9,11,17,14
16550,17963,17976,1,2,13,9,2,2,28,17,11,20,6,29
16551,17963,17976,49,3,13,6,6,1,24,12,12,18,8,24
16552,17963,17976,24,4,13,7,0,6,19,19,0,14,12,21
16553,17963,17976,22,8,13,4,5,4,17,15,2,13,13,17
16554,17963,17976,57,13,13,3,4,6,20,22,-2,10,16,13
16555,17963,17976,51,15,13,2,3,8,18,31,-13,7,19,9
16556,17963,17976,28,7,13,5,2,6,16,20,-4,12,14,17
16557,17963,17976,43,1,13,9,2,2,24,10,14,20,6,29
16558,17963,17976,25,11,13,3,3,7,15,24,-9,9,17,12
16559,17963,17976,12,14,13,2,3,8,12,23,-11,7,19,9
16560,18040,18046,25,11,21,5,6,10,20,30,-10,16,26,21
16561,18040,18046,28,6,22,9,5,8,28,29,-1,23,21,32
16562,18040,18046,43,1,21,16,3,2,44,17,27,35,7,51
16563,18040,18046,24,5,22,10,2,10,29,37,-8,22,22,32
16564,18040,18046,22,10,21,6,8,7,26,23,3,20,22,26
16565,18040,18046,57,12,21,6,5,10,31,33,-2,17,25,23
16566,18040,18046,51,14,21,4,3,14,26,49,-23,11,31,15
16567,18040,18046,1,2,22,14,3,5,42,28,14,31,13,45
16568,18040,18046,4,3,22,12,5,5,43,24,19,29,15,41
16569,18040,18046,45,4,21,9,6,6,32,26,6,24,18,33
16570,18040,18046,27,13,22,4,7,11,22,34,-12,15,29,19
16571,18040,18046,12,15,21,3,3,15,16,35,-19,9,33,12
16572,18040,18046,49,8,22,8,8,6,32,27,5,24,20,32
16573,18040,18046,35,7,22,9,5,8,26,29,-3,23,21,32
16574,18040,18046,56,9,21,8,7,6,26,22,4,23,19,31
16575,18096,18228,49,8,28,10,9,9,38,34,4,29,27,39
16576,18096,18228,28,5,28,12,6,10,35,35,0,30,26,42
16577,18096,18228,25,11,28,8,8,12,28,34,-6,24,32,32
16578,18096,18228,12,14,28,5,3,20,22,54,-32,13,43,18
16579,18096,18228,56,4,28,12,9,7,39,30,9,33,23,45
16580,18096,18228,35,10,28,9,8,11,30,43,-13,26,30,35
16581,18096,18228,4,3,28,14,7,7,49,30,19,35,21,49
16582,18096,18228,1,2,28,17,6,5,52,33,19,40,16,57
16583,18096,18228,43,1,28,22,3,3,62,20,42,47,9,69
16584,18096,18228,24,7,28,12,3,13,36,46,-10,27,29,39
16585,18096,18228,57,9,28,11,5,12,45,40,5,27,29,38
16586,18096,18228,22,12,28,8,10,10,33,31,2,26,30,34
16587,18096,18228,51,15,28,4,6,18,29,58,-29,14,42,18
16588,18096,18228,45,6,28,10,11,7,39,32,7,31,25,41
16589,18096,18228,27,13,28,5,8,15,28,45,-17,18,38,23
16590,18292,18305,45,12,10,2,5,3,15,16,-1,9,11,11
16591,18292,18305,27,14,10,1,3,6,6,19,-13,5,15,6
16592,18292,18305,15,16,10,0,1,9,4,22,-18,1,19,1
16593,18292,18305,12,9,10,4,3,3,14,16,-2,11,9,15
16594,18292,18305,25,10,10,4,2,4,11,11,0,10,10,14
16595,18292,18305,17,15,10,1,2,7,7,18,-11,4,16,5
16596,18292,18305,4,4,10,6,1,3,20,17,3,13,7,19
16597,18292,18305,49,3,10,6,2,2,20,10,10,14,6,20
16598,18292,18305,22,1,10,8,2,0,31,8,23,18,2,26
16599,18292,18305,43,2,10,6,3,1,23,7,16,15,5,21
16600,18292,18305,24,5,10,5,3,2,12,12,0,13,7,18
16601,18292,18305,57,8,10,4,4,2,14,14,0,12,8,16
16602,18292,18305,1,6,10,5,1,4,23,14,9,11,9,16
16603,18292,18305,56,7,10,5,1,4,12,11,1,11,9,16
16604,18292,18305,35,11,10,3,2,5,8,13,-5,8,12,11
16605,18292,18305,28,13,10,2,1,7,6,18,-12,5,15,7
16606,18376,18396,28,12,21,6,3,12,15,37,-22,15,27,21
16607,18376,18396,12,3,21,11,7,3,32,24,8,29,13,40
16608,18376,18396,56,9,21,9,4,8,24,21,3,22,20,31
16609,18376,18396,35,13,21,3,7,11,14,32,-18,13,29,16
16610,18376,18396,4,4,21,12,3,6,41,32,9,27,15,39
16611,18376,18396,17,15,21,2,7,12,17,45,-28,11,31,13
16612,18376,18396,1,6,21,10,3,8,40,29,11,23,19,33
16613,18376,18396,43,1,21,14,5,2,46,14,32,33,9,47
16614,18376,18396,22,2,21,13,5,3,52,20,32,31,11,44
16615,18376,18396,49,7,21,10,3,8,38,27,11,23,19,33
16616,18376,18396,25,11,21,6,7,8,26,30,-4,19,23,25
16617,18376,18396,45,10,21,7,9,5,32,24,8,23,19,30
16618,18376,18396,15,14,21,4,3,14,22,40,-18,11,31,15
16619,18376,18396,27,16,21,2,4,15,14,40,-26,8,34,10
16620,14841,14847,21,12,30,10,5,15,34,43,-9,25,35,35
16621,14841,14847,1,2,30,20,9,1,74,23,51,49,11,69
16622,14841,14847,33,8,30,13,7,10,57,45,12,33,27,46
16623,14841,14847,28,15,30,6,7,17,29,48,-19,19,41,25
16624,14841,14847,17,9,30,12,6,12,42,40,2,30,30,42
16625,14841,14847,12,6,30,13,9,8,46,37,9,35,25,48
16626,14841,14847,25,7,30,13,8,9,52,45,7,34,26,47
16627,14841,14847,43,1,30,21,8,1,74,24,50,50,10,71
16628,14841,14847,22,11,30,10,8,12,40,41,-1,28,32,38
16629,14841,14847,34,16,30,6,7,17,28,59,-31,19,41,25
16630,14841,14847,40,17,30,4,11,15,25,49,-24,19,41,23
16631,14841,14847,24,18,30,4,9,17,37,63,-26,17,43,21
16632,14841,14847,27,10,30,12,5,13,45,52,-7,29,31,41
16633,14841,14847,47,14,30,7,4,19,33,72,-39,18,42,25
16634,14841,14847,35,4,30,16,3,11,55,41,14,35,25,51
16635,14862,14868,35,4,33,17,3,13,61,50,11,37,29,54
16636,14862,14868,49,3,33,16,12,5,71,39,32,44,22,60
16637,14862,14868,37,13,33,9,8,16,28,61,-33,26,40,35
16638,14862,14868,47,17,33,7,4,22,33,77,-44,18,48,25
16639,14862,14868,4,6,33,15,9,9,58,48,10,39,27,54
16640,14862,14868,21,12,33,11,6,16,37,44,-7,28,38,39
16641,14862,14868,43,1,33,24,8,1,83,24,59,56,10,80
16642,14862,14868,22,11,33,11,9,13,45,45,0,31,35,42
16643,14862,14868,40,15,33,6,12,15,31,53,-22,24,42,30
16644,14862,14868,34,16,33,7,8,18,32,60,-28,22,44,29
16645,14862,14868,24,18,33,4,9,20,39,71,-32,17,49,21
16646,14862,14868,12,5,33,15,9,9,53,41,12,39,27,54
16647,14862,14868,25,7,33,15,8,10,61,52,9,38,28,53
16648,14862,14868,17,10,33,12,6,15,43,50,-7,30,36,42
16649,14862,14868,27,9,33,13,5,15,50,65,-15,31,35,44
16650,14862,14868,33,8,33,14,8,11,60,48,12,36,30,50
16651,14862,14868,28,14,33,9,7,17,43,53,-10,25,41,34
16652,14862,14868,1,2,33,22,9,2,77,24,53,53,13,75
16653,14869,14952,1,2,34,23,9,2,83,24,59,55,13,78
16654,14869,14952,33,7,34,15,8,11,63,49,14,38,30,53
16655,14869,14952,28,13,34,9,8,17,44,54,-10,26,42,35
16656,14869,14952,27,9,34,14,5,15,51,65,-14,33,35,47
16657,14869,14952,17,10,34,12,7,15,44,51,-7,31,37,43
16658,14869,14952,12,4,34,16,9,9,58,41,17,41,27,57
16659,14869,14952,25,8,34,15,8,11,61,53,8,38,30,53
16660,14869,14952,43,1,34,25,8,1,88,25,63,58,10,83
16661,14869,14952,22,11,34,11,9,14,45,51,-6,31,37,42
16662,14869,14952,40,15,34,6,12,16,32,56,-24,24,44,30
16663,14869,14952,34,16,34,7,8,19,33,65,-32,22,46,29
16664,14869,14952,24,18,34,4,10,20,40,72,-32,18,50,22
16665,14869,14952,4,5,34,16,9,9,61,49,12,41,27,57
16666,14869,14952,21,12,34,11,7,16,38,45,-7,29,39,40
16667,14869,14952,47,17,34,8,4,22,36,79,-43,20,48,28
16668,14869,14952,49,3,34,16,12,6,71,44,27,44,24,60
16669,14869,14952,37,14,34,9,8,17,30,64,-34,26,42,35
16670,14869,14952,35,6,34,17,3,14,62,53,9,37,31,54
16671,14617,14623,35,10,5,2,0,3,6,8,-2,4,6,6
16672,14617,14623,47,13,5,1,1,3,8,13,-5,3,7,4
16673,14617,14623,1,1,5,5,0,0,18,4,14,10,0,15
16674,14617,14623,4,6,5,3,1,1,10,9,1,7,3,10
16675,14617,14623,21,14,5,1,0,4,3,7,-4,2,8,3
16676,14617,14623,43,2,5,4,1,0,16,5,11,9,1,13
16677,14617,14623,22,12,5,1,2,2,6,7,-1,4,6,5
16678,14617,14623,40,16,5,0,2,3,2,13,-11,2,8,2
16679,14617,14623,34,17,5,0,1,4,5,14,-9,1,9,1
16680,14617,14623,24,18,5,0,1,4,4,14,-10,1,9,1
16681,14617,14623,25,5,5,3,1,1,7,5,2,7,3,10
16682,14617,14623,12,9,5,2,2,1,8,7,1,6,4,8
16683,14617,14623,27,4,5,4,0,1,12,8,4,8,2,12
16684,14617,14623,17,8,5,3,0,2,7,4,3,6,4,9
16685,14617,14623,33,3,5,4,0,1,15,4,11,8,2,12
16686,14617,14623,28,15,5,0,2,3,4,9,-5,2,8,2
16687,14617,14623,49,7,5,3,0,2,11,8,3,6,4,9
16688,14617,14623,37,11,5,2,0,3,5,8,-3,4,6,6
16689,14624,14630,49,5,6,4,0,2,18,8,10,8,4,12
16690,14624,14630,37,12,6,2,0,4,5,13,-8,4,8,6
16691,14624,14630,33,6,6,4,0,2,18,9,9,8,4,12
16692,14624,14630,28,16,6,0,2,4,5,11,-6,2,10,2
16693,14624,14630,17,7,6,4,0,2,11,5,6,8,4,12
16694,14624,14630,27,8,6,4,0,2,13,10,3,8,4,12
16695,14624,14630,25,4,6,4,1,1,12,8,4,9,3,13
16696,14624,14630,12,9,6,3,2,1,10,8,2,8,4,11
16697,14624,14630,43,2,6,5,1,0,20,8,12,11,1,16
16698,14624,14630,22,10,6,2,2,2,8,8,0,6,6,8
16699,12678,12754,17,5,34,14,9,11,52,52,0,37,31,51
16700,12678,12754,27,14,34,10,11,13,33,43,-10,31,37,41
16701,12678,12754,4,12,34,11,8,15,41,53,-12,30,38,41
16702,12678,12754,21,16,34,8,8,18,40,56,-16,24,44,32
16703,12678,12754,9,17,34,5,9,20,34,81,-47,19,49,24
16704,12678,12754,35,6,34,12,13,9,57,39,18,37,31,49
16705,12678,12754,6,7,34,13,9,12,44,41,3,35,33,48
16706,12678,12754,13,8,34,12,10,12,53,45,8,34,34,46
16707,12678,12754,41,18,34,5,7,22,35,72,-37,17,51,22
16708,12678,12754,49,2,34,21,9,4,52,23,29,51,17,72
16709,12678,12754,37,11,34,10,12,12,40,46,-6,32,36,42
16710,12678,12754,43,1,34,23,6,5,80,31,49,52,16,75
16711,12678,12754,34,4,34,14,11,9,63,57,6,39,29,53
16712,12678,12754,24,10,34,11,9,14,41,46,-5,31,37,42
16713,12678,12754,57,15,34,9,10,15,43,52,-9,28,40,37
16714,12678,12754,28,9,34,11,13,10,34,35,-1,35,33,46
16715,12678,12754,52,13,34,10,11,13,34,41,-7,31,37,41
16716,12874,12887,52,4,18,7,7,4,19,16,3,21,15,28
16717,12874,12887,28,14,18,5,5,8,22,31,-9,15,21,20
16718,12874,12887,24,7,18,7,5,6,23,27,-4,19,17,26
16719,12874,12887,34,10,18,6,5,7,24,27,-3,17,19,23
16720,12874,12887,43,2,18,11,3,4,40,19,21,25,11,36
16721,12874,12887,57,6,18,6,9,3,24,24,0,21,15,27
16722,12874,12887,49,8,18,6,7,5,25,20,5,19,17,25
16723,12874,12887,37,16,18,4,6,8,18,24,-6,14,22,18
16724,12874,12887,35,11,18,5,7,6,28,23,5,17,19,22
16725,12874,12887,6,15,18,5,4,9,21,29,-8,14,22,19
16726,12874,12887,20,17,18,3,5,10,16,33,-17,11,25,14
16727,12874,12887,13,18,18,3,4,11,21,38,-17,10,26,13
16728,12874,12887,21,12,18,6,3,9,25,27,-2,15,21,21
16729,12874,12887,4,13,18,5,6,7,20,25,-5,16,20,21
16730,12874,12887,27,5,18,7,7,4,34,33,1,21,15,28
16731,12874,12887,17,3,18,10,6,2,34,21,13,26,10,36
16732,12874,12887,1,1,18,11,5,2,39,14,25,27,9,38
16733,12874,12887,47,9,18,7,2,9,22,24,-2,16,20,23
16734,12944,12950,47,14,23,8,3,12,26,32,-6,19,27,27
16735,12944,12950,1,1,23,16,5,2,55,20,35,37,9,53
16736,12944,12950,28,15,23,7,5,11,28,42,-14,19,27,26
16737,12944,12950,6,11,23,8,5,10,25,34,-9,21,25,29
16738,12944,12950,17,3,23,10,7,6,37,29,8,27,19,37
16739,12944,12950,21,10,23,8,5,10,29,31,-2,21,25,29
16740,12944,12950,4,12,23,7,8,8,29,35,-6,22,24,29
16741,12944,12950,35,6,23,9,7,7,36,28,8,25,21,34
16742,12944,12950,13,16,23,6,4,13,28,49,-21,16,30,22
16743,12944,12950,20,18,23,3,6,14,20,47,-27,12,34,15
16744,12944,12950,49,7,23,8,9,6,33,27,6,25,21,33
16745,12944,12950,37,17,23,4,7,12,20,34,-14,15,31,19
16746,12944,12950,43,2,23,15,3,5,60,24,36,33,13,48
16747,12944,12950,57,4,23,9,9,5,36,30,6,27,19,36
16748,12944,12950,24,9,23,9,5,9,27,32,-5,23,23,32
16749,12944,12950,34,13,23,7,7,9,32,33,-1,21,25,28
16750,12944,12950,27,8,23,8,9,6,41,38,3,25,21,33
16751,12944,12950,52,5,23,9,8,6,26,23,3,26,20,35
16752,12951,12957,52,6,24,9,9,6,27,24,3,27,21,36
16753,12951,12957,28,15,24,7,6,11,29,43,-14,20,28,27
16754,12951,12957,43,2,24,16,3,5,63,25,38,35,13,51
16755,12951,12957,57,4,24,9,10,5,37,31,6,28,20,37
16756,12951,12957,24,9,24,9,5,10,28,35,-7,23,25,32
16757,12951,12957,34,14,24,7,7,10,33,35,-2,21,27,28
16758,12951,12957,49,5,24,9,9,6,35,28,7,27,21,36
16759,12951,12957,37,17,24,4,7,13,23,39,-16,15,33,19
16760,12951,12957,35,7,24,9,7,8,37,30,7,25,23,34
16761,12951,12957,6,10,24,9,5,10,27,35,-8,23,25,32
16762,12951,12957,13,16,24,6,4,14,29,51,-22,16,32,22
16763,12951,12957,20,18,24,3,7,14,21,48,-27,13,35,16
16764,12951,12957,4,11,24,8,8,8,30,35,-5,24,24,32
16765,12951,12957,21,13,24,8,6,10,30,32,-2,22,26,30
16766,12951,12957,17,3,24,10,8,6,38,30,8,28,20,38
16767,12951,12957,27,8,24,8,9,7,41,39,2,25,23,33
16768,12951,12957,1,1,24,17,5,2,60,23,37,39,9,56
16769,12951,12957,47,12,24,9,3,12,28,33,-5,21,27,30
16770,13000,13006,47,8,30,13,4,13,37,39,-2,30,30,43
16771,13000,13006,1,1,30,23,5,2,77,25,52,51,9,74
16772,13000,13006,17,3,30,13,10,7,49,36,13,36,24,49
16773,13000,13006,21,11,30,10,7,13,35,43,-8,27,33,37
16774,13000,13006,4,15,30,8,10,12,33,45,-12,26,34,34
16775,13000,13006,35,5,30,12,8,10,42,34,8,32,28,44
16776,13000,13006,6,9,30,12,5,13,35,42,-7,29,31,41
16777,7127,7133,52,3,26,14,8,4,40,22,18,36,16,50
16778,7127,7133,48,17,26,3,10,13,29,49,-20,16,36,19
16779,7127,7133,43,5,26,14,4,8,52,26,26,32,20,46
16780,7127,7133,57,7,26,12,4,10,42,42,0,28,24,40
16781,7127,7133,22,11,26,8,9,9,25,48,-23,25,27,33
16782,7127,7133,49,4,26,14,7,5,59,25,34,35,17,49
16783,7127,7133,37,8,26,9,10,7,30,31,-1,28,24,37
16784,7127,7133,17,6,26,12,4,10,48,35,13,28,24,40
16785,7127,7133,19,10,26,9,8,9,33,34,-1,26,26,35
16786,7127,7133,8,15,26,7,6,13,27,41,-14,20,32,27
16787,7127,7133,41,9,26,10,6,10,36,33,3,26,26,36
16788,7127,7133,20,13,26,7,10,9,26,33,-7,24,28,31
16789,7155,7161,43,5,29,16,4,9,58,28,30,36,22,52
16790,7155,7161,57,8,29,12,5,12,45,50,-5,29,29,41
16791,7155,7161,22,12,29,9,10,10,28,55,-27,28,30,37
16792,7155,7161,41,7,29,12,6,11,46,40,6,30,28,42
16793,7155,7161,20,11,29,9,11,9,31,35,-4,29,29,38
16794,7155,7161,49,2,29,17,7,5,67,27,40,41,17,58
16795,7155,7161,52,3,29,16,8,5,47,25,22,40,18,56
16796,7155,7161,37,10,29,10,10,9,33,35,-2,30,28,40
16797,7155,7161,1,1,29,19,5,5,63,27,36,43,15,62
16798,7155,7161,21,14,29,8,7,14,34,40,-6,23,35,31
16799,7155,7161,17,6,29,15,4,10,58,35,23,34,24,49
16800,7155,7161,19,9,29,11,8,10,41,37,4,30,28,41
16801,7155,7161,8,15,29,7,7,15,29,47,-18,21,37,28
16802,7155,7161,12,4,29,16,5,8,52,23,29,37,21,53
16803,7155,7161,53,13,29,8,9,12,33,42,-9,25,33,33
16804,7155,7161,48,16,29,5,10,14,32,51,-19,20,38,25
16805,7155,7161,27,17,29,6,5,18,17,60,-43,17,41,23
16806,7155,7161,59,18,29,2,5,22,18,75,-57,9,49,11
16807,7183,7189,27,17,33,8,5,20,22,65,-43,21,45,29
16808,7183,7189,59,18,33,2,5,26,19,92,-73,9,57,11
16809,7183,7189,52,3,33,18,10,5,54,28,26,46,20,64
16810,7183,7189,48,16,33,7,11,15,39,60,-21,25,41,32
16811,7183,7189,12,4,33,18,6,9,60,27,33,42,24,60
16812,7183,7189,53,14,33,8,11,14,37,49,-12,27,39,35
16813,7183,7189,21,13,33,10,8,15,41,44,-3,28,38,38
16814,7183,7189,17,5,33,17,4,12,69,42,27,38,28,55
16815,7183,7189,19,7,33,13,9,11,47,39,8,35,31,48
16816,7183,7189,8,15,33,9,7,17,32,49,-17,25,41,34
16817,7183,7189,49,2,33,20,8,5,79,30,49,48,18,68
16818,7183,7189,37,11,33,11,10,12,37,42,-5,32,34,43
16819,7183,7189,43,6,33,16,7,10,63,34,29,39,27,55
16820,7183,7189,57,8,33,13,6,14,50,57,-7,32,34,45
16821,7183,7189,22,10,33,11,11,11,34,62,-28,33,33,44
16822,7183,7189,41,9,33,12,8,13,50,46,4,32,34,44
16823,7183,7189,20,12,33,10,11,12,33,41,-8,31,35,41
16824,7183,7189,1,1,33,23,5,5,71,30,41,51,15,74
16825,6945,6951,1,3,4,3,0,1,7,2,5,6,2,9
16826,6945,6951,57,4,4,3,0,1,8,5,3,6,2,9
16827,6945,6951,43,13,4,1,0,3,8,9,-1,2,6,3
16828,6945,6951,20,8,4,1,2,1,4,2,2,4,4,5
16829,6945,6951,41,17,4,0,1,3,2,6,-4,1,7,1
16830,6945,6951,12,2,4,3,1,0,5,1,4,7,1,10
16831,6945,6951,53,7,4,1,3,0,4,3,1,5,3,6
16832,6945,6951,22,15,4,0,3,1,1,4,-3,3,5,3
16833,6945,6951,52,5,4,3,0,1,5,4,1,6,2,9
16834,6945,6951,48,10,4,1,2,1,5,6,-1,4,4,5
16835,6945,6951,49,1,4,3,1,0,10,4,6,7,1,10
16836,6945,6951,37,9,4,1,2,1,4,3,1,4,4,5
16837,6945,6951,21,16,4,0,2,2,0,3,-3,2,6,2
16838,6945,6951,8,12,4,1,1,2,7,3,4,3,5,4
16839,6945,6951,17,14,4,1,0,3,5,9,-4,2,6,3
16840,6945,6951,19,18,4,0,1,3,3,8,-5,1,7,1
16841,6945,6951,27,6,4,2,1,1,4,7,-3,5,3,7
16842,6945,6951,59,11,4,1,2,1,4,7,-3,4,4,5
16843,7484,7490,12,3,23,13,4,6,50,26,24,30,16,43
16844,7484,7490,52,7,23,10,3,10,33,36,-3,23,23,33
16845,7484,7490,17,10,23,8,8,7,39,31,8,24,22,32
16846,7484,7490,19,14,23,7,3,13,41,54,-13,17,29,24
16847,7484,7490,8,16,23,6,4,13,28,48,-20,16,30,22
16848,7484,7490,21,6,23,9,8,6,35,34,1,26,20,35
16849,7484,7490,4,9,23,9,6,8,38,31,7,24,22,33
16850,7484,7490,43,1,23,19,2,2,45,13,32,40,6,59
16851,7484,7490,22,8,23,10,3,10,29,35,-6,23,23,33
16852,7484,7490,37,2,23,14,4,5,38,19,19,32,14,46
16853,7484,7490,49,4,23,12,5,6,43,32,11,29,17,41
16854,7484,7490,48,18,23,4,7,12,20,54,-34,15,31,19
16855,7484,7490,57,15,23,6,5,12,35,52,-17,17,29,23
16856,7512,7518,22,8,27,11,5,11,34,38,-4,27,27,38
16857,7512,7518,57,14,27,8,5,14,41,57,-16,21,33,29
16858,7512,7518,52,7,27,11,5,11,37,40,-3,27,27,38
16859,7512,7518,48,18,27,5,9,13,23,62,-39,19,35,24
16860,7512,7518,21,6,27,10,9,8,37,40,-3,29,25,39
16861,7512,7518,4,9,27,10,8,9,41,35,6,28,26,38
16862,7512,7518,17,10,27,9,10,8,45,39,6,28,26,37
16863,7512,7518,19,15,27,8,4,15,44,60,-16,20,34,28
16864,7512,7518,8,16,27,6,7,14,31,53,-22,19,35,25
16865,7739,7742,4,1,12,8,3,1,21,9,12,19,5,27
16866,7739,7742,21,7,12,5,4,3,16,10,6,14,10,19
16867,7739,7742,56,5,12,6,2,4,17,16,1,14,10,20
16868,7739,7742,41,9,12,4,3,5,15,13,2,11,13,15
16869,7739,7742,20,13,12,3,3,6,9,11,-2,9,15,12
16870,7739,7742,43,4,12,7,3,2,23,12,11,17,7,24
16871,7739,7742,57,14,12,3,3,6,19,24,-5,9,15,12
16872,7739,7742,22,16,12,3,3,6,9,19,-10,9,15,12
16873,7739,7742,24,18,12,0,4,8,8,19,-11,4,20,4
16874,7739,7742,49,3,12,7,4,1,21,8,13,18,6,25
16875,7739,7742,37,11,12,3,6,3,8,9,-1,12,12,15
16876,7739,7742,1,17,12,2,3,7,16,22,-6,7,17,9
16877,7739,7742,17,2,12,8,2,2,20,13,7,18,6,26
16878,7739,7742,8,10,12,4,3,5,12,17,-5,11,13,15
16879,7739,7742,19,12,12,3,4,5,14,21,-7,10,14,13
16880,7739,7742,12,8,12,5,2,5,13,13,0,12,12,17
16881,7739,7742,52,6,12,6,1,5,18,18,0,13,11,19
16882,7739,7742,3,15,12,3,3,6,15,20,-5,9,15,12
16883,7883,7889,52,9,29,11,4,14,36,38,-2,26,32,37
16884,7883,7889,3,15,29,8,8,13,32,50,-18,24,34,32
16885,7883,7889,12,3,29,14,8,7,50,29,21,36,22,50
16886,7883,7889,37,7,29,12,9,8,36,26,10,33,25,45
16887,7883,7889,17,6,29,13,6,10,42,44,-2,32,26,45
16888,7883,7889,19,10,29,10,7,12,36,45,-9,27,31,37
16889,7883,7889,8,17,29,7,7,15,26,46,-20,21,37,28
16890,7883,7889,1,16,29,7,8,14,36,44,-8,22,36,29
16891,7883,7889,49,2,29,15,10,4,48,26,22,40,18,55
16892,7883,7889,56,8,29,12,8,9,36,31,5,32,26,44
16893,7883,7889,20,11,29,9,9,11,28,27,1,27,31,36
16894,7883,7889,41,13,29,9,6,14,33,44,-11,24,34,33
16895,7883,7889,43,1,29,16,7,6,48,27,21,39,19,55
16896,7883,7889,22,12,29,9,8,12,23,34,-11,26,32,35
16897,7883,7889,57,14,29,8,8,13,43,51,-8,24,34,32
16898,7883,7889,24,18,29,6,4,19,26,50,-24,16,42,22
16899,7883,7889,21,4,29,14,8,7,37,19,18,36,22,50
16900,7883,7889,4,5,29,13,11,5,34,19,15,37,21,50
16901,7715,7721,4,1,9,7,1,1,15,5,10,15,3,22
16902,7715,7721,21,6,9,4,2,3,12,8,4,10,8,14
16903,7715,7721,43,2,9,6,1,2,21,11,10,13,5,19
16904,7715,7721,57,11,9,3,2,4,17,19,-2,8,10,11
16905,7715,7721,22,16,9,2,2,5,6,16,-10,6,12,8
16906,7715,7721,24,18,9,0,3,6,8,17,-9,3,15,3
16907,7715,7721,41,5,9,4,3,2,14,8,6,11,7,15
16908,7715,7721,56,8,9,4,2,3,12,12,0,10,8,14
16909,7715,7721,20,15,9,2,2,5,7,8,-1,6,12,8
16910,7715,7721,49,4,9,4,4,1,16,8,8,12,6,16
16911,7715,7721,37,10,9,3,3,3,7,8,-1,9,9,12
16912,7715,7721,1,17,9,2,1,6,13,18,-5,5,13,7
16913,7715,7721,17,3,9,5,2,2,14,11,3,12,6,17
16914,7715,7721,8,13,9,3,2,4,11,15,-4,8,10,11
16915,7715,7721,19,14,9,2,3,4,10,17,-7,7,11,9
16916,7715,7721,12,7,9,4,2,3,9,8,1,10,8,14
16917,7715,7721,52,9,9,4,1,4,14,14,0,9,9,13
16918,7715,7721,3,12,9,3,2,4,12,15,-3,8,10,11
16919,8128,8141,3,18,16,2,4,10,16,32,-16,8,24,10
16920,8128,8141,12,5,16,8,5,3,22,13,9,21,11,29
16921,8128,8141,53,11,16,5,4,7,23,33,-10,14,18,19
16922,8128,8141,49,1,16,10,2,4,42,20,22,22,10,32
16923,8128,8141,37,8,16,6,6,4,34,16,18,18,14,24
16924,8128,8141,1,4,16,8,5,3,25,14,11,21,11,29
16925,8128,8141,13,17,16,2,7,7,15,32,-17,11,21,13
16926,8128,8141,56,12,16,4,7,5,18,23,-5,15,17,19
16927,8128,8141,20,13,16,4,4,8,16,23,-7,12,20,16
16928,8128,8141,41,15,16,3,5,8,12,32,-20,11,21,14
16929,8128,8141,43,3,16,8,5,3,32,19,13,21,11,29
16930,8128,8141,57,14,16,3,6,7,18,24,-6,12,20,15
16931,8128,8141,22,16,16,3,4,9,17,24,-7,10,22,13
16932,8128,8141,52,9,16,6,5,5,19,17,2,17,15,23
16933,8128,8141,21,6,16,8,4,4,19,17,2,20,12,28
16934,8128,8141,4,7,16,6,7,3,26,19,7,19,13,25
16935,13322,13328,34,17,24,4,9,11,27,40,-13,17,31,21
16936,13322,13328,57,18,24,3,7,14,26,49,-23,13,35,16
16937,13364,13370,43,4,29,14,9,6,50,31,19,37,21,51
16938,13364,13370,22,9,29,10,8,11,38,36,2,28,30,38
16939,13364,13370,12,14,29,8,7,14,36,51,-15,23,35,31
16940,13364,13370,27,10,29,9,7,13,38,43,-5,25,33,34
16941,13364,13370,17,1,29,17,10,2,58,32,26,44,14,61
16942,13364,13370,6,5,29,14,7,8,41,38,3,35,23,49
16943,13364,13370,35,13,29,8,7,14,35,49,-14,23,35,31
16944,13364,13370,33,3,29,16,9,4,54,29,25,41,17,57
16945,13364,13370,28,11,29,9,7,13,39,49,-10,25,33,34
16946,13364,13370,52,12,29,8,8,13,28,36,-8,24,34,32
16947,13364,13370,24,15,29,7,10,12,32,44,-12,24,34,31
16948,13364,13370,34,17,29,5,10,14,34,50,-16,20,38,25
16949,13364,13370,57,18,29,4,8,17,28,58,-30,16,42,20
16950,13364,13370,49,7,29,14,2,13,49,45,4,30,28,44
16951,13364,13370,47,6,29,12,9,8,44,31,13,33,25,45
16952,13364,13370,21,8,29,13,5,11,41,38,3,31,27,44
16953,13364,13370,4,16,29,8,6,15,40,53,-13,22,36,30
16954,13364,13370,1,2,29,18,5,6,60,32,28,41,17,59
16955,13371,13377,1,2,30,19,5,6,63,32,31,43,17,62
16956,13371,13377,21,8,30,13,5,12,41,41,0,31,29,44
16957,13371,13377,4,14,30,9,6,15,42,54,-12,24,36,33
16958,13371,13377,47,6,30,12,9,9,44,32,12,33,27,45
16959,13371,13377,49,7,30,14,2,14,50,47,3,30,30,44
16960,13371,13377,43,4,30,14,10,6,50,31,19,38,22,52
16961,13371,13377,22,9,30,11,8,11,41,36,5,30,30,41
16962,13371,13377,24,16,30,7,10,13,32,45,-13,24,36,31
16963,13371,13377,34,17,30,6,10,14,37,52,-15,22,38,28
16964,13371,13377,57,18,30,5,8,17,30,59,-29,18,42,23
16965,13371,13377,33,3,30,16,9,5,54,32,22,41,19,57
16966,13371,13377,28,11,30,9,7,14,40,51,-11,25,35,34
16967,13371,13377,52,15,30,8,9,13,28,36,-8,25,35,33
16968,13371,13377,6,5,30,14,7,9,42,42,0,35,25,49
16969,13371,13377,35,12,30,9,7,14,39,50,-11,25,35,34
16970,13371,13377,17,1,30,18,10,2,59,32,27,46,14,64
16971,13371,13377,27,10,30,9,7,14,40,46,-6,25,35,34
16972,13371,13377,12,13,30,9,7,14,37,51,-14,25,35,34
16973,13140,13153,27,15,4,1,0,3,4,8,-4,2,6,3
16974,13140,13153,33,4,4,2,2,0,7,4,3,6,2,8
16975,13140,13153,52,9,4,1,2,1,4,5,-1,4,4,5
16976,13140,13153,28,16,4,1,0,3,4,11,-7,2,6,3
16977,13140,13153,43,6,4,1,3,0,9,3,6,5,3,6
16978,13140,13153,22,8,4,1,2,1,6,5,1,4,4,5
16979,13140,13153,34,11,4,1,1,2,5,6,-1,3,5,4
16980,13140,13153,24,17,4,0,3,1,6,7,-1,3,5,3
16981,13140,13153,57,18,4,0,3,1,4,5,-1,3,5,3
16982,13140,13153,17,7,4,1,3,0,7,3,4,5,3,6
16983,13140,13153,49,2,4,3,0,1,7,3,4,6,2,9
16984,13140,13153,4,1,4,3,1,0,9,5,4,7,1,10
16985,13140,13153,21,5,4,2,0,2,6,10,-4,4,4,6
16986,13140,13153,47,10,4,1,1,2,6,7,-1,3,5,4
16987,13140,13153,1,3,4,2,2,0,10,4,6,6,2,8
16988,13140,13153,12,12,4,1,1,2,4,5,-1,3,5,4
16989,13140,13153,35,13,4,1,1,2,6,8,-2,3,5,4
16990,13140,13153,6,14,4,1,1,2,5,10,-5,3,5,4
16991,13623,13650,35,4,17,9,3,5,27,21,6,21,13,30
16992,13623,13650,6,5,17,8,3,6,29,24,5,19,15,27
16993,13623,13650,1,1,17,15,2,0,45,10,35,32,2,47
16994,13623,13650,17,7,17,7,4,6,28,22,6,18,16,25
16995,13623,13650,47,3,17,8,7,2,33,19,14,23,11,31
16996,13623,13650,4,11,17,5,7,5,28,26,2,17,17,22
16997,13623,13650,21,18,17,2,2,13,18,35,-17,6,28,8
16998,13623,13650,49,14,17,4,7,6,22,24,-2,15,19,19
16999,13623,13650,37,17,17,3,5,9,17,28,-11,11,23,14
17000,13623,13650,22,2,17,10,3,4,38,22,16,23,11,33
17001,13623,13650,43,6,17,8,3,6,23,19,4,19,15,27
17002,13623,13650,34,12,17,6,3,8,28,31,-3,15,19,21
17003,13623,13650,52,16,17,4,2,11,20,45,-25,10,24,14
17004,13623,13650,28,9,17,6,5,6,17,20,-3,17,17,23
17005,13623,13650,33,15,17,4,4,9,16,24,-8,12,22,16
17006,13623,13650,12,8,17,8,0,9,32,37,-5,16,18,24
17007,13623,13650,25,13,17,5,5,7,27,34,-7,15,19,20
17008,13623,13650,27,10,17,6,5,6,24,31,-7,17,17,23
17009,13707,13713,27,12,26,8,6,12,37,49,-12,22,30,30
17010,13707,13713,22,2,26,17,4,5,57,29,28,38,14,55
17011,13707,13713,43,5,26,12,6,8,42,30,12,30,22,42
17012,13707,13713,34,15,26,7,7,12,37,48,-11,21,31,28
17013,13707,13713,49,9,26,8,9,9,36,34,2,25,27,33
17014,18376,18396,24,5,21,10,5,6,26,23,3,25,17,35
17015,18376,18396,57,8,21,9,5,7,26,27,-1,23,19,32
17016,18425,18431,43,1,26,18,6,2,53,14,39,42,10,60
17017,18425,18431,22,2,26,17,6,3,61,24,37,40,12,57
17018,18425,18431,24,5,26,12,7,7,30,27,3,31,21,43
17019,18425,18431,57,8,26,11,5,10,33,31,2,27,25,38
17020,18425,18431,45,11,26,7,10,9,34,34,0,24,28,31
17021,18425,18431,49,7,26,13,3,10,44,32,12,29,23,42
17022,18425,18431,1,4,26,14,3,9,52,31,21,31,21,45
17023,18425,18431,17,15,26,4,8,14,23,55,-32,16,36,20
17024,18425,18431,4,3,26,15,5,6,51,37,14,35,17,50
17025,18425,18431,15,14,26,5,5,16,26,46,-20,15,37,20
17026,18425,18431,27,16,26,3,6,17,17,47,-30,12,40,15
17027,18425,18431,56,9,26,10,4,12,29,30,-1,24,28,34
17028,18425,18431,35,13,26,4,10,12,20,36,-16,18,34,22
17029,18425,18431,28,12,26,6,5,15,17,47,-30,17,35,23
17030,18425,18431,12,6,26,11,10,5,37,32,5,32,20,43
17031,18425,18431,25,10,26,8,7,11,34,38,-4,23,29,31
17032,18432,18445,12,6,27,11,10,6,38,34,4,32,22,43
17033,18432,18445,28,13,27,6,5,16,17,48,-31,17,37,23
17034,18432,18445,56,9,27,10,4,13,30,33,-3,24,30,34
17035,18432,18445,35,12,27,5,10,12,23,37,-14,20,34,25
17036,18432,18445,25,10,27,9,7,11,36,38,-2,25,29,34
17037,18432,18445,45,11,27,7,11,9,35,35,0,25,29,32
17038,18432,18445,15,14,27,5,6,16,26,46,-20,16,38,21
17039,18432,18445,27,16,27,4,6,17,18,47,-29,14,40,18
17040,18432,18445,4,3,27,16,5,6,55,38,17,37,17,53
17041,18432,18445,1,4,27,15,3,9,54,32,22,33,21,48
17042,18432,18445,49,7,27,13,3,11,45,36,9,29,25,42
17043,18432,18445,22,1,27,18,6,3,62,24,38,42,12,60
17044,18432,18445,43,2,27,18,6,3,53,16,37,42,12,60
17045,18432,18445,24,5,27,12,7,8,30,28,2,31,23,43
17046,18432,18445,57,8,27,11,6,10,33,31,2,28,26,39
17047,18432,18445,17,15,27,4,9,14,24,56,-32,17,37,21
17048,18243,18249,25,8,3,1,1,1,2,2,0,3,3,4
17049,18243,18249,12,12,3,0,2,1,4,6,-2,2,4,2
17050,18243,18249,45,11,3,0,2,1,3,4,-1,2,4,2
17051,18243,18249,27,13,3,0,2,1,1,6,-5,2,4,2
17052,18243,18249,15,15,3,0,0,3,2,7,-5,0,6,0
17053,18243,18249,49,6,3,1,2,0,8,5,3,4,2,5
17054,18243,18249,22,1,3,3,0,0,11,1,10,6,0,9
17055,18243,18249,24,2,3,3,0,0,5,1,4,6,0,9
17056,18243,18249,43,3,3,2,1,0,8,1,7,5,1,7
17057,18243,18249,57,7,3,1,2,0,4,2,2,4,2,5
17058,18243,18249,1,9,3,1,0,2,5,5,0,2,4,3
17059,18243,18249,4,5,3,2,0,1,3,5,-2,4,2,6
17060,18243,18249,56,4,3,2,1,0,4,1,3,5,1,7
17061,18243,18249,35,14,3,0,1,2,1,6,-5,1,5,1
17062,18243,18249,28,10,3,1,0,2,2,6,-4,2,4,3
17063,18243,18249,17,16,3,0,0,3,1,6,-5,0,6,0
17064,18281,18284,56,7,8,4,1,3,8,8,0,9,7,13
17065,18281,18284,35,12,8,2,2,4,6,11,-5,6,10,8
17066,18281,18284,28,13,8,2,1,5,5,14,-9,5,11,7
17067,18281,18284,25,8,8,3,2,3,8,8,0,8,8,11
17068,18281,18284,4,4,8,5,1,2,16,14,2,11,5,16
17069,18281,18284,1,6,8,4,1,3,19,10,9,9,7,13
17070,18281,18284,22,1,8,7,1,0,26,6,20,15,1,22
17071,18281,18284,43,2,8,5,3,0,17,2,15,13,3,18
17072,18281,18284,24,3,8,5,2,1,10,5,5,12,4,17
17073,18281,18284,57,10,8,2,4,2,11,13,-2,8,8,10
17074,18281,18284,49,5,8,4,2,2,13,8,5,10,6,14
17075,18281,18284,45,9,8,2,4,2,14,12,2,8,8,10
17076,18281,18284,27,14,8,1,2,5,5,17,-12,4,12,5
17077,18281,18284,15,16,8,0,1,7,3,18,-15,1,15,1
17078,18281,18284,12,11,8,2,3,3,12,16,-4,7,9,9
17079,18281,18284,17,15,8,0,2,6,6,17,-11,2,14,2
17080,18677,18683,45,13,11,2,4,5,10,16,-6,8,14,10
17081,18677,18683,43,1,11,8,2,1,22,9,13,18,4,26
17082,18677,18683,57,4,11,6,4,1,16,10,6,16,6,22
17083,18677,18683,22,8,11,4,4,3,18,14,4,12,10,16
17084,18677,18683,24,11,11,3,2,6,12,20,-8,8,14,11
17085,18677,18683,49,5,11,5,3,3,13,15,-2,13,9,18
17086,18677,18683,16,12,11,3,2,6,11,19,-8,8,14,11
17087,18677,18683,4,2,11,7,1,3,25,15,10,15,7,22
17088,18677,18683,28,16,11,1,2,8,18,31,-13,4,18,5
17089,18677,18683,1,3,11,6,4,1,21,11,10,16,6,22
17090,18677,18683,12,10,11,3,3,5,14,15,-1,9,13,12
17091,18677,18683,25,15,11,1,4,6,9,19,-10,6,16,7
17092,18677,18683,56,6,11,5,2,4,14,11,3,12,10,17
17093,18677,18683,35,9,11,3,5,3,20,18,2,11,11,14
17094,14624,14630,40,15,6,0,3,3,4,15,-11,3,9,3
17095,14624,14630,24,17,6,0,2,4,6,16,-10,2,10,2
17096,14624,14630,34,18,6,0,1,5,5,21,-16,1,11,1
17097,14624,14630,4,3,6,4,1,1,15,9,6,9,3,13
17098,14624,14630,21,14,6,1,0,5,4,11,-7,2,10,3
17099,14624,14630,1,1,6,6,0,0,21,6,15,12,0,18
17100,14624,14630,47,13,6,1,1,4,11,17,-6,3,9,4
17101,14624,14630,35,11,6,2,0,4,8,11,-3,4,8,6
17102,15170,15176,35,9,27,8,12,7,51,41,10,28,26,36
17103,15170,15176,6,12,27,8,7,12,42,50,-8,23,31,31
17104,15170,15176,49,4,27,13,8,6,50,33,17,34,20,47
17105,15170,15176,37,18,27,2,8,17,29,73,-44,12,42,14
17106,15170,15176,1,1,27,19,2,6,64,33,31,40,14,59
17107,15170,15176,22,2,27,16,10,1,73,35,38,42,12,58
17108,15170,15176,43,3,27,15,9,3,60,29,31,39,15,54
17109,15170,15176,40,14,27,7,8,12,32,50,-18,22,32,29
17110,15170,15176,34,17,27,4,6,17,21,58,-37,14,40,18
17111,15170,15176,12,7,27,12,7,8,35,29,6,31,23,43
17112,15170,15176,25,13,27,8,6,13,43,50,-7,22,32,30
17113,15170,15176,17,15,27,7,7,13,43,52,-9,21,33,28
17114,15170,15176,27,11,27,9,6,12,31,47,-16,24,30,33
17115,15170,15176,33,5,27,14,4,9,58,32,26,32,22,46
17116,15170,15176,28,8,27,12,4,11,40,38,2,28,26,40
17117,15170,15176,52,10,27,10,4,13,37,46,-9,24,30,34
17118,15170,15176,4,6,27,12,8,7,47,41,6,32,22,44
17119,15170,15176,21,16,27,5,8,14,35,54,-19,18,36,23
17120,15408,15421,21,9,11,3,3,5,18,23,-5,9,13,12
17121,15408,15421,4,11,11,3,2,6,16,21,-5,8,14,11
17122,15408,15421,28,3,11,7,3,1,36,18,18,17,5,24
17123,15408,15421,33,8,12,4,4,4,24,27,-3,12,12,16
17124,15408,15421,1,1,12,11,1,0,32,8,24,23,1,34
17125,15408,15421,27,17,12,0,4,8,13,31,-18,4,20,4
17126,15408,15421,17,4,11,7,3,1,22,8,14,17,5,24
17127,15408,15421,42,7,12,5,2,5,20,14,6,12,12,17
17128,15408,15421,40,14,11,2,4,5,11,12,-1,8,14,10
17129,15408,15421,24,16,11,1,3,7,8,25,-17,5,17,6
17130,15408,15421,12,2,11,8,3,0,28,14,14,19,3,27
17131,15408,15421,25,13,11,3,1,7,8,20,-12,7,15,10
17132,15408,15421,43,5,12,6,2,4,26,18,8,14,10,20
17133,15408,15421,22,6,11,5,4,2,23,17,6,14,8,19
17134,15408,15421,49,10,11,3,3,5,15,20,-5,9,13,12
17135,15408,15421,37,15,11,3,0,8,11,27,-16,6,16,9
17136,15408,15421,35,12,11,3,2,6,18,26,-8,8,14,11
17137,15478,15484,35,15,17,4,3,10,29,37,-8,11,23,15
17138,15478,15484,49,8,17,7,5,5,30,24,6,19,15,26
17139,15478,15484,37,14,17,5,1,11,20,41,-21,11,23,16
17140,15478,15484,12,3,17,10,4,3,37,25,12,24,10,34
17141,15478,15484,25,11,17,6,1,10,14,27,-13,13,21,19
17142,15478,15484,43,4,17,10,2,5,39,23,16,22,12,32
17143,15478,15484,22,7,17,7,5,5,36,29,7,19,15,26
17144,15478,15484,40,13,17,4,5,8,19,21,-2,13,21,17
17145,15478,15484,24,17,17,1,4,12,10,45,-35,6,28,7
17146,15478,15484,17,5,16,8,5,3,26,16,10,21,11,29
17147,15478,15484,42,6,17,8,2,7,30,23,7,18,16,26
17148,15478,15484,27,16,17,2,5,10,19,41,-22,9,25,11
17149,15478,15484,1,1,17,15,1,1,48,14,34,31,3,46
17150,15478,15484,28,2,17,10,4,3,46,25,21,24,10,34
17151,15478,15484,33,10,17,6,5,6,29,32,-3,17,17,23
17152,15478,15484,4,9,17,7,2,8,27,28,-1,16,18,23
17153,15478,15484,21,12,17,5,4,8,26,34,-8,14,20,19
17154,15506,15512,4,6,21,10,2,9,32,31,1,22,20,32
17155,15506,15512,21,13,21,6,4,11,30,42,-12,16,26,22
17156,15506,15512,28,3,20,12,4,4,50,28,22,28,12,40
17157,15506,15512,33,10,21,7,5,9,34,44,-10,19,23,26
17158,15506,15512,1,1,21,19,1,1,70,18,52,39,3,58
17159,15506,15512,27,16,21,3,5,13,26,49,-23,11,31,14
17160,15506,15512,17,5,20,11,5,4,35,24,11,27,13,38
17161,15506,15512,42,8,21,9,3,9,32,26,6,21,21,30
17162,15506,15512,43,2,21,14,2,5,49,25,24,30,12,44
17163,15506,15512,22,7,20,9,5,6,44,35,9,23,17,32
17164,15506,15512,40,15,21,4,5,12,22,32,-10,13,29,17
17165,15506,15512,24,17,21,1,4,16,10,60,-50,6,36,7
17166,15506,15512,12,4,20,12,4,4,43,29,14,28,12,40
17167,15506,15512,25,12,21,7,1,13,17,33,-16,15,27,22
17168,15506,15512,49,9,21,8,6,7,36,30,6,22,20,30
17169,15506,15512,37,11,21,8,1,12,33,51,-18,17,25,25
17170,15506,15512,35,14,20,6,3,11,33,39,-6,15,25,21
17171,15513,15519,35,14,21,6,3,12,34,42,-8,15,27,21
17172,15513,15519,49,9,22,8,7,7,37,31,6,23,21,31
17173,14400,14406,12,12,22,7,6,9,37,44,-7,20,24,27
17174,14400,14406,58,17,22,2,9,11,16,40,-24,13,31,15
17175,14400,14406,27,14,22,5,6,11,26,41,-15,16,28,21
17176,14400,14406,4,6,22,12,1,9,55,44,11,25,19,37
17177,14400,14406,34,10,22,9,2,11,41,43,-2,20,24,29
17178,14400,14406,24,11,22,9,2,11,37,53,-16,20,24,29
17179,14400,14406,49,3,22,13,2,7,49,35,14,28,16,41
17180,14400,14406,43,1,22,15,6,1,55,23,32,36,8,51
17181,14400,14406,22,4,22,11,6,5,47,31,16,28,16,39
17182,14400,14406,37,13,22,6,6,10,34,41,-7,18,26,24
17183,14400,14406,47,15,22,5,4,13,37,47,-10,14,30,19
17184,14400,14406,1,2,22,13,3,6,51,23,28,29,15,42
17185,14400,14406,33,7,22,11,4,7,46,34,12,26,18,37
17186,14400,14406,28,16,22,5,4,13,22,45,-23,14,30,19
17187,14799,14805,33,6,25,12,5,8,48,32,16,29,21,41
17188,14799,14805,28,16,25,4,6,15,24,43,-19,14,36,18
17189,14799,14805,47,15,25,6,2,17,29,66,-37,14,36,20
17190,14799,14805,4,4,25,12,7,6,46,35,11,31,19,43
17191,14799,14805,21,12,25,8,4,13,27,35,-8,20,30,28
17192,14799,14805,1,2,25,17,7,1,66,19,47,41,9,58
17193,14799,14805,49,3,25,12,9,4,57,29,28,33,17,45
17194,14799,14805,37,11,25,8,7,10,22,45,-23,23,27,31
17195,14799,14805,27,9,25,11,4,10,40,45,-5,26,24,37
17196,14799,14805,43,1,25,20,5,0,69,19,50,45,5,65
17197,14799,14805,22,13,25,7,7,11,29,36,-7,21,29,28
17198,14799,14805,34,14,25,6,5,14,25,52,-27,17,33,23
17199,14799,14805,40,17,25,2,9,14,19,45,-26,13,37,15
17200,14799,14805,24,18,25,2,7,16,29,58,-29,11,39,13
17201,14799,14805,25,5,25,12,6,7,46,37,9,30,20,42
17202,14799,14805,12,7,25,11,7,7,38,32,6,29,21,40
17203,14799,14805,35,8,25,12,3,10,46,37,9,27,23,39
17204,14799,14805,17,10,25,10,6,9,35,30,5,26,24,36
17205,14631,14637,17,8,7,4,0,3,13,10,3,8,6,12
17206,14631,14637,35,10,7,3,0,4,11,13,-2,6,8,9
17207,14631,14637,25,4,7,4,2,1,13,9,4,10,4,14
17208,14631,14637,12,9,7,3,3,1,11,9,2,9,5,12
17209,14631,14637,27,3,7,5,0,2,17,13,4,10,4,15
17210,14631,14637,49,5,7,4,1,2,19,9,10,9,5,13
17211,14631,14637,37,12,7,2,1,4,5,13,-8,5,9,7
17212,14631,14637,43,2,7,6,1,0,25,10,15,13,1,19
17213,14631,14637,22,11,7,2,2,3,8,9,-1,6,8,8
17214,14631,14637,34,15,7,1,1,5,6,21,-15,3,11,4
17215,14631,14637,40,17,7,0,3,4,4,16,-12,3,11,3
17216,14631,14637,24,18,7,0,2,5,8,19,-11,2,12,2
17217,14631,14637,4,7,7,4,1,2,18,13,5,9,5,13
17218,14631,14637,21,13,7,2,0,5,5,11,-6,4,10,6
17219,14631,14637,47,14,7,1,1,5,11,23,-12,3,11,4
17220,14631,14637,1,1,7,7,0,0,27,6,21,14,0,21
17221,14631,14637,33,6,7,4,1,2,18,9,9,9,5,13
17222,14631,14637,28,16,7,0,3,4,6,12,-6,3,11,3
17223,15142,15148,33,7,23,11,3,9,47,30,17,25,21,36
17224,15142,15148,28,9,23,9,4,10,33,33,0,22,24,31
17225,15142,15148,52,13,23,7,4,12,31,41,-10,18,28,25
17226,15142,15148,4,4,23,12,7,4,41,31,10,31,15,43
17227,15142,15148,21,15,23,5,6,12,32,44,-12,16,30,21
17228,15142,15148,49,5,23,12,6,5,44,29,15,30,16,42
17229,15142,15148,37,18,23,2,7,14,24,61,-37,11,35,13
17230,15142,15148,35,8,23,8,9,6,45,34,11,25,21,33
17231,15142,15148,6,11,23,7,6,10,35,40,-5,20,26,27
17232,15142,15148,27,10,23,8,4,11,23,43,-20,20,26,28
17233,15142,15148,1,1,23,17,1,5,55,26,29,35,11,52
17234,15142,15148,12,6,23,12,6,5,34,22,12,30,16,42
17235,15142,15148,25,12,23,7,5,11,38,45,-7,19,27,26
17236,15142,15148,22,2,23,13,9,1,63,31,32,35,11,48
17237,15142,15148,43,3,23,13,7,3,52,25,27,33,13,46
17238,15142,15148,40,16,23,4,8,11,25,44,-19,16,30,20
17239,15142,15148,34,17,23,4,4,15,18,51,-33,12,34,16
17240,15142,15148,17,14,23,5,6,12,35,45,-10,16,30,21
17241,15163,15169,35,9,26,8,11,7,50,40,10,27,25,35
17242,15163,15169,6,12,26,8,7,11,41,45,-4,23,29,31
17243,15163,15169,17,15,26,6,7,13,40,50,-10,19,33,25
17244,15163,15169,22,2,26,15,10,1,68,34,34,40,12,55
17245,15163,15169,43,3,26,15,8,3,59,28,31,38,14,53
17246,15163,15169,40,14,26,6,8,12,30,49,-19,20,32,26
17247,15163,15169,34,17,26,4,5,17,20,57,-37,13,39,17
17248,15163,15169,12,7,26,12,7,7,35,25,10,31,21,43
17249,15163,15169,25,13,26,8,5,13,42,49,-7,21,31,29
17250,15163,15169,1,1,26,19,1,6,63,32,31,39,13,58
17251,13000,13006,13,16,30,8,5,17,33,61,-28,21,39,29
17252,13000,13006,20,18,30,3,8,19,26,64,-38,14,46,17
17253,13000,13006,49,7,30,11,11,8,44,40,4,33,27,44
17254,13000,13006,37,17,30,6,7,17,32,47,-15,19,41,25
17255,13000,13006,43,2,30,20,4,6,77,33,44,44,16,64
17256,13000,13006,57,10,30,10,10,10,43,42,1,30,30,40
17257,13000,13006,24,12,30,10,7,13,32,41,-9,27,33,37
17258,13000,13006,34,14,30,9,9,12,42,45,-3,27,33,36
17259,13000,13006,27,6,30,11,11,8,50,45,5,33,27,44
17260,13000,13006,52,4,30,12,11,7,37,28,9,35,25,47
17261,13000,13006,28,13,30,10,6,14,37,51,-14,26,34,36
17262,12783,12789,52,6,6,3,2,1,6,5,1,8,4,11
17263,12783,12789,28,17,6,1,1,4,6,14,-8,3,9,4
17264,12783,12789,34,1,6,5,0,1,13,5,8,10,2,15
17265,12783,12789,57,9,6,2,2,2,7,10,-3,6,6,8
17266,12783,12789,43,10,6,2,1,3,10,10,0,5,7,7
17267,12783,12789,24,15,6,1,2,3,9,17,-8,4,8,5
17268,12783,12789,49,2,6,4,2,0,14,3,11,10,2,14
17269,12783,12789,37,8,6,3,0,3,7,8,-1,6,6,9
17270,12783,12789,13,11,6,2,1,3,8,10,-2,5,7,7
17271,12783,12789,35,12,6,1,3,2,9,9,0,5,7,6
17272,12783,12789,20,14,6,1,2,3,6,13,-7,4,8,5
17273,12783,12789,6,18,6,0,1,5,3,11,-8,1,11,1
17274,12783,12789,4,13,6,1,2,3,7,10,-3,4,8,5
17275,12783,12789,21,16,6,1,1,4,5,9,-4,3,9,4
17276,12783,12789,17,7,6,3,1,2,9,7,2,7,5,10
17277,12783,12789,27,5,6,4,1,1,12,8,4,9,3,13
17278,12783,12789,1,3,6,4,1,1,15,5,10,9,3,13
17279,12783,12789,47,4,6,4,1,1,13,5,8,9,3,13
17280,12790,12796,47,2,7,5,1,1,14,5,9,11,3,16
17281,12790,12796,1,1,7,5,1,1,18,6,12,11,3,16
17282,12790,12796,27,5,7,4,2,1,15,11,4,10,4,14
17283,12790,12796,49,4,7,4,3,0,15,4,11,11,3,15
17284,12790,12796,37,9,7,3,0,4,8,11,-3,6,8,9
17285,12790,12796,17,6,7,4,1,2,12,8,4,9,5,13
17286,12790,12796,21,11,7,2,1,4,8,11,-3,5,9,7
17287,12790,12796,4,14,7,1,3,3,10,13,-3,5,9,6
17288,12790,12796,13,11,7,2,1,4,8,11,-3,5,9,7
17289,12790,12796,35,13,7,1,3,3,10,11,-1,5,9,6
17290,12790,12796,20,15,7,1,2,4,7,16,-9,4,10,5
17291,12790,12796,6,17,7,1,1,5,5,12,-7,3,11,4
17292,12790,12796,34,3,7,5,1,1,14,6,8,11,3,16
17293,12790,12796,43,8,7,3,1,3,13,11,2,7,7,10
17294,12790,12796,57,10,7,2,3,2,9,12,-3,7,7,9
17295,12790,12796,24,16,7,1,2,4,10,20,-10,4,10,5
17296,12790,12796,52,7,7,3,3,1,8,7,1,9,5,12
17297,12790,12796,28,18,7,1,1,5,8,17,-9,3,11,4
17298,13343,13349,33,3,27,15,9,3,49,25,24,39,15,54
17299,13343,13349,52,10,27,8,7,12,28,34,-6,23,31,31
17300,13343,13349,28,13,27,8,6,13,37,48,-11,22,32,30
17301,13343,13349,43,4,27,13,9,5,46,27,19,35,19,48
17302,13343,13349,22,9,27,8,8,11,31,34,-3,24,30,32
17303,13343,13349,24,16,27,7,8,12,29,41,-12,22,32,29
17304,13343,13349,34,17,27,4,10,13,29,47,-18,18,36,22
17305,13343,13349,57,18,27,4,7,16,28,54,-26,15,39,19
17306,13343,13349,21,6,27,13,5,9,40,35,5,31,23,44
17307,13343,13349,4,15,27,8,5,14,35,47,-12,21,33,29
17308,13343,13349,6,5,27,13,6,8,39,38,1,32,22,45
17309,13343,13349,49,8,27,13,2,12,44,40,4,28,26,41
17310,13343,13349,17,2,27,15,10,2,52,28,24,40,14,55
17311,13343,13349,27,11,27,8,6,13,34,41,-7,22,32,30
17312,13343,13349,12,14,27,8,6,13,35,48,-13,22,32,30
17313,13343,13349,35,12,27,8,6,13,33,42,-9,22,32,30
17314,13343,13349,47,7,27,12,7,8,43,30,13,31,23,43
17315,13343,13349,1,1,27,17,5,5,57,30,27,39,15,56
17316,13168,13174,47,15,7,1,2,4,7,11,-4,4,10,5
17317,13168,13174,1,3,7,4,3,0,17,6,11,11,3,15
17318,13168,13174,27,13,7,2,1,4,10,12,-2,5,9,7
17319,13168,13174,17,11,7,1,5,1,10,7,3,7,7,8
17320,13168,13174,49,1,7,5,0,2,11,8,3,10,4,15
17321,13168,13174,6,10,7,2,3,2,10,13,-3,7,7,9
17322,13168,13174,35,15,7,1,2,4,7,11,-4,4,10,5
17323,13168,13174,4,5,7,3,2,2,14,13,1,8,6,11
17324,13168,13174,21,6,7,3,1,3,9,14,-5,7,7,10
17325,13168,13174,43,2,7,4,3,0,17,4,13,11,3,15
17326,13168,13174,34,8,7,2,3,2,10,10,0,7,7,9
17327,13168,13174,22,9,7,2,3,2,8,9,-1,7,7,9
17328,13168,13174,24,12,7,1,5,1,11,11,0,7,7,8
17329,13168,13174,57,18,7,0,3,4,6,16,-10,3,11,3
17330,13168,13174,12,7,7,2,3,2,11,8,3,7,7,9
17331,13168,13174,33,4,7,4,3,0,14,8,6,11,3,15
17332,6801,6804,37,1,28,17,8,3,54,19,35,42,14,59
17333,6801,6804,49,5,28,13,9,6,38,26,12,35,21,48
17334,6801,6804,21,7,28,9,11,8,35,34,1,29,27,38
17335,6801,6804,19,8,28,9,10,9,35,33,2,28,28,37
17336,6801,6804,17,9,28,10,6,12,33,36,-3,26,30,36
17337,6801,6804,8,12,28,7,11,10,27,32,-5,25,31,32
17338,6801,6804,12,4,28,13,9,6,41,27,14,35,21,48
17339,6801,6804,53,10,28,9,7,12,35,40,-5,25,31,34
17340,6801,6804,27,11,28,9,6,13,29,37,-8,24,32,33
17341,6801,6804,1,6,28,12,10,6,42,38,4,34,22,46
17342,6805,6811,1,6,29,12,10,7,43,41,2,34,24,46
17343,6805,6811,53,8,29,10,7,12,38,41,-3,27,31,37
17344,6805,6811,12,4,29,14,9,6,48,27,21,37,21,51
17345,6805,6811,27,12,29,9,7,13,31,39,-8,25,33,34
17346,6805,6811,19,9,29,9,10,10,36,36,0,28,30,37
17347,6805,6811,17,10,29,10,6,13,33,39,-6,26,32,36
17348,6805,6811,8,11,29,8,11,10,28,32,-4,27,31,35
17349,6805,6811,21,7,29,9,11,9,36,37,-1,29,29,38
17350,6805,6811,37,1,29,17,9,3,56,21,35,43,15,60
17351,6805,6811,49,5,29,13,9,7,38,27,11,35,23,48
17352,6805,6811,52,3,29,15,6,8,46,32,14,36,22,51
17353,6805,6811,48,16,29,6,12,11,23,35,-12,24,34,30
17354,6805,6811,20,14,29,6,13,10,26,38,-12,25,33,31
17355,6805,6811,41,15,29,8,6,15,38,45,-7,22,36,30
17356,6805,6811,56,18,29,4,9,16,20,50,-30,17,41,21
17357,6805,6811,43,2,29,19,2,8,66,31,35,40,18,59
17358,6805,6811,22,13,29,8,10,11,39,44,-5,26,32,34
17359,6805,6811,40,17,29,7,7,15,40,70,-30,21,37,28
17360,7064,7070,20,11,18,5,8,5,19,19,0,18,18,23
17361,7064,7070,41,12,18,6,4,8,24,28,-4,16,20,22
17362,7064,7070,21,10,18,6,6,6,24,17,7,18,18,24
17363,7064,7070,43,3,18,10,2,6,38,20,18,22,14,32
17364,7064,7070,57,7,18,8,4,6,32,29,3,20,16,28
17365,7064,7070,22,15,18,4,5,9,15,43,-28,13,23,17
17366,7064,7070,37,8,18,6,9,3,20,18,2,21,15,27
17367,7064,7070,52,5,18,8,7,3,23,17,6,23,13,31
17368,7064,7070,49,4,18,9,5,4,45,22,23,23,13,32
17369,7064,7070,17,6,18,9,1,8,32,26,6,19,17,28
17370,7064,7070,19,13,18,5,6,7,20,27,-7,16,20,21
17371,7064,7070,8,16,18,3,5,10,17,28,-11,11,25,14
17372,7064,7070,1,2,18,12,2,4,40,13,27,26,10,38
17373,7064,7070,48,14,18,3,9,6,23,29,-6,15,21,18
17374,7064,7070,12,1,18,13,2,3,44,14,30,28,8,41
17375,7064,7070,53,9,18,6,7,5,21,22,-1,19,17,25
17376,7064,7070,27,17,18,3,3,12,9,39,-30,9,27,12
17377,7064,7070,59,18,18,2,3,13,11,46,-35,7,29,9
17378,7078,7084,12,1,20,14,2,4,46,16,30,30,10,44
17379,7078,7084,53,8,20,7,8,5,25,23,2,22,18,29
17380,7078,7084,52,3,20,10,7,3,27,19,8,27,13,37
17381,7078,7084,48,15,20,3,9,8,23,33,-10,15,25,18
17382,7078,7084,1,2,20,13,2,5,45,17,28,28,12,41
17383,7078,7084,27,17,20,4,3,13,11,42,-31,11,29,15
17384,7078,7084,59,18,20,2,3,15,13,52,-39,7,33,9
17385,7078,7084,17,7,20,9,3,8,32,26,6,21,19,30
17386,7078,7084,19,12,20,6,6,8,23,30,-7,18,22,24
17387,7078,7084,8,16,20,4,5,11,20,30,-10,13,27,17
17388,7078,7084,37,9,20,6,10,4,20,21,-1,22,18,28
17389,7078,7084,21,11,20,6,7,7,26,20,6,19,21,25
17390,7078,7084,49,5,20,10,6,4,47,22,25,26,14,36
17391,7078,7084,43,4,20,11,3,6,41,20,21,25,15,36
17392,7078,7084,57,6,20,9,4,7,34,32,2,22,18,31
17393,7078,7084,22,14,20,5,6,9,18,44,-26,16,24,21
17394,7078,7084,41,10,20,7,5,8,26,29,-3,19,21,26
17395,7078,7084,20,13,20,5,9,6,20,21,-1,19,21,24
17396,7386,7392,43,1,13,11,1,1,32,9,23,23,3,34
17397,7386,7392,22,8,13,6,1,6,18,18,0,13,13,19
17398,7386,7392,57,14,13,4,3,6,21,29,-8,11,15,15
17399,7386,7392,4,13,13,4,3,6,18,18,0,11,15,15
17400,7386,7392,21,15,13,3,5,5,14,25,-11,11,15,14
17401,7386,7392,17,10,13,5,4,4,23,21,2,14,12,19
17402,7386,7392,19,12,13,5,1,7,25,28,-3,11,15,16
17403,7386,7392,8,17,13,2,3,8,14,31,-17,7,19,9
17404,7386,7392,37,2,13,8,3,2,25,10,15,19,7,27
17405,7386,7392,49,4,13,7,3,3,30,19,11,17,9,24
17406,7386,7392,52,7,13,6,2,5,18,19,-1,14,12,20
17407,7386,7392,48,11,13,4,5,4,15,19,-4,13,13,17
17408,7386,7392,20,6,13,6,2,5,19,17,2,14,12,20
17409,7386,7392,56,9,13,6,1,6,19,22,-3,13,13,19
17410,8128,8141,19,2,16,8,6,2,27,16,11,22,10,30
17411,8128,8141,17,10,16,5,4,7,17,24,-7,14,18,19
17412,8191,8197,21,3,21,12,4,5,32,22,10,28,14,40
17413,8191,8197,4,8,21,8,8,5,31,27,4,24,18,32
17414,8191,8197,56,10,21,6,9,6,23,26,-3,21,21,27
17415,8191,8197,20,14,21,5,5,11,25,34,-9,15,27,20
17416,8191,8197,41,15,21,4,8,9,17,39,-22,16,26,20
17417,8191,8197,13,16,21,2,10,9,21,43,-22,14,28,16
17418,8191,8197,49,2,21,12,5,4,48,23,25,29,13,41
17419,8191,8197,37,7,21,8,8,5,43,22,21,24,18,32
17420,8191,8197,43,1,21,12,6,3,44,23,21,30,12,42
17421,8191,8197,57,13,21,6,6,9,25,31,-6,18,24,24
17422,8191,8197,22,17,21,3,6,12,22,33,-11,12,30,15
17423,8191,8197,1,4,21,10,6,5,33,22,11,26,16,36
17424,8191,8197,19,5,21,10,6,5,34,25,9,26,16,36
17425,8191,8197,17,11,21,7,4,10,21,31,-10,18,24,25
17426,8191,8197,12,6,21,10,5,6,27,19,8,25,17,35
17427,8191,8197,53,12,21,6,7,8,28,37,-9,19,23,25
17428,8191,8197,52,9,21,7,8,6,23,20,3,22,20,29
17429,8191,8197,3,18,21,3,5,13,22,42,-20,11,31,14
17430,8051,8057,3,10,7,2,2,3,10,11,-1,6,8,8
17431,8051,8057,52,12,7,2,2,3,8,12,-4,6,8,8
17432,8051,8057,53,3,7,4,2,1,13,11,2,10,4,14
17433,8051,8057,12,7,7,4,1,2,9,7,2,9,5,13
17434,8051,8057,19,8,7,3,3,1,9,5,4,9,5,12
17435,8051,8057,17,9,7,3,1,3,6,13,-7,7,7,10
17436,8051,8057,1,1,7,5,1,1,11,5,6,11,3,16
17437,8051,8057,37,2,7,4,2,1,16,4,12,10,4,14
17438,8051,8057,49,4,7,4,1,2,20,9,11,9,5,13
17439,8051,8057,43,6,7,4,1,2,12,9,3,9,5,13
17440,8051,8057,22,17,7,1,1,5,5,9,-4,3,11,4
17441,8051,8057,57,18,7,0,1,6,7,15,-8,1,13,1
17442,8051,8057,56,11,7,2,2,3,9,11,-2,6,8,8
17443,8051,8057,13,14,7,1,4,2,6,8,-2,6,8,7
17444,8051,8057,20,15,7,2,0,5,7,12,-5,4,10,6
17445,8051,8057,41,16,7,1,3,3,2,12,-10,5,9,6
17446,8051,8057,21,5,7,4,1,2,11,7,4,9,5,13
17447,8051,8057,4,13,7,1,4,2,7,8,-1,6,8,7
17448,8506,8533,41,12,17,5,5,7,17,24,-7,15,19,20
17449,8506,8533,56,14,17,4,7,6,19,23,-4,15,19,19
17450,8506,8533,43,3,17,9,5,3,41,23,18,23,11,32
17451,8506,8533,57,4,17,8,3,6,20,15,5,19,15,27
17452,8506,8533,24,9,17,4,10,3,21,23,-2,18,16,22
17453,8506,8533,13,2,17,10,4,3,35,18,17,24,10,34
17454,8506,8533,20,5,17,7,5,5,25,18,7,19,15,26
17455,8506,8533,1,7,17,6,7,4,26,21,5,19,15,25
17456,8506,8533,19,8,17,6,5,6,26,26,0,17,17,23
17457,8506,8533,17,10,17,6,3,8,23,27,-4,15,19,21
17458,8506,8533,8,17,17,3,4,10,17,38,-21,10,24,13
17459,8506,8533,12,13,17,5,4,8,18,25,-7,14,20,19
17460,8506,8533,53,15,17,3,9,5,21,31,-10,15,19,18
17461,8506,8533,52,18,17,1,7,9,16,29,-13,9,25,10
17462,8506,8533,37,1,17,12,4,1,34,17,17,28,6,40
17463,8506,8533,49,6,17,7,5,5,24,18,6,19,15,26
17464,8506,8533,21,11,17,5,6,6,22,20,2,16,18,21
17465,8506,8533,4,16,17,4,3,10,19,28,-9,11,23,15
17466,8429,8442,21,6,9,4,2,3,14,10,4,10,8,14
17467,8429,8442,4,11,9,3,1,5,11,13,-2,7,11,10
17468,8429,8442,52,16,9,1,4,4,9,14,-5,6,12,7
17469,8429,8442,12,8,9,4,2,3,11,9,2,10,8,14
17470,8429,8442,53,13,9,2,4,3,13,20,-7,8,10,10
17471,8429,8442,1,10,9,3,3,3,12,14,-2,9,9,12
17472,8429,8442,13,2,9,6,2,1,17,7,10,14,4,20
17473,8429,8442,20,7,9,4,2,3,10,7,3,10,8,14
17474,8429,8442,56,15,9,2,3,4,9,13,-4,7,11,9
17475,8429,8442,41,17,9,1,2,6,7,18,-11,4,14,5
17476,8429,8442,37,1,9,6,3,0,14,8,6,15,3,21
17477,8429,8442,49,5,9,4,2,3,13,8,5,10,8,14
17478,8429,8442,43,3,9,5,2,2,22,10,12,12,6,17
17479,8429,8442,57,4,9,5,1,3,10,7,3,11,7,16
17480,8429,8442,24,9,9,3,5,1,14,11,3,11,7,14
17481,8429,8442,19,12,9,2,4,3,14,14,0,8,10,10
17482,8429,8442,17,14,9,3,0,6,13,17,-4,6,12,9
17483,8429,8442,8,18,9,1,2,6,9,22,-13,4,14,5
17484,8863,8911,4,3,17,10,3,4,41,21,20,23,11,33
17485,8863,8911,21,7,17,5,8,4,19,22,-3,18,16,23
17486,8863,8911,43,1,17,13,4,0,58,15,43,30,4,43
17487,8863,8911,57,13,17,4,6,7,16,24,-8,14,20,18
17488,8863,8911,24,14,17,4,6,7,21,31,-10,14,20,18
17489,8863,8911,2,18,17,3,2,12,18,41,-23,8,26,11
17490,15163,15169,21,16,26,5,8,13,35,52,-17,18,34,23
17491,15163,15169,27,10,26,9,5,12,30,46,-16,23,29,32
17492,15163,15169,49,4,26,13,8,5,49,31,18,34,18,47
17493,15163,15169,37,18,26,2,8,16,27,69,-42,12,40,14
17494,15163,15169,33,6,26,13,4,9,54,32,22,30,22,43
17495,15163,15169,28,8,26,11,4,11,36,36,0,26,26,37
17496,15163,15169,52,11,26,9,4,13,35,46,-11,22,30,31
17497,15163,15169,4,5,26,12,8,6,45,38,7,32,20,44
17498,15436,15442,28,2,14,9,3,2,43,23,20,21,7,30
17499,15436,15442,33,10,14,4,5,5,24,29,-5,13,15,17
17500,15436,15442,49,8,14,5,4,5,24,22,2,14,14,19
17501,15436,15442,37,15,14,4,1,9,15,30,-15,9,19,13
17502,15436,15442,27,17,14,0,5,9,15,38,-23,5,23,5
17503,15436,15442,4,9,14,5,2,7,20,23,-3,12,16,17
17504,15436,15442,21,12,14,4,3,7,22,29,-7,11,17,15
17505,15436,15442,1,1,15,13,1,1,42,13,29,27,3,40
17506,15436,15442,24,16,14,1,4,9,9,37,-28,6,22,7
17507,15436,15442,43,4,14,8,2,4,30,19,11,18,10,26
17508,15436,15442,22,7,14,6,5,3,34,23,11,17,11,23
17509,15436,15442,40,14,14,3,5,6,15,15,0,11,17,14
17510,15436,15442,17,5,14,7,4,3,23,14,9,18,10,25
17511,15436,15442,42,6,15,7,2,6,25,19,6,16,14,23
17512,15436,15442,35,13,14,4,2,8,26,31,-5,10,18,14
17513,15436,15442,12,3,14,9,3,2,32,21,11,21,7,30
17514,15436,15442,25,11,14,5,1,8,11,24,-13,11,17,16
17515,15443,15449,43,4,15,9,2,4,32,20,12,20,10,29
17516,15443,15449,22,5,15,7,5,3,35,23,12,19,11,26
17517,15443,15449,40,15,15,3,5,7,16,17,-1,11,19,14
17518,15443,15449,24,16,15,1,4,10,9,39,-30,6,24,7
17519,15443,15449,12,2,15,9,4,2,33,22,11,22,8,31
17520,15443,15449,25,13,15,5,1,9,12,26,-14,11,19,16
17521,15443,15449,21,10,15,5,3,7,24,29,-5,13,17,18
17522,15443,15449,4,11,15,5,2,8,21,27,-6,12,18,17
17523,15443,15449,37,12,15,5,1,9,18,30,-12,11,19,16
17524,15443,15449,35,14,15,4,2,9,27,34,-7,10,20,14
17525,15443,15449,49,8,15,6,4,5,28,23,5,16,14,22
17526,15443,15449,28,3,15,9,3,3,43,24,19,21,9,30
17527,15443,15449,33,9,15,5,5,5,26,30,-4,15,15,20
17528,15443,15449,27,17,15,0,5,10,15,41,-26,5,25,5
17529,15443,15449,1,1,16,14,1,1,45,14,31,29,3,43
17530,15443,15449,17,6,15,7,5,3,24,15,9,19,11,26
17531,15443,15449,42,7,15,7,2,6,25,19,6,16,14,23
17532,15492,15498,17,5,18,9,5,4,30,23,7,23,13,32
17533,15492,15498,42,6,19,9,2,8,32,25,7,20,18,29
17534,15492,15498,1,1,19,17,1,1,58,16,42,35,3,52
17535,15492,15498,27,16,19,2,5,12,20,46,-26,9,29,11
17536,15492,15498,28,3,18,11,4,3,48,26,22,26,10,37
17537,15492,15498,33,10,19,7,5,7,30,34,-4,19,19,26
17538,15492,15498,12,4,18,11,4,3,38,25,13,26,10,37
17539,15492,15498,25,11,19,7,1,11,16,30,-14,15,23,22
17540,15492,15498,35,14,19,5,3,11,31,39,-8,13,25,18
17541,15492,15498,49,9,19,8,5,6,34,26,8,21,17,29
17542,15492,15498,37,12,19,6,1,12,29,49,-20,13,25,19
17543,15492,15498,4,7,19,9,2,8,31,29,2,20,18,29
17544,15492,15498,21,13,19,5,4,10,26,37,-11,14,24,19
17545,15492,15498,43,2,19,12,2,5,43,24,19,26,12,38
17546,15492,15498,22,8,19,8,5,6,39,31,8,21,17,29
17547,15492,15498,40,15,19,4,5,10,20,26,-6,13,25,17
17548,15492,15498,24,17,19,1,4,14,10,49,-39,6,32,7
17549,15534,15540,43,2,25,17,2,6,54,27,27,36,14,53
17550,15534,15540,22,6,24,11,6,7,53,39,14,28,20,39
17551,15534,15540,40,15,24,5,7,12,27,34,-7,17,31,22
17552,15534,15540,24,17,24,2,5,17,12,65,-53,9,39,11
17553,15534,15540,12,3,24,16,4,4,58,32,26,36,12,52
17554,15534,15540,25,12,24,7,3,14,19,37,-18,17,31,24
17555,15534,15540,17,4,24,13,7,4,41,28,13,33,15,46
17556,15534,15540,42,8,25,11,3,11,37,30,7,25,25,36
17557,15534,15540,4,9,25,11,2,12,38,42,-4,24,26,35
17558,15534,15540,21,13,25,6,5,14,32,47,-15,17,33,23
17559,15534,15540,1,1,25,22,1,2,80,21,59,45,5,67
17560,15534,15540,49,7,25,10,7,8,40,33,7,27,23,37
17561,15534,15540,37,11,24,9,1,14,37,59,-22,19,29,28
17562,15534,15540,35,14,24,6,4,14,35,46,-11,16,32,22
17563,15534,15540,28,5,24,13,5,6,51,32,19,31,17,44
17564,15534,15540,33,10,25,8,5,12,35,51,-16,21,29,29
17565,15534,15540,27,16,25,5,5,15,30,56,-26,15,35,20
17566,15541,15554,28,5,25,14,5,6,53,33,20,33,17,47
17567,15541,15554,33,10,26,8,5,13,36,53,-17,21,31,29
17568,15513,15519,37,11,22,9,1,12,36,52,-16,19,25,28
17569,15513,15519,12,3,21,13,4,4,46,30,16,30,12,43
17570,15513,15519,25,12,22,7,1,14,18,36,-18,15,29,22
17571,15513,15519,43,2,22,14,2,6,49,26,23,30,14,44
17572,15513,15519,22,6,21,10,5,6,47,35,12,25,17,35
17573,15513,15519,40,15,21,4,5,12,22,32,-10,13,29,17
17574,15513,15519,24,17,22,1,5,16,10,60,-50,7,37,8
17575,15513,15519,17,5,21,11,6,4,36,25,11,28,14,39
17576,15513,15519,42,7,22,10,3,9,33,26,7,23,21,33
17577,15513,15519,27,16,22,3,5,14,26,52,-26,11,33,14
17578,15513,15519,1,1,22,20,1,1,74,19,55,41,3,61
17579,15513,15519,28,4,21,12,5,4,50,28,22,29,13,41
17580,15513,15519,33,10,22,8,5,9,35,44,-9,21,23,29
17581,15513,15519,4,8,22,10,2,10,33,35,-2,22,22,32
17582,15513,15519,21,13,22,6,4,12,30,43,-13,16,28,22
17583,15891,15897,4,11,25,6,10,9,24,27,-3,22,28,28
17584,15891,15897,21,17,25,5,4,16,20,50,-30,14,36,19
17585,15891,15897,31,18,25,4,6,15,22,48,-26,14,36,18
17586,15891,15897,33,4,25,12,9,4,49,33,16,33,17,45
17587,15891,15897,1,2,25,15,4,6,52,25,27,34,16,49
17588,15891,15897,27,16,25,5,7,13,23,33,-10,17,33,22
17589,15891,15897,42,12,25,6,9,10,24,32,-8,21,29,27
17590,15891,15897,17,15,25,4,12,9,22,32,-10,20,30,24
17591,15891,15897,25,5,25,12,8,5,38,28,10,32,18,44
17592,15891,15897,12,13,25,6,7,12,31,43,-12,19,31,25
17593,15891,15897,43,1,25,21,2,2,63,19,44,44,6,65
17594,15891,15897,22,6,25,12,6,7,46,32,14,30,20,42
17595,15891,15897,40,10,25,6,11,8,31,35,-4,23,27,29
17596,15891,15897,57,14,25,5,10,10,20,42,-22,20,30,25
17597,15891,15897,49,3,25,14,7,4,53,23,30,35,15,49
17598,15891,15897,37,8,25,10,2,13,35,41,-6,22,28,32
17599,15891,15897,35,7,25,8,10,7,22,25,-3,26,24,34
17600,15891,15897,28,9,25,8,8,9,28,35,-7,24,26,32
17601,16052,16058,37,11,2,0,2,0,3,3,0,2,2,2
17602,16052,16058,49,14,2,0,1,1,2,3,-1,1,3,1
17603,16052,16058,46,18,2,0,0,2,0,2,-2,0,4,0
17604,16052,16058,35,8,2,1,0,1,4,5,-1,2,2,3
17605,16052,16058,25,4,2,1,1,0,5,4,1,3,1,4
17606,16052,16058,12,5,2,1,1,0,3,2,1,3,1,4
17607,16052,16058,40,1,2,2,0,0,7,3,4,4,0,6
17608,16052,16058,22,6,2,1,1,0,1,0,1,3,1,4
17609,16052,16058,43,9,2,1,0,1,2,3,-1,2,2,3
17610,16052,16058,57,13,2,0,1,1,3,4,-1,1,3,1
17611,16052,16058,42,12,2,0,2,0,2,2,0,2,2,2
17612,16052,16058,17,14,2,0,1,1,2,3,-1,1,3,1
17613,16052,16058,27,10,2,1,0,1,4,6,-2,2,2,3
17614,16052,16058,1,2,2,1,1,0,6,1,5,3,1,4
17615,16052,16058,33,3,2,1,1,0,2,0,2,3,1,4
17616,16052,16058,28,16,2,0,1,1,1,2,-1,1,3,1
17617,16052,16058,4,7,2,1,0,1,5,5,0,2,2,3
17618,16052,16058,9,17,2,0,1,1,3,7,-4,1,3,1
17619,16668,16674,4,4,32,17,6,9,46,34,12,40,24,57
17620,16668,16674,33,13,32,10,4,18,40,42,-2,24,40,34
17621,16668,16674,28,14,32,8,10,14,36,45,-9,26,38,34
17622,16668,16674,1,3,32,17,9,6,47,32,15,43,21,60
17623,16668,16674,45,6,32,14,7,11,50,44,6,35,29,49
17624,16668,16674,27,8,32,11,11,10,37,36,1,33,31,44
17625,16668,16674,17,17,32,7,8,17,20,50,-30,22,42,29
17626,16668,16674,12,7,32,12,11,9,47,45,2,35,29,47
17627,16668,16674,25,10,32,11,7,14,38,46,-8,29,35,40
17628,16668,16674,43,1,32,19,9,4,69,27,42,47,17,66
17629,16668,16674,22,5,32,15,9,8,46,35,11,39,25,54
17630,16668,16674,51,11,32,10,10,12,44,41,3,30,34,40
17631,16668,16674,57,15,32,8,8,16,35,56,-21,24,40,32
17632,16668,16674,40,18,32,4,13,15,23,48,-25,21,43,25
17633,16668,16674,35,9,32,12,7,13,42,43,-1,31,33,43
17634,16668,16674,49,2,32,19,7,6,51,26,25,45,19,64
17635,16668,16674,46,12,32,10,10,12,27,29,-2,30,34,40
17636,16668,16674,37,16,32,8,6,18,34,53,-19,22,42,30
17637,16892,16898,49,4,15,8,3,4,26,16,10,19,11,27
17638,16892,16898,37,12,15,4,4,7,14,22,-8,12,18,16
17639,16892,16898,46,13,15,3,7,5,15,18,-3,13,17,16
17640,16892,16898,35,8,15,6,4,5,19,20,-1,16,14,22
17641,16892,16898,1,3,15,9,3,3,31,14,17,21,9,30
17642,16892,16898,22,1,15,11,4,0,34,11,23,26,4,37
17643,16892,16898,43,2,15,9,4,2,28,16,12,22,8,31
17644,16892,16898,51,9,15,5,4,6,25,27,-2,14,16,19
17645,16892,16898,57,16,15,4,2,9,13,18,-5,10,20,14
17646,16892,16898,25,7,15,7,3,5,22,20,2,17,13,24
17647,18677,18683,42,7,11,4,4,3,24,19,5,12,10,16
17648,18677,18683,17,14,11,1,6,4,6,11,-5,8,14,9
17649,18719,18725,42,7,16,6,5,5,31,27,4,17,15,23
17650,18719,18725,17,14,16,2,7,7,12,21,-9,11,21,13
17651,18719,18725,56,5,16,8,3,5,23,19,4,19,13,27
17652,18719,18725,35,9,16,5,6,5,27,23,4,16,16,21
17653,18719,18725,12,10,16,4,6,6,22,24,-2,14,18,18
17654,18719,18725,25,16,16,2,4,10,13,29,-16,8,24,10
17655,18719,18725,1,3,16,9,4,3,29,18,11,22,10,31
17656,18719,18725,28,15,16,2,4,10,24,39,-15,8,24,10
17657,18719,18725,4,2,16,10,3,3,38,18,20,23,9,33
17658,18719,18725,49,4,16,8,5,3,22,20,2,21,11,29
17659,18719,18725,16,12,16,4,3,9,17,29,-12,11,21,15
17660,18719,18725,43,1,16,11,3,2,32,13,19,25,7,36
17661,18719,18725,57,6,16,7,6,3,20,15,5,20,12,27
17662,18719,18725,22,8,16,6,5,5,28,24,4,17,15,23
17663,18719,18725,24,11,16,4,4,8,20,32,-12,12,20,16
17664,18719,18725,45,13,16,2,8,6,15,22,-7,12,20,14
17665,18600,18606,22,3,2,1,1,0,3,1,2,3,1,4
17666,18600,18606,57,4,2,1,1,0,2,1,1,3,1,4
17667,18600,18606,43,6,2,1,0,1,4,3,1,2,2,3
17668,18600,18606,24,8,2,1,0,1,3,4,-1,2,2,3
17669,18600,18606,4,13,2,0,1,1,2,3,-1,1,3,1
17670,18600,18606,1,1,2,1,1,0,8,3,5,3,1,4
17671,18600,18606,12,15,2,0,1,1,1,3,-2,1,3,1
17672,18600,18606,25,16,2,0,1,1,0,5,-5,1,3,1
17673,18600,18606,28,12,2,0,1,1,4,5,-1,1,3,1
17674,18600,18606,56,10,2,0,2,0,1,1,0,2,2,2
17675,18600,18606,35,14,2,0,1,1,3,5,-2,1,3,1
17676,18600,18606,45,4,2,1,1,0,2,1,1,3,1,4
17677,18600,18606,49,2,2,1,1,0,4,2,2,3,1,4
17678,18600,18606,16,7,2,1,0,1,3,3,0,2,2,3
17679,18600,18606,42,9,2,0,2,0,2,2,0,2,2,2
17680,18600,18606,17,10,2,0,2,0,1,1,0,2,2,2
17681,18761,18767,42,8,20,7,6,7,36,36,0,20,20,27
17682,18761,18767,17,13,20,4,8,8,16,26,-10,16,24,20
17683,18761,18767,56,4,20,10,4,6,26,21,5,24,16,34
17684,18761,18767,35,9,20,6,7,7,30,32,-2,19,21,25
17685,18761,18767,45,14,20,2,10,8,20,29,-9,14,26,16
17686,18761,18767,4,2,20,12,3,5,43,22,21,27,13,39
17687,18761,18767,12,12,20,4,9,7,26,29,-3,17,23,21
17688,18761,18767,25,15,20,3,4,13,18,37,-19,10,30,13
17689,18761,18767,1,3,20,11,4,5,32,24,8,26,14,37
17690,18761,18767,28,16,20,2,7,11,24,40,-16,11,29,13
17691,18761,18767,43,1,20,13,4,3,40,18,22,30,10,43
17692,18761,18767,57,6,20,9,6,5,27,21,6,24,16,33
17693,18761,18767,22,7,20,8,7,5,37,27,10,23,17,31
17694,18761,18767,24,10,20,6,6,8,28,36,-8,18,22,24
17695,18761,18767,49,5,20,9,7,4,29,24,5,25,15,34
17696,18761,18767,16,11,20,5,6,9,25,35,-10,16,24,21
17697,18803,18809,28,16,27,2,9,16,28,56,-28,13,41,15
17698,18803,18809,43,1,27,18,6,3,53,23,30,42,12,60
17699,18803,18809,57,4,27,13,7,7,35,30,5,33,21,46
17700,18803,18809,22,6,27,12,7,8,53,37,16,31,23,43
17701,18803,18809,24,8,27,10,7,10,39,44,-5,27,27,37
17702,18803,18809,1,2,27,16,4,7,47,31,16,36,18,52
17703,18803,18809,12,9,27,9,10,8,41,38,3,28,26,37
17704,18803,18809,25,15,27,4,5,18,25,51,-26,13,41,17
17705,18803,18809,4,3,27,15,5,7,57,31,26,35,19,50
17706,18803,18809,45,13,27,5,12,10,29,35,-6,22,32,27
17707,18803,18809,56,7,27,11,7,9,33,31,2,29,25,40
17708,18803,18809,35,10,27,9,8,10,41,43,-2,26,28,35
17709,18803,18809,49,5,27,12,9,6,37,31,6,33,21,45
17710,18803,18809,16,14,27,6,7,14,35,53,-18,19,35,25
17711,18803,18809,42,11,27,7,8,12,43,51,-8,22,32,29
17712,18803,18809,17,12,27,6,11,10,23,34,-11,23,31,29
17713,18614,18620,42,7,4,1,3,0,8,6,2,5,3,6
17714,18614,18620,17,14,4,0,3,1,3,4,-1,3,5,3
17715,18614,18620,49,3,4,2,1,1,8,6,2,5,3,7
17716,18614,18620,16,13,4,1,0,3,4,6,-2,2,6,3
17717,18614,18620,28,15,4,0,1,3,6,11,-5,1,7,1
17718,18614,18620,35,10,4,1,2,1,7,7,0,4,4,5
17719,18614,18620,56,11,4,1,2,1,4,4,0,4,4,5
17720,18614,18620,12,12,4,1,1,2,3,4,-1,3,5,4
17721,18614,18620,25,16,4,0,1,3,3,11,-8,1,7,1
17722,18614,18620,1,2,4,2,2,0,10,4,6,6,2,8
17723,18614,18620,4,3,4,2,1,1,8,6,2,5,3,7
17724,18614,18620,24,1,4,3,0,1,7,6,1,6,2,9
17725,18614,18620,43,5,4,2,1,1,7,5,2,5,3,7
17726,18614,18620,57,6,4,2,1,1,5,5,0,5,3,7
17727,8978,8981,41,3,25,13,8,4,45,24,21,34,16,47
17728,8978,8981,13,12,25,7,6,12,30,46,-16,20,30,27
17729,8978,8981,56,13,25,7,6,12,30,48,-18,20,30,27
17730,8978,8981,12,9,25,8,7,10,36,40,-4,23,27,31
17731,8978,8981,53,16,25,6,6,13,33,50,-17,18,32,24
17732,8978,8981,11,17,25,4,7,14,27,51,-24,15,35,19
17733,8765,8771,37,3,3,2,1,0,7,2,5,5,1,7
17734,8765,8771,49,5,3,1,2,0,6,5,1,4,2,5
17735,8765,8771,1,4,3,2,1,0,4,1,3,5,1,7
17736,8765,8771,13,6,3,1,2,0,5,4,1,4,2,5
17737,8765,8771,41,9,3,1,1,1,4,3,1,3,3,4
17738,8765,8771,20,12,3,1,0,2,3,6,-3,2,4,3
17739,8765,8771,56,16,3,0,1,2,1,5,-4,1,5,1
17740,8765,8771,17,11,3,1,0,2,4,5,-1,2,4,3
17741,8765,8771,19,15,3,0,2,1,1,5,-4,2,4,2
17742,8765,8771,4,2,3,2,1,0,11,4,7,5,1,7
17743,8765,8771,21,7,3,1,2,0,4,3,1,4,2,5
17744,8765,8771,43,1,3,2,1,0,18,5,13,5,1,7
17745,8765,8771,24,13,3,0,3,0,3,3,0,3,3,3
17746,8765,8771,57,14,3,0,2,1,2,3,-1,2,4,2
17747,8765,8771,2,18,3,0,0,3,4,15,-11,0,6,0
17748,8765,8771,11,8,3,1,1,1,5,3,2,3,3,4
17749,8765,8771,12,10,3,1,1,1,4,9,-5,3,3,4
17750,8765,8771,53,17,3,0,1,2,3,8,-5,1,5,1
17751,9185,9198,43,2,13,8,3,2,31,15,16,19,7,27
17752,9185,9198,57,6,13,6,2,5,22,20,2,14,12,20
17753,9185,9198,24,13,13,2,7,4,13,20,-7,11,15,13
17754,9185,9198,37,7,13,6,2,5,21,23,-2,14,12,20
17755,9185,9198,49,9,13,5,4,4,18,17,1,14,12,19
17756,9185,9198,52,16,13,2,5,6,12,24,-12,9,17,11
17757,9185,9198,41,4,13,7,2,4,22,15,7,16,10,23
17758,9185,9198,20,8,13,5,4,4,20,9,11,14,12,19
17759,9185,9198,13,11,13,4,5,4,10,11,-1,13,13,17
17760,9185,9198,56,18,13,1,5,7,11,23,-12,7,19,8
17761,9185,9198,17,10,13,4,5,4,15,14,1,13,13,17
17762,9185,9198,19,17,13,2,3,8,12,31,-19,7,19,9
17763,9185,9198,1,1,13,10,1,2,34,12,22,21,5,31
17764,9185,9198,53,5,13,6,5,2,22,15,7,17,9,23
17765,9185,9198,12,12,13,3,4,6,15,25,-10,10,16,13
17766,9185,9198,4,3,13,8,2,3,22,10,12,18,8,26
17767,9185,9198,21,15,13,2,5,6,12,21,-9,9,17,11
17768,9185,9198,27,14,13,3,2,8,16,23,-7,8,18,11
17769,9199,9205,27,13,14,4,2,8,17,23,-6,10,18,14
17770,9199,9205,4,3,14,8,3,3,22,10,12,19,9,27
17771,9199,9205,21,14,14,3,5,6,13,21,-8,11,17,14
17772,9199,9205,53,6,14,6,5,3,23,20,3,17,11,23
17773,9199,9205,12,15,14,3,4,7,15,26,-11,10,18,13
17774,9199,9205,1,1,14,10,2,2,34,12,22,22,6,32
17775,9199,9205,17,11,14,4,5,5,15,15,0,13,15,17
17776,9199,9205,19,16,14,3,3,8,13,31,-18,9,19,12
17777,9199,9205,41,4,14,7,2,5,22,16,6,16,12,23
17778,9199,9205,20,7,14,6,4,4,25,10,15,16,12,22
17779,9199,9205,13,10,14,4,6,4,11,12,-1,14,14,18
17780,9199,9205,56,18,14,1,5,8,11,24,-13,7,21,8
17781,9199,9205,52,17,14,2,5,7,13,28,-15,9,19,11
17782,9199,9205,37,5,14,7,2,5,25,24,1,16,12,23
17783,9199,9205,49,9,14,5,5,4,18,17,1,15,13,20
17784,9199,9205,43,2,14,8,4,2,31,15,16,20,8,28
17785,9199,9205,57,8,14,6,3,5,23,21,2,15,13,21
17786,9199,9205,24,12,14,3,7,4,14,20,-6,13,15,16
17787,9234,9240,43,2,19,12,5,2,48,21,27,29,9,41
17788,9234,9240,57,8,19,7,5,7,29,28,1,19,19,26
17789,9234,9240,24,12,19,4,9,6,19,28,-9,17,21,21
17790,9234,9240,52,17,19,3,6,10,17,33,-16,12,26,15
17791,9234,9240,20,5,19,9,4,6,31,15,16,22,16,31
17792,9234,9240,41,7,19,9,3,7,28,25,3,21,17,30
17793,9234,9240,13,13,19,4,8,7,13,18,-5,16,22,20
17794,9234,9240,56,16,19,4,5,10,19,31,-12,13,25,17
17795,9234,9240,37,4,19,10,3,6,31,26,5,23,15,33
17796,9234,9240,49,9,19,6,7,6,25,22,3,19,19,25
17797,9234,9240,17,15,19,4,6,9,19,31,-12,14,24,18
17798,9234,9240,19,18,19,3,5,11,16,40,-24,11,27,14
17799,9234,9240,4,3,19,10,4,5,31,18,13,24,14,34
17800,9234,9240,21,10,19,6,7,6,20,25,-5,19,19,25
17801,9234,9240,1,1,19,14,3,2,44,17,27,31,7,45
17802,9234,9240,27,14,19,5,3,11,24,33,-9,13,25,18
17803,9234,9240,53,6,19,8,7,4,31,25,6,23,15,31
17804,9234,9240,12,11,19,6,4,9,24,33,-9,16,22,22
17805,9304,9317,27,15,27,7,5,15,32,48,-16,19,35,26
17806,7386,7392,41,18,13,2,1,10,13,23,-10,5,21,7
17807,7386,7392,12,3,13,8,1,4,23,12,11,17,9,25
17808,7386,7392,53,16,13,3,1,9,13,24,-11,7,19,10
17809,7386,7392,1,5,13,6,2,5,23,19,4,14,12,20
17810,7400,7406,1,5,15,7,2,6,28,23,5,16,14,23
17811,7400,7406,12,4,15,8,2,5,25,17,8,18,12,26
17812,7400,7406,53,17,15,3,2,10,14,26,-12,8,22,11
17813,7400,7406,56,6,15,7,2,6,23,24,-1,16,14,23
17814,7400,7406,20,10,15,6,3,6,21,21,0,15,15,21
17815,7400,7406,41,16,15,3,2,10,17,24,-7,8,22,11
17816,7400,7406,52,7,15,7,2,6,19,22,-3,16,14,23
17817,7400,7406,48,14,15,4,5,6,16,26,-10,13,17,17
17818,7400,7406,37,2,15,10,3,2,30,11,19,23,7,33
17819,7400,7406,49,3,15,8,4,3,32,20,12,20,10,28
17820,7400,7406,17,9,15,6,4,5,29,23,6,16,14,22
17821,7400,7406,19,13,15,5,2,8,26,32,-6,12,18,17
17822,7400,7406,8,18,15,2,3,10,16,36,-20,7,23,9
17823,7400,7406,21,11,15,5,5,5,21,28,-7,15,15,20
17824,7400,7406,4,15,15,4,4,7,19,20,-1,12,18,16
17825,7400,7406,43,1,15,13,1,1,35,10,25,27,3,40
17826,7400,7406,22,8,15,7,1,7,20,20,0,15,15,22
17827,7400,7406,57,12,15,5,3,7,22,30,-8,13,17,18
17828,7442,7448,43,1,18,14,2,2,36,12,24,30,6,44
17829,7442,7448,22,8,18,8,2,8,23,24,-1,18,18,26
17830,7442,7448,57,13,18,6,4,8,29,36,-7,16,20,22
17831,7442,7448,21,9,18,7,5,6,27,31,-4,19,17,26
17832,7442,7448,4,10,18,7,4,7,33,26,7,18,18,25
17833,7442,7448,17,6,18,7,6,5,32,24,8,20,16,27
17834,7442,7448,19,15,18,5,2,11,32,47,-15,12,24,17
17835,7442,7448,8,17,18,4,3,11,23,41,-18,11,25,15
17836,7442,7448,37,2,18,12,4,2,33,12,21,28,8,40
17837,7442,7448,49,3,18,10,5,3,37,22,15,25,11,35
17838,7442,7448,52,5,18,9,2,7,26,28,-2,20,16,29
17839,7442,7448,48,14,18,4,6,8,18,34,-16,14,22,18
17840,7442,7448,20,11,18,7,4,7,23,24,-1,18,18,25
17841,7442,7448,56,12,18,7,3,8,24,28,-4,17,19,24
17842,7442,7448,41,16,18,4,3,11,24,31,-7,11,25,15
17843,7442,7448,12,4,18,9,3,6,28,19,9,21,15,30
17844,7442,7448,53,18,18,3,2,13,15,31,-16,8,28,11
17845,7442,7448,1,7,18,8,2,8,36,29,7,18,18,26
17846,7526,7532,1,5,29,14,4,11,63,46,17,32,26,46
17847,7526,7532,53,16,29,7,6,16,32,47,-15,20,38,27
17848,7526,7532,52,7,29,12,5,12,40,42,-2,29,29,41
17849,7526,7532,48,18,29,5,9,15,24,66,-42,19,39,24
17850,7526,7532,20,11,29,9,9,11,35,38,-3,27,31,36
17851,7526,7532,41,12,29,9,7,13,43,39,4,25,33,34
17852,7526,7532,56,13,29,9,7,13,34,48,-14,25,33,34
17853,7526,7532,12,2,29,16,6,7,58,31,27,38,20,54
17854,7526,7532,4,8,29,11,8,10,45,40,5,30,28,41
17855,7526,7532,21,9,29,10,10,9,37,41,-4,30,28,40
17856,7526,7532,17,10,29,9,11,9,47,43,4,29,29,38
17857,7526,7532,19,15,29,9,4,16,45,62,-17,22,36,31
17858,7526,7532,8,17,29,6,7,16,31,56,-25,19,39,25
17859,7526,7532,37,3,29,16,6,7,46,27,19,38,20,54
17860,7526,7532,49,4,29,15,5,9,53,40,13,35,23,50
17861,7526,7532,43,1,29,22,5,2,67,19,48,49,9,71
17862,7526,7532,22,6,29,13,5,11,38,39,-1,31,27,44
17863,7526,7532,57,14,29,9,6,14,43,57,-14,24,34,33
17864,7351,7357,20,9,9,4,1,4,14,13,1,9,9,13
17865,7351,7357,56,10,9,4,1,4,13,15,-2,9,9,13
17866,7351,7357,41,18,9,0,1,8,7,20,-13,1,17,1
17867,7351,7357,43,1,9,7,1,1,24,9,15,15,3,22
17868,7351,7357,22,11,9,4,0,5,13,14,-1,8,10,12
17869,7351,7357,57,14,9,3,1,5,17,23,-6,7,11,10
17870,7351,7357,17,6,9,4,3,2,19,13,6,11,7,15
17871,7351,7357,19,8,9,4,1,4,18,17,1,9,9,13
17872,7351,7357,8,15,9,2,2,5,10,18,-8,6,12,8
17873,7351,7357,21,13,9,3,2,4,9,19,-10,8,10,11
17874,7351,7357,4,16,9,2,2,5,6,14,-8,6,12,8
17875,7351,7357,37,2,9,6,1,2,18,8,10,13,5,19
17876,7351,7357,49,3,9,5,3,1,24,12,12,13,5,18
17877,7351,7357,52,4,9,5,2,2,13,9,4,12,6,17
17878,7351,7357,48,12,9,3,3,3,11,16,-5,9,9,12
17879,7351,7357,12,5,9,5,1,3,17,9,8,11,7,16
17880,7351,7357,53,17,9,2,1,6,11,16,-5,5,13,7
17881,7351,7357,1,7,9,4,2,3,16,15,1,10,8,14
17882,7722,7735,1,17,10,2,1,7,13,19,-6,5,15,7
17883,7722,7735,52,6,10,5,1,4,16,15,1,11,9,16
17884,7722,7735,3,14,10,3,2,5,12,16,-4,8,12,11
17885,13707,13713,37,16,26,5,8,13,23,40,-17,18,34,23
17886,13707,13713,17,7,26,11,6,9,41,34,7,28,24,39
17887,13707,13713,47,4,26,12,9,5,43,25,18,33,19,45
17888,13707,13713,1,1,26,21,4,1,60,21,39,46,6,67
17889,13707,13713,4,11,26,7,11,8,35,36,-1,25,27,32
17890,13707,13713,21,18,26,4,6,16,26,48,-22,14,38,18
17891,13707,13713,12,6,26,13,1,12,53,53,0,27,25,40
17892,13707,13713,25,13,26,7,9,10,38,43,-5,23,29,30
17893,13707,13713,28,10,26,8,8,10,24,29,-5,24,28,32
17894,13707,13713,33,14,26,7,7,12,29,39,-10,21,31,28
17895,13707,13713,52,17,26,5,4,17,27,63,-36,14,38,19
17896,13707,13713,35,3,26,14,5,7,48,36,12,33,19,47
17897,13707,13713,6,8,26,10,6,10,40,39,1,26,26,36
17898,13763,13867,6,11,34,10,11,13,46,50,-4,31,37,41
17899,13763,13867,4,8,34,11,14,9,50,44,6,36,32,47
17900,13763,13867,21,18,34,6,7,21,38,71,-33,19,49,25
17901,13763,13867,1,1,34,26,6,2,78,29,49,58,10,84
17902,13763,13867,47,5,34,15,10,9,50,31,19,40,28,55
17903,13763,13867,17,7,34,14,8,12,54,45,9,36,32,50
17904,13763,13867,49,9,34,11,10,13,53,50,3,32,36,43
17905,13763,13867,37,16,34,7,11,16,30,48,-18,25,43,32
17906,13763,13867,33,10,34,11,8,15,39,45,-6,30,38,41
17907,13763,13867,28,14,34,8,13,13,32,45,-13,29,39,37
17908,13763,13867,52,17,34,8,7,19,39,74,-35,23,45,31
17909,13763,13867,35,3,34,17,7,10,60,48,12,41,27,58
17910,13763,13867,27,13,34,9,12,13,46,57,-11,30,38,39
17911,13763,13867,12,6,34,16,4,14,68,68,0,36,32,52
17912,13763,13867,25,12,34,9,14,11,52,56,-4,32,36,41
17913,13763,13867,22,2,34,20,6,8,65,40,25,46,22,66
17914,13763,13867,43,4,34,16,9,9,53,37,16,41,27,57
17915,13763,13867,34,15,34,9,9,16,51,66,-15,27,41,36
17916,14043,14056,12,5,23,12,4,7,49,35,14,28,18,40
17917,14043,14056,25,11,23,9,3,11,43,43,0,21,25,30
17918,14043,14056,35,9,23,10,4,9,36,34,2,24,22,34
17919,14043,14056,6,15,23,5,4,14,23,36,-13,14,32,19
17920,14043,14056,56,17,23,3,5,15,32,59,-27,11,35,14
17921,14043,14056,27,14,23,4,9,10,27,36,-9,17,29,21
17922,14043,14056,33,3,23,12,7,4,52,35,17,31,15,43
17923,14043,14056,28,7,23,11,6,6,32,24,8,28,18,39
17924,14043,14056,22,1,23,15,5,3,51,26,25,35,11,50
17925,14043,14056,43,4,23,12,5,6,43,32,11,29,17,41
17926,14043,14056,34,12,23,7,5,11,31,41,-10,19,27,26
17927,14043,14056,49,8,23,12,2,9,37,27,10,26,20,38
17928,14043,14056,37,16,23,4,5,14,24,41,-17,13,33,17
17929,14043,14056,17,10,23,10,3,10,43,37,6,23,23,33
17930,14043,14056,47,13,23,6,8,9,29,36,-7,20,26,26
17931,14043,14056,1,2,23,15,4,4,42,22,20,34,12,49
17932,14043,14056,4,6,23,11,7,5,40,38,2,29,17,40
17933,14043,14056,9,18,23,2,8,13,21,53,-32,12,34,14
17934,14057,14063,4,6,24,11,8,5,41,39,2,30,18,41
17935,14057,14063,9,18,24,2,8,14,22,55,-33,12,36,14
17936,14057,14063,1,2,24,16,4,4,46,22,24,36,12,52
17937,14057,14063,47,13,24,7,8,9,31,36,-5,22,26,29
17938,14057,14063,17,9,24,11,3,10,45,37,8,25,23,36
17939,14057,14063,49,5,24,13,2,9,43,27,16,28,20,41
17940,14057,14063,37,16,24,4,5,15,24,47,-23,13,35,17
17941,14057,14063,22,1,24,16,5,3,54,27,27,37,11,53
17942,14057,14063,43,4,24,13,5,6,47,33,14,31,17,44
17943,14057,14063,34,12,24,8,5,11,34,41,-7,21,27,29
17944,14057,14063,33,3,24,13,7,4,54,36,18,33,15,46
17945,14057,14063,28,8,24,11,6,7,33,28,5,28,20,39
17946,14057,14063,27,14,24,4,10,10,28,37,-9,18,30,22
17947,14057,14063,35,10,24,10,4,10,36,36,0,24,24,34
17948,14057,14063,6,15,24,5,4,15,23,39,-16,14,34,19
17949,14057,14063,56,17,24,3,5,16,33,62,-29,11,37,14
17950,14057,14063,12,7,24,12,4,8,49,39,10,28,20,40
17951,14057,14063,25,11,24,9,3,12,43,45,-2,21,27,30
17952,14085,14105,17,9,28,13,5,10,57,40,17,31,25,44
17953,14085,14105,35,10,28,11,6,11,39,39,0,28,28,39
17954,14085,14105,6,15,28,5,5,18,24,45,-21,15,41,20
17955,14085,14105,56,17,28,4,6,18,37,68,-31,14,42,18
17956,14085,14105,22,1,28,18,6,4,60,30,30,42,14,60
17957,14085,14105,43,3,28,16,6,6,55,36,19,38,18,54
17958,14085,14105,34,13,28,8,7,13,39,51,-12,23,33,31
17959,14085,14105,33,4,28,15,7,6,64,43,21,37,19,52
17960,14085,14105,28,7,28,13,7,8,46,35,11,33,23,46
17961,14085,14105,49,5,28,16,2,10,50,30,20,34,22,50
17962,14085,14105,37,16,28,5,5,18,27,54,-27,15,41,20
17963,18614,18620,22,9,4,1,2,1,7,6,1,4,4,5
17964,18614,18620,45,8,4,1,3,0,5,4,1,5,3,6
17965,19041,19047,43,2,11,6,4,1,20,10,10,16,6,22
17966,19041,19047,22,3,11,5,6,0,20,12,8,16,6,21
17967,19041,19047,24,10,11,4,2,5,18,17,1,10,12,14
17968,19041,19047,57,16,11,1,1,9,9,26,-17,3,19,4
17969,19041,19047,45,5,11,6,1,4,19,16,3,13,9,19
17970,19041,19047,1,1,11,6,4,1,26,16,10,16,6,22
17971,19041,19047,12,9,11,4,3,4,17,16,1,11,11,15
17972,19041,19047,4,7,11,4,4,3,15,14,1,12,10,16
17973,19041,19047,27,13,11,3,1,7,11,23,-12,7,15,10
17974,19041,19047,10,15,11,1,4,6,11,21,-10,6,16,7
17975,19041,19047,56,4,11,6,2,3,13,10,3,14,8,20
17976,19041,19047,35,11,11,4,2,5,15,18,-3,10,12,14
17977,19041,19047,16,6,11,4,5,2,25,18,7,13,9,17
17978,19041,19047,49,12,11,4,1,6,21,21,0,9,13,13
17979,19041,19047,42,8,11,4,3,4,22,21,1,11,11,15
17980,19041,19047,17,14,11,1,7,3,11,14,-3,9,13,10
17981,18985,18991,1,1,5,4,1,0,13,6,7,9,1,13
17982,18985,18991,49,3,5,3,1,1,12,6,6,7,3,10
17983,18985,18991,16,10,5,1,3,1,9,11,-2,5,5,6
17984,18985,18991,17,9,5,1,3,1,5,4,1,5,5,6
17985,18985,18991,42,11,5,1,2,2,10,10,0,4,6,5
17986,18985,18991,4,4,5,3,1,1,8,5,3,7,3,10
17987,18985,18991,27,14,5,1,0,4,5,13,-8,2,8,3
17988,18985,18991,12,7,5,2,1,2,9,8,1,5,5,7
17989,18985,18991,56,8,5,2,1,2,5,6,-1,5,5,7
17990,18985,18991,35,13,5,1,1,3,6,9,-3,3,7,4
17991,18985,18991,43,2,5,3,2,0,8,3,5,8,2,11
17992,18985,18991,22,6,5,2,3,0,9,6,3,7,3,9
17993,18985,18991,24,11,5,1,2,2,10,10,0,4,6,5
17994,18985,18991,57,16,5,0,1,4,6,14,-8,1,9,1
17995,18985,18991,10,15,5,0,1,4,3,10,-7,1,9,1
17996,18985,18991,45,5,5,3,1,1,7,4,3,7,3,10
17997,19013,19019,45,6,8,4,1,3,12,11,1,9,7,13
17998,19013,19019,27,14,8,2,1,5,10,18,-8,5,11,7
17999,19013,19019,10,15,8,1,3,4,7,12,-5,5,11,6
18000,19013,19019,43,2,8,4,4,0,14,8,6,12,4,16
18001,19013,19019,22,4,8,3,5,0,14,10,4,11,5,14
18002,19013,19019,24,7,8,3,2,3,15,12,3,8,8,11
18003,19013,19019,57,16,8,0,1,7,6,21,-15,1,15,1
18004,19013,19019,1,1,8,6,2,0,22,9,13,14,2,20
18005,19013,19019,12,8,8,3,2,3,12,11,1,8,8,11
18006,19013,19019,4,3,8,4,2,2,11,9,2,10,6,14
18007,19013,19019,17,11,8,1,6,1,8,7,1,8,8,9
18008,19013,19019,42,12,8,2,2,4,16,18,-2,6,10,8
18009,19013,19019,49,10,8,3,1,4,17,15,2,7,9,10
18010,19013,19019,16,13,8,1,5,2,12,15,-3,7,9,8
18011,19013,19019,35,5,8,4,1,3,13,12,1,9,7,13
18012,19013,19019,56,9,8,3,2,3,8,9,-1,8,8,11
18013,19328,19334,49,2,2,2,0,0,5,0,5,4,0,6
18014,19328,19334,16,14,2,0,0,2,1,5,-4,0,4,0
18015,19328,19334,42,10,2,0,1,1,2,3,-1,1,3,1
18016,19328,19334,17,14,2,0,0,2,1,5,-4,0,4,0
18017,19328,19334,4,6,2,1,1,0,3,2,1,3,1,4
18018,19328,19334,9,14,2,0,0,2,1,5,-4,0,4,0
18019,19328,19334,45,5,2,2,0,0,3,1,2,4,0,6
18020,19328,19334,10,9,2,0,2,0,2,2,0,2,2,2
18021,19328,19334,27,11,2,0,1,1,1,3,-2,1,3,1
18022,19328,19334,12,4,2,2,0,0,5,3,2,4,0,6
18023,19328,19334,56,8,2,1,0,1,1,1,0,2,2,3
18024,19328,19334,1,3,2,2,0,0,4,1,3,4,0,6
18025,19328,19334,22,1,2,2,0,0,7,1,6,4,0,6
18026,19328,19334,43,7,2,1,0,1,6,3,3,2,2,3
18027,19328,19334,57,12,2,0,1,1,1,5,-4,1,3,1
18028,19328,19334,24,13,2,0,0,2,1,4,-3,0,4,0
18029,19335,19341,43,5,3,2,0,1,10,4,6,4,2,6
18030,19335,19341,22,6,3,2,0,1,7,3,4,4,2,6
18031,19335,19341,57,11,3,0,2,1,2,6,-4,2,4,2
18032,19335,19341,24,13,3,0,1,2,1,4,-3,1,5,1
18033,19335,19341,1,2,3,2,1,0,5,2,3,5,1,7
18034,19335,19341,56,7,3,1,1,1,4,4,0,3,3,4
18035,19335,19341,12,3,3,2,1,0,8,6,2,5,1,7
18036,19335,19341,45,4,3,2,1,0,4,2,2,5,1,7
18037,19335,19341,27,8,3,1,1,1,3,4,-1,3,3,4
18038,19335,19341,10,10,3,0,3,0,2,2,0,3,3,3
18039,19335,19341,4,9,3,1,1,1,4,6,-2,3,3,4
18040,19335,19341,9,14,3,0,1,2,2,6,-4,1,5,1
18041,19335,19341,42,12,3,0,1,2,3,5,-2,1,5,1
18042,19335,19341,17,14,3,0,1,2,2,6,-4,1,5,1
18043,19335,19341,49,1,3,3,0,0,7,0,7,6,0,9
18044,19335,19341,16,14,3,0,1,2,2,6,-4,1,5,1
18045,19552,19684,49,1,30,20,7,3,59,17,42,47,13,67
18046,7722,7735,12,9,10,4,2,4,10,10,0,10,10,14
18047,7722,7735,17,3,10,6,2,2,15,11,4,14,6,20
18048,7722,7735,8,11,10,3,3,4,11,15,-4,9,11,12
18049,7722,7735,19,12,10,3,3,4,11,17,-6,9,11,12
18050,7722,7735,56,5,10,5,2,3,14,13,1,12,8,17
18051,7722,7735,41,7,10,4,3,3,14,9,5,11,9,15
18052,7722,7735,20,15,10,2,3,5,8,9,-1,7,13,9
18053,7722,7735,4,1,10,7,2,1,16,6,10,16,4,23
18054,7722,7735,21,8,10,4,3,3,13,9,4,11,9,15
18055,7722,7735,49,4,10,5,4,1,17,8,9,14,6,19
18056,7722,7735,37,10,10,3,4,3,7,8,-1,10,10,13
18057,7722,7735,43,2,10,6,2,2,21,11,10,14,6,20
18058,7722,7735,57,13,10,3,2,5,18,21,-3,8,12,11
18059,7722,7735,22,16,10,2,3,5,7,17,-10,7,13,9
18060,7722,7735,24,18,10,0,4,6,8,17,-9,4,16,4
18061,7806,7812,43,1,19,11,4,4,33,21,12,26,12,37
18062,7806,7812,22,15,19,5,5,9,14,27,-13,15,23,20
18063,7806,7812,57,16,19,5,3,11,29,38,-9,13,25,18
18064,7806,7812,24,18,19,2,4,13,16,29,-13,8,30,10
18065,7806,7812,49,3,19,10,6,3,28,17,11,26,12,36
18066,7806,7812,37,7,19,8,7,4,24,16,8,23,15,31
18067,7806,7812,4,2,19,10,6,3,28,14,14,26,12,36
18068,7806,7812,21,4,19,10,5,4,27,13,14,25,13,35
18069,7806,7812,17,5,19,10,4,5,28,23,5,24,14,34
18070,7806,7812,19,11,19,6,6,7,22,31,-9,18,20,24
18071,7806,7812,8,12,19,6,5,8,20,26,-6,17,21,23
18072,7806,7812,56,6,19,10,3,6,27,24,3,23,15,33
18073,7806,7812,12,8,19,8,5,6,27,20,7,21,17,29
18074,7806,7812,20,10,19,6,6,7,21,19,2,18,20,24
18075,7806,7812,41,14,19,5,5,9,21,28,-7,15,23,20
18076,7806,7812,52,9,19,8,2,9,28,27,1,18,20,26
18077,7806,7812,3,13,19,5,6,8,22,31,-9,16,22,21
18078,7806,7812,1,17,19,3,4,12,22,33,-11,10,28,13
18079,7673,7679,1,11,3,1,0,2,6,5,1,2,4,3
18080,7673,7679,12,3,3,2,1,0,4,2,2,5,1,7
18081,7673,7679,17,2,3,2,1,0,4,1,3,5,1,7
18082,7673,7679,8,10,3,1,1,1,4,6,-2,3,3,4
18083,7673,7679,19,18,3,0,1,2,3,9,-6,1,5,1
18084,7673,7679,3,5,3,2,0,1,6,4,2,4,2,6
18085,7673,7679,52,13,3,1,0,2,3,6,-3,2,4,3
18086,7673,7679,49,7,3,1,2,0,6,3,3,4,2,5
18087,7673,7679,37,8,3,1,2,0,4,2,2,4,2,5
18088,7673,7679,41,4,3,2,0,1,7,5,2,4,2,6
18089,7673,7679,20,14,3,0,2,1,1,2,-1,2,4,2
18090,7673,7679,56,15,3,0,2,1,1,3,-2,2,4,2
18091,7673,7679,4,5,3,2,0,1,6,4,2,4,2,6
18092,7673,7679,21,9,3,1,1,1,2,2,0,3,3,4
18093,7673,7679,43,1,3,2,1,0,8,3,5,5,1,7
18094,7673,7679,22,12,3,1,0,2,4,7,-3,2,4,3
18095,7673,7679,24,16,3,0,1,2,3,5,-2,1,5,1
18096,7673,7679,57,17,3,0,1,2,5,8,-3,1,5,1
18097,7911,7917,57,13,33,10,8,15,56,58,-2,28,38,38
18098,7911,7917,22,16,33,9,9,15,23,49,-26,27,39,36
18099,7911,7917,24,18,33,6,5,22,27,63,-36,17,49,23
18100,7911,7917,4,4,33,15,13,5,36,19,17,43,23,58
18101,7911,7917,21,5,33,16,9,8,43,22,21,41,25,57
18102,7911,7917,49,1,33,18,10,5,56,27,29,46,20,64
18103,7911,7917,37,6,33,14,9,10,43,29,14,37,29,51
18104,7911,7917,17,8,33,13,8,12,45,49,-4,34,32,47
18105,7911,7917,19,9,33,11,8,14,43,52,-9,30,36,41
18106,7911,7917,43,2,33,18,8,7,53,30,23,44,22,62
18107,7911,7917,56,7,33,13,10,10,38,35,3,36,30,49
18108,7911,7917,20,12,33,10,9,14,30,33,-3,29,37,39
18109,7911,7917,41,14,33,10,8,15,36,49,-13,28,38,38
18110,7911,7917,3,10,33,11,8,14,39,52,-13,30,36,41
18111,7911,7917,52,11,33,11,7,15,41,44,-3,29,37,40
18112,7911,7917,8,15,33,9,9,15,32,48,-16,27,39,36
18113,7911,7917,12,3,33,16,10,7,54,31,23,42,24,58
18114,7911,7917,1,17,33,9,8,16,41,46,-5,26,40,35
18115,7680,7686,1,15,4,1,0,3,6,7,-1,2,6,3
18116,7680,7686,12,2,4,3,1,0,6,2,4,7,1,10
18117,7680,7686,17,1,4,3,1,0,6,1,5,7,1,10
18118,7680,7686,8,14,4,1,1,2,4,9,-5,3,5,4
18119,7680,7686,19,16,4,0,2,2,5,11,-6,2,6,2
18120,7680,7686,3,7,4,2,1,1,8,6,2,5,3,7
18121,7680,7686,52,13,4,1,1,2,4,7,-3,3,5,4
18122,7680,7686,49,4,4,2,2,0,8,3,5,6,2,8
18123,7680,7686,37,5,4,2,2,0,6,2,4,6,2,8
18124,7680,7686,41,8,4,2,0,2,7,6,1,4,4,6
18125,7680,7686,20,9,4,1,2,1,4,2,2,4,4,5
18126,7680,7686,56,10,4,1,2,1,2,3,-1,4,4,5
18127,9304,9317,53,9,27,9,11,7,35,35,0,29,25,38
18128,9304,9317,12,11,27,8,7,12,36,48,-12,23,31,31
18129,9304,9317,49,5,27,12,9,6,42,26,16,33,21,45
18130,9304,9317,37,7,27,12,7,8,43,33,10,31,23,43
18131,9304,9317,52,13,27,6,9,12,27,47,-20,21,33,27
18132,9304,9317,1,2,27,17,6,4,57,27,30,40,14,57
18133,9304,9317,21,10,27,8,10,9,28,37,-9,26,28,34
18134,9304,9317,41,4,27,13,6,8,40,31,9,32,22,45
18135,9304,9317,20,6,27,13,5,9,44,27,17,31,23,44
18136,9304,9317,4,3,27,13,8,6,41,26,15,34,20,47
18137,9304,9317,56,14,27,7,5,15,31,42,-11,19,35,26
18138,9304,9317,13,16,27,5,10,12,19,31,-12,20,34,25
18139,9304,9317,57,8,27,10,8,9,46,39,7,28,26,38
18140,9304,9317,24,12,27,5,14,8,26,36,-10,24,30,29
18141,9304,9317,43,1,27,17,7,3,67,27,40,41,13,58
18142,9304,9317,19,17,27,5,8,14,20,50,-30,18,36,23
18143,9304,9317,17,18,27,4,9,14,25,49,-24,17,37,21
18144,9591,9597,37,6,14,6,8,0,19,8,11,20,8,26
18145,9591,9597,49,7,14,6,5,3,22,11,11,17,11,23
18146,9591,9597,52,16,14,3,3,8,15,27,-12,9,19,12
18147,9591,9597,43,1,14,11,2,1,35,7,28,24,4,35
18148,9591,9597,24,4,14,8,4,2,23,8,15,20,8,28
18149,9591,9597,2,9,14,5,3,6,15,20,-5,13,15,18
18150,9591,9597,57,14,14,3,3,8,17,19,-2,9,19,12
18151,9591,9597,41,8,14,6,4,4,19,15,4,16,12,22
18152,9591,9597,20,11,14,5,1,8,19,26,-7,11,17,16
18153,9591,9597,13,12,14,4,3,7,16,23,-7,11,17,15
18154,9591,9597,56,15,14,3,3,8,16,22,-6,9,19,12
18155,9591,9597,4,13,14,4,2,8,12,24,-12,10,18,14
18156,9591,9597,21,18,14,0,4,10,9,27,-18,4,24,4
18157,9591,9597,1,2,14,9,3,2,32,13,19,21,7,30
18158,9591,9597,27,5,14,8,2,4,20,16,4,18,10,26
18159,9591,9597,48,17,14,1,3,10,6,33,-27,5,23,6
18160,9591,9597,12,3,14,8,5,1,20,13,7,21,7,29
18161,9591,9597,53,10,14,4,6,4,14,17,-3,14,14,18
18162,9724,9730,1,3,28,15,7,6,52,26,26,37,19,52
18163,9724,9730,27,7,28,12,7,9,40,36,4,31,25,43
18164,9724,9730,4,15,28,6,7,15,22,45,-23,19,37,25
18165,9724,9730,21,16,28,5,8,15,28,42,-14,18,38,23
18166,9724,9730,43,1,28,20,6,2,68,23,45,46,10,66
18167,9724,9730,24,2,28,19,7,2,44,11,33,45,11,64
18168,9724,9730,2,11,28,8,9,11,27,38,-11,25,31,33
18169,9724,9730,12,4,28,14,8,6,47,33,14,36,20,50
18170,9724,9730,53,8,28,10,9,9,28,28,0,29,27,39
18171,9724,9730,37,5,28,12,13,3,37,20,17,37,19,49
18172,9724,9730,49,10,28,8,10,10,34,27,7,26,30,34
18173,9724,9730,57,13,28,7,9,12,29,33,-4,23,33,30
18174,9724,9730,52,14,28,6,9,13,27,45,-18,21,35,27
18175,9724,9730,48,18,28,4,7,17,17,62,-45,15,41,19
18176,9724,9730,41,6,28,12,7,9,36,31,5,31,25,43
18177,9724,9730,20,9,28,11,5,12,39,38,1,27,29,38
18178,9724,9730,56,12,28,8,6,14,33,40,-7,22,34,30
18179,9724,9730,13,17,28,5,6,17,27,57,-30,16,40,21
18180,9927,9933,24,1,13,9,2,2,20,9,11,20,6,29
18181,9927,9933,43,5,13,6,5,2,23,8,15,17,9,23
18182,9927,9933,57,10,13,4,4,5,17,16,1,12,14,16
18183,9927,9933,22,15,13,4,0,9,16,35,-19,8,18,12
18184,9927,9933,2,17,13,3,1,9,10,23,-13,7,19,10
18185,9927,9933,41,4,13,6,6,1,21,12,9,18,8,24
18186,9927,9933,20,6,13,7,1,5,26,17,9,15,11,22
18187,9927,9933,56,16,13,3,3,7,14,24,-10,9,17,12
18188,9927,9933,21,2,13,8,5,0,29,11,18,21,5,29
18189,9927,9933,4,12,13,4,1,8,13,24,-11,9,17,13
18190,9927,9933,27,14,13,3,4,6,15,23,-8,10,16,13
18191,9927,9933,28,7,13,6,4,3,14,13,1,16,10,22
18192,9927,9933,52,13,13,3,4,6,12,19,-7,10,16,13
18193,9927,9933,12,8,13,5,4,4,16,15,1,14,12,19
18194,9927,9933,53,9,13,5,1,7,15,18,-3,11,15,16
18195,9927,9933,49,11,13,4,3,6,19,22,-3,11,15,15
18196,9927,9933,37,18,13,2,3,8,15,20,-5,7,19,9
18197,9927,9933,1,3,13,8,3,2,28,14,14,19,7,27
18198,9934,9940,1,1,14,9,3,2,30,14,16,21,7,30
18199,9934,9940,49,10,14,5,3,6,21,23,-2,13,15,18
18200,9934,9940,37,18,14,2,4,8,15,20,-5,8,20,10
18201,9934,9940,12,9,14,5,4,5,16,18,-2,14,14,19
18202,9934,9940,53,11,14,5,2,7,16,19,-3,12,16,17
18203,9934,9940,28,7,14,6,4,4,14,15,-1,16,12,22
18204,9934,9940,52,13,14,4,4,6,15,19,-4,12,16,16
18205,15541,15554,42,9,26,11,3,12,37,32,5,25,27,36
18206,15541,15554,27,16,26,5,5,16,30,57,-27,15,37,20
18207,15541,15554,49,8,25,10,7,8,40,33,7,27,23,37
18208,15541,15554,37,11,25,9,1,15,37,61,-24,19,31,28
18209,15541,15554,1,1,26,22,1,3,81,26,55,45,7,67
18210,15541,15554,4,7,26,12,2,12,39,42,-3,26,26,38
18211,15541,15554,21,14,26,6,5,15,33,49,-16,17,35,23
18212,15541,15554,17,4,25,14,7,4,42,28,14,35,15,49
18213,15541,15554,35,15,25,6,4,15,35,47,-12,16,34,22
18214,15541,15554,12,3,25,17,4,4,60,33,27,38,12,55
18215,15541,15554,25,12,25,8,3,14,21,37,-16,19,31,27
18216,15541,15554,43,2,26,18,2,6,59,28,31,38,14,56
18217,15541,15554,22,6,25,12,6,7,55,39,16,30,20,42
18218,15541,15554,40,13,25,6,7,12,28,34,-6,19,31,25
18219,15541,15554,24,17,25,2,5,18,12,66,-54,9,41,11
18220,15569,15575,43,2,28,20,2,6,62,28,34,42,14,62
18221,15569,15575,22,7,27,12,6,9,56,45,11,30,24,42
18222,15569,15575,40,14,27,6,7,14,30,39,-9,19,35,25
18223,15569,15575,24,17,27,2,5,20,12,76,-64,9,45,11
18224,15569,15575,12,3,27,18,4,5,66,39,27,40,14,58
18225,15569,15575,25,10,27,10,3,14,28,38,-10,23,31,33
18226,15569,15575,35,13,27,7,5,15,42,49,-7,19,35,26
18227,15569,15575,4,8,27,13,2,12,42,44,-2,28,26,41
18228,15569,15575,21,15,27,6,6,15,34,50,-16,18,36,24
18229,15569,15575,49,6,27,12,7,8,44,33,11,31,23,43
18230,15569,15575,37,11,27,10,1,16,43,63,-20,21,33,31
18231,15569,15575,27,16,28,6,5,17,35,62,-27,17,39,23
18232,15569,15575,17,5,27,14,7,6,43,31,12,35,19,49
18233,15569,15575,42,9,28,12,3,13,41,37,4,27,29,39
18234,15569,15575,1,1,28,24,1,3,88,28,60,49,7,73
18235,15569,15575,28,4,27,15,5,7,55,36,19,35,19,50
18236,15569,15575,33,12,28,8,5,15,39,62,-23,21,35,29
18237,15856,15862,33,4,20,9,8,3,40,26,14,26,14,35
18238,15856,15862,28,7,20,7,7,6,24,27,-3,21,19,28
18239,15856,15862,1,5,20,10,4,6,41,23,18,24,16,34
18240,15856,15862,27,17,20,3,6,11,16,26,-10,12,28,15
18241,15856,15862,4,9,20,6,8,6,21,20,1,20,20,26
18242,15856,15862,31,15,20,4,5,11,19,34,-15,13,27,17
18243,15856,15862,21,18,20,3,4,13,14,40,-26,10,30,13
18244,15856,15862,49,2,20,12,5,3,39,18,21,29,11,41
18245,15856,15862,37,8,20,8,2,10,27,31,-4,18,22,26
18246,15856,15862,35,10,20,6,7,7,18,23,-5,19,21,25
18247,15856,15862,17,13,20,4,10,6,21,24,-3,18,22,22
18248,15856,15862,42,16,20,3,8,9,20,31,-11,14,26,17
18249,15856,15862,25,6,20,8,7,5,24,25,-1,23,17,31
18250,15856,15862,12,14,20,4,6,10,22,33,-11,14,26,18
18251,15856,15862,43,1,20,18,1,1,52,15,37,37,3,55
18252,15856,15862,22,3,20,10,5,5,40,26,14,25,15,35
18253,15856,15862,40,11,20,5,9,6,25,28,-3,19,21,24
18254,15856,15862,57,12,20,5,8,7,18,31,-13,18,22,23
18255,15870,15876,43,1,22,20,1,1,57,18,39,41,3,61
18256,15870,15876,22,6,22,10,6,6,42,30,12,26,18,36
18257,15870,15876,40,11,22,5,11,6,27,30,-3,21,23,26
18258,15870,15876,57,12,22,5,9,8,20,34,-14,19,25,24
18259,15870,15876,25,5,22,10,7,5,30,25,5,27,17,37
18260,15870,15876,12,15,22,4,7,11,23,35,-12,15,29,19
18261,15870,15876,17,13,22,4,11,7,22,27,-5,19,25,23
18262,15870,15876,42,14,22,4,9,9,22,31,-9,17,27,21
18263,15870,15876,35,8,22,7,8,7,20,24,-4,22,22,29
18264,15870,15876,49,2,22,12,7,3,41,20,21,31,13,43
18265,15870,15876,4,9,22,6,9,7,22,22,0,21,23,27
18266,15870,15876,31,16,22,4,6,12,21,37,-16,14,30,18
18267,15870,15876,21,17,22,4,4,14,17,45,-28,12,32,16
18268,15870,15876,37,10,22,8,2,12,29,37,-8,18,26,26
18269,15870,15876,27,18,22,3,7,12,19,31,-12,13,31,16
18270,15870,15876,1,3,22,12,4,6,46,23,23,28,16,40
18271,15870,15876,28,7,22,8,7,7,26,31,-5,23,21,31
18272,15870,15876,33,4,22,10,9,3,44,28,16,29,15,39
18273,15905,15918,21,17,27,5,5,17,20,51,-31,15,39,20
18274,15905,15918,31,18,27,4,6,17,24,54,-30,14,40,18
18275,15905,15918,33,4,27,13,10,4,55,34,21,36,18,49
18276,15905,15918,28,8,27,8,10,9,30,37,-7,26,28,34
18277,15905,15918,42,15,27,6,10,11,24,33,-9,22,32,28
18278,15905,15918,49,3,27,14,9,4,54,24,30,37,17,51
18279,15905,15918,37,9,27,10,3,14,35,46,-11,23,31,33
18280,15905,15918,27,16,27,6,7,14,28,37,-9,19,35,25
18281,15905,15918,4,10,27,7,11,9,25,27,-2,25,29,32
18282,15905,15918,1,2,27,17,4,6,58,27,31,38,16,55
18283,19552,19684,16,15,30,6,9,15,30,47,-17,21,39,27
18284,19552,19684,56,8,30,10,9,11,42,44,-2,29,31,39
18285,19552,19684,17,12,30,9,5,16,36,53,-17,23,37,32
18286,19552,19684,42,16,30,6,4,20,29,53,-24,16,44,22
18287,19552,19684,43,3,30,18,3,9,61,31,30,39,21,57
18288,19552,19684,22,6,30,14,3,13,42,39,3,31,29,45
18289,19552,19684,57,11,30,9,6,15,29,55,-26,24,36,33
18290,19552,19684,24,13,30,8,7,15,34,51,-17,23,37,31
18291,19552,19684,45,4,30,14,11,5,51,38,13,39,21,53
18292,19552,19684,27,10,30,8,10,12,36,41,-5,26,34,34
18293,19552,19684,4,7,30,12,8,10,39,37,2,32,28,44
18294,19552,19684,9,9,30,9,7,14,28,46,-18,25,35,34
18295,19552,19684,10,14,30,6,13,11,28,35,-7,25,35,31
18296,19552,19684,12,5,30,15,6,9,48,31,17,36,24,51
18297,19552,19684,1,2,30,19,6,5,54,28,26,44,16,63
18298,19825,19831,1,1,19,10,8,1,44,20,24,28,10,38
18299,19825,19831,12,6,19,7,8,4,28,20,8,22,16,29
18300,19825,19831,25,12,19,5,7,7,31,40,-9,17,21,22
18301,19825,19831,38,10,19,6,5,8,30,31,-1,17,21,23
18302,19825,19831,56,4,19,10,1,8,31,27,4,21,17,31
18303,19825,19831,27,7,19,8,4,7,28,26,2,20,18,28
18304,19825,19831,45,11,19,6,4,9,25,31,-6,16,22,22
18305,19825,19831,10,14,19,6,2,11,20,31,-11,14,24,20
18306,19825,19831,43,2,19,9,7,3,33,24,9,25,13,34
18307,19825,19831,22,3,19,8,8,3,25,16,9,24,14,32
18308,19825,19831,24,13,19,5,6,8,22,28,-6,16,22,21
18309,19825,19831,57,15,19,4,5,10,13,28,-15,13,25,17
18310,19825,19831,17,16,19,3,5,11,20,35,-15,11,27,14
18311,19825,19831,49,8,19,8,3,8,30,31,-1,19,19,27
18312,19825,19831,4,5,19,8,7,4,28,17,11,23,15,31
18313,19825,19831,9,9,19,7,4,8,25,28,-3,18,20,25
18314,19699,19705,43,1,3,3,0,0,6,1,5,6,0,9
18315,19699,19705,24,10,3,1,0,2,5,6,-1,2,4,3
18316,19699,19705,57,13,3,0,2,1,1,2,-1,2,4,2
18317,19699,19705,22,14,3,0,2,1,2,4,-2,2,4,2
18318,19699,19705,49,5,3,2,0,1,6,3,3,4,2,6
18319,19699,19705,17,6,3,1,1,1,4,3,1,3,3,4
18320,19699,19705,4,2,3,2,1,0,4,1,3,5,1,7
18321,19699,19705,9,12,3,1,0,2,1,4,-3,2,4,3
18322,19699,19705,45,6,3,1,1,1,4,3,1,3,3,4
18323,19699,19705,10,15,3,0,1,2,1,4,-3,1,5,1
18324,19699,19705,27,16,3,0,0,3,2,7,-5,0,6,0
18325,19699,19705,56,11,3,1,0,2,4,6,-2,2,4,3
18326,19699,19705,38,9,3,1,1,1,4,5,-1,3,3,4
18327,19699,19705,25,4,3,2,1,0,5,3,2,5,1,7
18328,19699,19705,12,8,3,1,1,1,2,2,0,3,3,4
18329,19699,19705,1,2,3,2,1,0,4,1,3,5,1,7
18330,20119,20132,1,6,10,5,1,4,21,13,8,11,9,16
18331,20119,20132,28,7,10,4,2,4,13,10,3,10,10,14
18332,20119,20132,38,11,10,2,4,4,13,17,-4,8,12,10
18333,20119,20132,12,14,10,2,2,6,8,13,-5,6,14,8
18334,20119,20132,25,16,10,1,4,5,11,20,-9,6,14,7
18335,20119,20132,56,10,10,3,4,3,7,7,0,10,10,13
18336,20119,20132,9,1,10,7,2,1,21,10,11,16,4,23
18337,20119,20132,4,2,10,5,5,0,18,8,10,15,5,20
18338,20119,20132,45,5,10,5,2,3,17,13,4,12,8,17
18339,20119,20132,27,8,10,3,5,2,10,9,1,11,9,14
18340,20119,20132,10,9,10,4,1,5,17,24,-7,9,11,13
18341,20119,20132,16,12,10,2,3,5,12,16,-4,7,13,9
18342,20119,20132,49,15,10,2,2,6,11,23,-12,6,14,8
18343,20119,20132,43,3,10,5,4,1,14,8,6,14,6,19
18344,20119,20132,22,4,10,5,2,3,14,9,5,12,8,17
18345,20119,20132,24,13,10,2,3,5,12,19,-7,7,13,9
18346,20427,20433,28,11,2,1,0,1,1,2,-1,2,2,3
18347,20427,20433,38,14,2,0,0,2,1,3,-2,0,4,0
18348,20427,20433,49,4,2,1,1,0,4,2,2,3,1,4
18349,20427,20433,56,13,2,0,1,1,2,6,-4,1,3,1
18350,20427,20433,43,1,2,2,0,0,7,2,5,4,0,6
18351,20427,20433,24,8,2,1,0,1,2,2,0,2,2,3
18352,20427,20433,22,8,2,1,0,1,2,2,0,2,2,3
18353,20427,20433,4,5,2,1,1,0,2,1,1,3,1,4
18354,20427,20433,9,8,2,1,0,1,2,2,0,2,2,3
18355,20427,20433,45,2,2,2,0,0,5,0,5,4,0,6
18356,20427,20433,27,3,2,2,0,0,2,0,2,4,0,6
18357,20427,20433,10,15,2,0,0,2,0,3,-3,0,4,0
18358,20427,20433,15,16,2,0,0,2,0,5,-5,0,4,0
18359,20427,20433,12,6,2,1,0,1,3,1,2,2,2,3
18360,20427,20433,25,12,2,0,1,1,2,5,-3,1,3,1
18361,20427,20433,1,7,2,1,0,1,2,1,1,2,2,3
18362,20861,20867,1,1,10,9,0,1,25,9,16,18,2,27
18363,20861,20867,12,10,10,3,2,5,14,17,-3,8,12,11
18364,7680,7686,4,3,4,3,0,1,7,4,3,6,2,9
18365,7680,7686,21,11,4,1,1,2,2,3,-1,3,5,4
18366,7680,7686,43,6,4,2,1,1,8,5,3,5,3,7
18367,7680,7686,22,12,4,1,1,2,5,8,-3,3,5,4
18368,7680,7686,24,17,4,0,1,3,3,7,-4,1,7,1
18369,7680,7686,57,18,4,0,1,3,5,10,-5,1,7,1
18370,8121,8127,43,2,15,8,4,3,30,17,13,20,10,28
18371,8121,8127,57,14,15,3,5,7,18,24,-6,11,19,14
18372,8121,8127,22,17,15,3,3,9,16,23,-7,9,21,12
18373,8121,8127,21,6,15,7,4,4,18,17,1,18,12,25
18374,8121,8127,4,8,15,6,6,3,25,18,7,18,12,24
18375,8121,8127,19,4,15,7,6,2,20,14,6,20,10,27
18376,8121,8127,17,10,15,5,3,7,15,22,-7,13,17,18
18377,8121,8127,56,12,15,4,6,5,16,21,-5,14,16,18
18378,8121,8127,20,13,15,4,3,8,14,21,-7,11,19,15
18379,8121,8127,41,15,15,3,4,8,12,32,-20,10,20,13
18380,8121,8127,13,16,15,2,7,6,13,25,-12,11,19,13
18381,8121,8127,12,3,15,8,4,3,22,13,9,20,10,28
18382,8121,8127,53,11,15,5,3,7,23,33,-10,13,17,18
18383,8121,8127,52,9,15,6,5,4,17,14,3,17,13,23
18384,8121,8127,3,18,15,2,4,9,16,31,-15,8,22,10
18385,8121,8127,49,1,15,9,2,4,39,18,21,20,10,29
18386,8121,8127,37,7,15,6,6,3,34,13,21,18,12,24
18387,8121,8127,1,5,15,7,5,3,22,14,8,19,11,26
18388,8303,8382,12,8,34,13,9,12,42,38,4,35,33,48
18389,8303,8382,53,15,34,8,9,17,43,61,-18,25,43,33
18390,8303,8382,1,5,34,17,9,8,58,49,9,43,25,60
18391,8303,8382,52,10,34,9,13,12,32,38,-6,31,37,40
18392,8303,8382,3,17,34,7,7,20,39,64,-25,21,47,28
18393,8303,8382,41,9,34,11,10,13,37,54,-17,32,36,43
18394,8303,8382,56,11,34,10,9,15,41,55,-14,29,39,39
18395,8303,8382,13,13,34,8,12,14,41,62,-21,28,40,36
18396,8303,8382,20,16,34,7,10,17,36,51,-15,24,44,31
18397,8303,8382,57,14,34,7,15,12,38,49,-11,29,39,36
18398,8303,8382,22,18,34,5,10,19,36,62,-26,20,48,25
18399,8303,8382,19,7,34,14,9,11,48,49,-1,37,31,51
18400,8303,8382,17,12,34,10,7,17,34,52,-18,27,41,37
18401,8303,8382,21,3,34,20,6,8,56,30,26,46,22,66
18402,8303,8382,4,4,34,18,10,6,60,42,18,46,22,64
18403,8303,8382,49,1,34,22,6,6,78,34,44,50,18,72
18404,8303,8382,37,6,34,15,10,9,68,38,30,40,28,55
18405,8303,8382,43,2,34,20,9,5,74,33,41,49,19,69
18406,8478,8484,43,3,13,7,4,2,30,16,14,18,8,25
18407,8478,8484,57,6,13,6,3,4,13,10,3,15,11,21
18408,8478,8484,24,9,13,3,8,2,18,19,-1,14,12,17
18409,8478,8484,37,1,13,9,4,0,26,14,12,22,4,31
18410,8478,8484,49,10,13,4,4,5,17,15,2,12,14,16
18411,8478,8484,21,8,13,5,3,5,19,16,3,13,13,18
18412,8478,8484,4,15,13,3,3,7,15,21,-6,9,17,12
18413,8478,8484,19,4,13,6,4,3,22,15,7,16,10,22
18414,8478,8484,17,13,13,4,2,7,17,23,-6,10,16,14
18415,8478,8484,8,17,13,2,2,9,12,33,-21,6,20,8
18416,8478,8484,53,11,13,3,7,3,16,22,-6,13,13,16
18417,8478,8484,12,12,13,4,3,6,12,16,-4,11,15,15
18418,8478,8484,52,18,13,1,5,7,11,20,-9,7,19,8
18419,8478,8484,13,2,13,8,3,2,27,13,14,19,7,27
18420,8478,8484,20,5,13,6,3,4,18,10,8,15,11,21
18421,8478,8484,56,14,13,3,4,6,12,17,-5,10,16,13
18422,8478,8484,41,16,13,3,3,7,13,23,-10,9,17,12
18423,8478,8484,1,7,13,5,5,3,23,18,5,15,11,20
18424,8590,8596,12,12,25,8,6,11,28,36,-8,22,28,30
18425,8590,8596,53,14,25,6,9,10,32,50,-18,21,29,27
18426,8590,8596,21,7,25,9,9,7,40,31,9,27,23,36
18427,8590,8596,4,16,25,6,5,14,25,36,-11,17,33,23
18428,8590,8596,19,10,25,9,6,10,32,36,-4,24,26,33
18429,8590,8596,17,15,25,7,4,14,30,48,-18,18,32,25
18430,8590,8596,8,17,25,6,4,15,23,52,-29,16,34,22
18431,8590,8596,52,18,25,4,10,11,24,32,-8,18,32,22
18432,8590,8596,13,2,25,14,5,6,48,29,19,33,17,47
18433,8590,8596,20,6,25,10,6,9,39,33,6,26,24,36
18434,8590,8596,41,11,25,8,6,11,29,37,-8,22,28,30
18435,8590,8596,56,13,25,7,8,10,25,31,-6,22,28,29
18436,8590,8596,37,1,25,16,6,3,47,27,20,38,12,54
18437,8590,8596,49,4,25,13,5,7,43,27,16,31,19,44
18438,8590,8596,43,3,25,13,7,5,57,33,24,33,17,46
18439,8590,8596,24,8,25,8,10,7,31,35,-4,26,24,34
18440,8590,8596,57,9,25,9,6,10,26,24,2,24,26,33
18441,8590,8596,1,5,25,12,8,5,45,27,18,32,18,44
18442,14085,14105,12,8,28,13,6,9,53,49,4,32,24,45
18443,14085,14105,25,12,28,10,5,13,48,50,-2,25,31,35
18444,14085,14105,47,11,28,9,9,10,39,40,-1,27,29,36
18445,14085,14105,1,2,28,18,4,6,51,30,21,40,16,58
18446,14085,14105,4,6,28,13,8,7,48,48,0,34,22,47
18447,14085,14105,9,18,28,2,9,17,23,64,-41,13,43,15
18448,14085,14105,27,14,28,6,11,11,35,43,-8,23,33,29
18449,13878,13881,9,6,3,1,2,0,4,3,1,4,2,5
18450,13878,13881,4,12,3,1,1,1,3,4,-1,3,3,4
18451,13878,13881,6,15,3,1,0,2,2,4,-2,2,4,3
18452,13878,13881,35,17,3,0,0,3,1,10,-9,0,6,0
18453,13878,13881,56,18,3,0,0,3,1,12,-11,0,6,0
18454,13878,13881,1,3,3,2,1,0,5,2,3,5,1,7
18455,13878,13881,17,13,3,1,0,2,7,6,1,2,4,3
18456,13878,13881,47,10,3,1,1,1,3,3,0,3,3,4
18457,13878,13881,22,8,3,1,1,1,4,4,0,3,3,4
18458,13878,13881,34,14,3,1,0,2,5,5,0,2,4,3
18459,13878,13881,43,16,3,0,2,1,3,4,-1,2,4,2
18460,13878,13881,49,4,3,2,0,1,6,2,4,4,2,6
18461,13878,13881,37,8,3,1,1,1,4,4,0,3,3,4
18462,13878,13881,33,2,3,2,1,0,5,1,4,5,1,7
18463,13878,13881,28,7,3,1,1,1,5,4,1,3,3,4
18464,13878,13881,12,1,3,3,0,0,11,1,10,6,0,9
18465,13878,13881,25,5,3,2,0,1,5,4,1,4,2,6
18466,13878,13881,27,11,3,1,1,1,4,5,-1,3,3,4
18467,14120,14122,35,10,31,13,6,12,44,43,1,32,30,45
18468,14120,14122,6,16,31,6,7,18,30,48,-18,19,43,25
18469,14120,14122,56,17,31,5,6,20,42,75,-33,16,46,21
18470,14120,14122,17,9,31,13,6,12,60,46,14,32,30,45
18471,14120,14122,33,4,31,18,7,6,72,45,27,43,19,61
18472,14120,14122,28,7,31,14,7,10,48,41,7,35,27,49
18473,14120,14122,22,1,31,20,7,4,67,32,35,47,15,67
18474,14120,14122,43,3,31,18,7,6,64,36,28,43,19,61
18475,14120,14122,34,13,31,8,7,16,42,62,-20,23,39,31
18476,14120,14122,49,6,31,17,2,12,52,39,13,36,26,53
18477,14120,14122,37,15,31,7,5,19,29,55,-26,19,43,26
18478,14120,14122,12,5,31,16,6,9,63,53,10,38,24,54
18479,14120,14122,25,12,31,11,5,15,51,55,-4,27,35,38
18480,14120,14122,47,11,31,10,9,12,42,43,-1,29,33,39
18481,14120,14122,1,2,31,20,5,6,57,32,25,45,17,65
18482,14120,14122,4,8,31,13,9,9,51,54,-3,35,27,48
18483,14120,14122,9,18,31,3,10,18,25,68,-43,16,46,19
18484,14120,14122,27,14,31,6,11,14,37,49,-12,23,39,29
18485,13889,13895,28,6,6,3,1,2,10,7,3,7,5,10
18486,13889,13895,33,7,6,2,4,0,7,3,4,8,4,10
18487,13889,13895,4,9,6,2,2,2,9,10,-1,6,6,8
18488,13889,13895,9,14,6,1,3,2,4,10,-6,5,7,6
18489,13889,13895,6,12,6,2,0,4,5,8,-3,4,8,6
18490,13889,13895,35,13,6,2,0,4,4,14,-10,4,8,6
18491,13889,13895,56,18,6,1,0,5,7,18,-11,2,10,3
18492,13889,13895,1,3,6,4,1,1,9,5,4,9,3,13
18493,13889,13895,47,15,6,1,2,3,6,8,-2,4,8,5
18494,13889,13895,22,3,6,4,1,1,9,5,4,9,3,13
18495,13889,13895,43,16,6,1,2,3,8,13,-5,4,8,5
18496,13889,13895,34,17,6,1,1,4,8,12,-4,3,9,4
18497,13889,13895,49,8,6,3,0,3,9,6,3,6,6,9
18498,13889,13895,37,10,6,2,1,3,10,9,1,5,7,7
18499,13889,13895,17,11,6,2,1,3,10,11,-1,5,7,7
18500,13889,13895,27,5,6,3,2,1,10,5,5,8,4,11
18501,13889,13895,25,1,6,5,0,1,17,8,9,10,2,15
18502,13889,13895,12,2,6,4,1,1,16,6,10,9,3,13
18503,14316,14322,27,11,13,4,5,4,18,18,0,13,13,17
18504,14316,14322,33,9,13,5,3,5,23,20,3,13,13,18
18505,14316,14322,43,1,13,11,2,0,40,16,24,24,2,35
18506,14316,14322,22,3,13,7,5,1,34,15,19,19,7,26
18507,14316,14322,34,7,13,6,2,5,27,21,6,14,12,20
18508,14316,14322,24,8,13,6,0,7,19,31,-12,12,14,18
18509,14316,14322,49,12,13,5,1,7,21,27,-6,11,15,16
18510,14316,14322,37,18,13,1,5,7,15,29,-14,7,19,8
18511,14316,14322,25,10,13,5,3,5,25,29,-4,13,13,18
18512,14316,14322,12,14,13,2,5,6,18,27,-9,9,17,11
18513,14316,14322,58,17,13,1,6,6,8,25,-17,8,18,9
18514,14316,14322,47,13,13,3,4,6,18,20,-2,10,16,13
18515,14316,14322,28,15,13,2,3,8,16,33,-17,7,19,9
18516,14316,14322,35,5,13,7,2,4,24,22,2,16,10,23
18517,14316,14322,6,16,13,1,6,6,14,26,-12,8,18,9
18518,14316,14322,4,4,13,8,0,5,38,25,13,16,10,24
18519,14316,14322,1,6,13,7,1,5,29,14,15,15,11,22
18520,14316,14322,17,2,13,8,3,2,25,14,11,19,7,27
18521,14449,14455,33,6,28,14,6,8,60,42,18,34,22,48
18522,20861,20867,38,4,10,5,3,2,18,16,2,13,7,18
18523,20861,20867,28,6,10,5,2,3,12,12,0,12,8,17
18524,20861,20867,56,13,10,2,3,5,11,17,-6,7,13,9
18525,20861,20867,15,15,10,1,3,6,13,28,-15,5,15,6
18526,20861,20867,27,2,10,6,3,1,18,10,8,15,5,21
18527,20861,20867,45,7,10,5,1,4,20,14,6,11,9,16
18528,20861,20867,10,8,10,3,3,4,21,16,5,9,11,12
18529,20861,20867,21,3,10,5,3,2,18,14,4,13,7,18
18530,20861,20867,4,12,10,2,3,5,11,12,-1,7,13,9
18531,20861,20867,9,16,10,1,2,7,10,19,-9,4,16,5
18532,20861,20867,49,9,10,3,3,4,9,15,-6,9,11,12
18533,20861,20867,43,5,10,5,3,2,15,13,2,13,7,18
18534,20861,20867,22,11,10,2,5,3,17,17,0,9,11,11
18535,20861,20867,24,14,10,1,5,4,13,16,-3,7,13,8
18536,20868,20871,43,5,11,5,3,3,15,14,1,13,9,18
18537,20868,20871,22,10,11,3,5,3,18,17,1,11,11,14
18538,20868,20871,24,15,11,1,5,5,14,20,-6,7,15,8
18539,20868,20871,49,9,11,4,3,4,12,16,-4,11,11,15
18540,20868,20871,21,4,11,5,3,3,18,15,3,13,9,18
18541,20868,20871,4,12,11,2,4,5,12,13,-1,8,14,10
18542,20868,20871,9,16,11,1,2,8,10,20,-10,4,18,5
18543,20868,20871,27,2,11,6,4,1,19,11,8,16,6,22
18544,20868,20871,45,7,11,5,1,5,22,19,3,11,11,16
18545,20868,20871,10,8,11,4,3,4,26,18,8,11,11,15
18546,20868,20871,15,14,11,2,3,6,17,29,-12,7,15,9
18547,20868,20871,56,13,11,2,4,5,12,18,-6,8,14,10
18548,20868,20871,28,3,11,6,2,3,13,12,1,14,8,20
18549,20868,20871,38,6,11,5,3,3,19,19,0,13,9,18
18550,20868,20871,12,11,11,3,3,5,15,18,-3,9,13,12
18551,20868,20871,1,1,11,10,0,1,26,9,17,20,2,30
18552,20791,20797,1,2,2,2,0,0,7,1,6,4,0,6
18553,20791,20797,12,15,2,0,0,2,0,5,-5,0,4,0
18554,20791,20797,28,8,2,1,0,1,3,4,-1,2,2,3
18555,20791,20797,38,9,2,1,0,1,3,5,-2,2,2,3
18556,20791,20797,45,1,2,2,0,0,7,0,7,4,0,6
18557,20791,20797,27,3,2,2,0,0,6,2,4,4,0,6
18558,20791,20797,10,10,2,0,2,0,5,5,0,2,2,2
18559,20791,20797,15,16,2,0,0,2,1,8,-7,0,4,0
18560,20791,20797,21,5,2,1,1,0,1,0,1,3,1,4
18561,20791,20797,4,13,2,0,0,2,2,4,-2,0,4,0
18562,20791,20797,9,14,2,0,0,2,0,2,-2,0,4,0
18563,20791,20797,56,7,2,1,0,1,1,1,0,2,2,3
18564,20791,20797,49,4,2,1,1,0,3,2,1,3,1,4
18565,20791,20797,43,5,2,1,1,0,1,0,1,3,1,4
18566,20791,20797,24,11,2,0,2,0,3,3,0,2,2,2
18567,20791,20797,22,12,2,0,1,1,4,5,-1,1,3,1
18568,20963,20965,28,6,23,8,8,7,27,32,-5,24,22,32
18569,20963,20965,38,12,23,7,5,11,29,41,-12,19,27,26
18570,20963,20965,43,3,23,13,5,5,34,28,6,31,15,44
18571,20963,20965,22,7,23,7,9,7,31,30,1,23,23,30
18572,20963,20965,24,16,23,4,6,13,21,39,-18,14,32,18
18573,20963,20965,49,10,23,7,8,8,25,29,-4,22,24,29
18574,20963,20965,4,4,23,10,6,7,31,19,12,26,20,36
18575,20963,20965,21,5,23,9,9,5,33,27,6,27,19,36
18576,20963,20965,9,13,23,7,4,12,30,32,-2,18,28,25
18577,20963,20965,56,9,23,8,5,10,32,36,-4,21,25,29
18578,20963,20965,27,2,23,13,6,4,39,21,18,32,14,45
18579,20963,20965,10,8,23,8,5,10,42,40,2,21,25,29
18580,20963,20965,45,11,23,8,2,13,35,41,-6,18,28,26
18581,20963,20965,15,15,23,4,7,12,30,48,-18,15,31,19
18582,20963,20965,12,14,23,6,6,11,25,36,-11,18,28,24
18583,20963,20965,1,1,23,18,3,2,58,23,35,39,7,57
18584,20840,20846,1,1,8,7,0,1,20,6,14,14,2,21
18585,20840,20846,12,12,8,2,1,5,10,15,-5,5,11,7
18586,20840,20846,38,4,8,5,1,2,15,13,2,11,5,16
18587,20840,20846,28,5,8,5,1,2,11,10,1,11,5,16
18588,20840,20846,56,10,8,2,3,3,9,12,-3,7,9,9
18589,20840,20846,10,8,8,2,3,3,18,14,4,7,9,9
18590,20840,20846,15,15,8,1,1,6,8,23,-15,3,13,4
18591,20840,20846,21,6,8,4,3,1,15,11,4,11,5,15
18592,20840,20846,4,14,8,1,3,4,8,10,-2,5,11,6
18593,20840,20846,9,16,8,0,2,6,6,15,-9,2,14,2
18594,20840,20846,49,11,8,2,3,3,6,13,-7,7,9,9
18595,20840,20846,27,2,8,5,2,1,15,8,7,12,4,17
18596,20840,20846,45,3,8,5,1,2,19,8,11,11,5,16
18597,20840,20846,43,7,8,3,3,2,10,10,0,9,7,12
18598,20840,20846,22,9,8,2,3,3,13,13,0,7,9,9
18599,20840,20846,24,13,8,1,4,3,8,10,-2,6,10,7
18600,21246,21252,28,6,14,5,6,3,19,16,3,16,12,21
18601,21246,21252,38,15,14,2,3,9,10,21,-11,7,21,9
18602,21246,21252,21,3,14,8,4,2,21,13,8,20,8,28
18603,6294,6300,37,4,15,8,3,4,23,13,10,19,11,27
18604,6294,6300,14,17,15,3,3,9,19,37,-18,9,21,12
18605,6294,6300,52,11,15,5,4,6,26,25,1,14,16,19
18606,6294,6300,20,6,15,7,2,6,22,19,3,16,14,23
18607,6294,6300,56,14,15,4,5,6,15,21,-6,13,17,17
18608,6294,6300,41,16,15,3,4,8,16,25,-9,10,20,13
18609,6294,6300,21,8,15,6,4,5,23,17,6,16,14,22
18610,6294,6300,43,3,15,8,4,3,28,13,15,20,10,28
18611,6294,6300,22,5,15,6,6,3,23,15,8,18,12,24
18612,6294,6300,40,15,15,5,1,9,16,30,-14,11,19,16
18613,6294,6300,57,18,15,2,4,9,9,26,-17,8,22,10
18614,6294,6300,27,10,15,6,3,6,21,25,-4,15,15,21
18615,6294,6300,1,1,15,10,2,3,36,24,12,22,8,32
18616,6343,6349,27,9,20,8,4,8,28,34,-6,20,20,28
18617,6343,6349,52,11,20,7,5,8,38,34,4,19,21,26
18618,6343,6349,43,3,20,11,4,5,35,19,16,26,14,37
18619,6343,6349,22,6,20,9,7,4,31,22,9,25,15,34
18620,6343,6349,40,14,20,5,4,11,18,36,-18,14,26,19
18621,6343,6349,57,18,20,2,5,13,12,41,-29,9,31,11
18622,6343,6349,20,8,20,8,4,8,29,27,2,20,20,28
18623,6343,6349,56,15,20,4,7,9,22,32,-10,15,25,19
18624,6343,6349,41,16,20,4,5,11,25,36,-11,13,27,17
18625,6343,6349,53,7,20,8,9,3,37,25,12,25,15,33
18626,6343,6349,12,12,20,6,5,9,26,24,2,17,23,23
18627,6343,6349,17,5,20,10,4,6,34,25,9,24,16,34
18628,6343,6349,8,13,20,6,4,10,18,26,-8,16,24,22
18629,6343,6349,1,1,20,14,3,3,49,31,18,31,9,45
18630,6343,6349,49,2,20,12,4,4,39,22,17,28,12,40
18631,6343,6349,37,4,20,11,4,5,30,16,14,26,14,37
18632,6343,6349,14,17,20,4,4,12,25,50,-25,12,28,16
18633,6343,6349,21,10,20,7,6,7,28,24,4,20,20,27
18634,6364,6370,21,9,23,8,7,8,31,27,4,23,23,31
18635,6364,6370,49,2,23,14,5,4,44,24,20,33,13,47
18636,6364,6370,37,5,23,11,5,7,32,21,11,27,19,38
18637,6364,6370,1,1,23,16,4,3,55,33,22,36,10,52
18638,6364,6370,17,3,23,13,4,6,41,27,14,30,16,43
18639,6364,6370,8,13,23,7,5,11,21,32,-11,19,27,26
18640,6364,6370,14,17,23,4,5,14,27,58,-31,13,33,17
18641,6364,6370,20,11,23,8,5,10,32,36,-4,21,25,29
18642,6364,6370,43,4,23,12,5,6,40,22,18,29,17,41
18643,6364,6370,22,6,23,10,8,5,35,28,7,28,18,38
18644,6364,6370,40,14,23,6,5,12,22,45,-23,17,29,23
18645,6364,6370,56,15,23,5,8,10,28,37,-9,18,28,23
18646,6364,6370,41,16,23,5,6,12,35,40,-5,16,30,21
18647,6364,6370,57,18,23,2,6,15,14,46,-32,10,36,12
18648,6364,6370,52,8,23,9,6,8,42,36,6,24,22,33
18649,6364,6370,27,12,23,8,4,11,30,40,-10,20,26,28
18650,6364,6370,53,7,23,9,10,4,43,28,15,28,18,37
18651,6364,6370,12,10,23,8,6,9,34,26,8,22,24,30
18652,6371,6377,27,13,24,8,4,12,30,42,-12,20,28,28
18653,6371,6377,43,4,24,13,5,6,42,22,20,31,17,44
18654,6371,6377,22,6,24,10,8,6,35,30,5,28,20,38
18655,6371,6377,40,15,24,6,5,13,22,47,-25,17,31,23
18656,6371,6377,20,11,24,8,6,10,32,36,-4,22,26,30
18657,6371,6377,56,14,24,6,8,10,30,37,-7,20,28,26
18658,6371,6377,41,16,24,5,7,12,37,42,-5,17,31,22
18659,6371,6377,21,8,24,9,7,8,33,27,6,25,23,34
18660,6371,6377,57,18,24,2,6,16,15,48,-33,10,38,12
18661,6371,6377,49,2,24,14,6,4,44,24,20,34,14,48
18662,6371,6377,37,5,24,12,5,7,34,21,13,29,19,41
18663,6371,6377,14,17,24,4,5,15,27,60,-33,13,35,17
18664,6371,6377,53,7,24,9,10,5,43,30,13,28,20,37
18665,6371,6377,12,10,24,8,7,9,36,28,8,23,25,31
18666,6371,6377,52,9,24,9,6,9,42,38,4,24,24,33
18667,6371,6377,17,3,24,14,4,6,43,27,16,32,16,46
18668,6371,6377,8,12,24,8,5,11,23,33,-10,21,27,29
18669,6371,6377,1,1,24,17,4,3,57,33,24,38,10,55
18670,6763,6765,19,7,22,8,9,5,27,21,6,25,19,33
18671,6763,6765,17,11,22,8,3,11,26,31,-5,19,25,27
18672,6763,6765,8,13,22,6,8,8,22,25,-3,20,24,26
18673,6763,6765,21,8,22,7,10,5,26,23,3,24,20,31
18674,6763,6765,37,1,22,14,6,2,42,15,27,34,10,48
18675,6763,6765,49,3,22,10,7,5,28,18,10,27,17,37
18676,6763,6765,20,15,22,3,11,8,16,30,-14,17,27,20
18677,6763,6765,41,16,22,4,6,12,22,35,-13,14,30,18
18678,6763,6765,56,18,22,2,9,11,14,39,-25,13,31,15
18679,6763,6765,43,2,22,14,1,7,52,26,26,29,15,43
18680,6763,6765,22,12,22,6,9,7,29,30,-1,21,23,27
18681,15905,15918,35,7,27,9,11,7,23,25,-2,29,25,38
18682,15905,15918,17,12,27,6,12,9,24,32,-8,24,30,30
18683,15905,15918,25,6,27,12,8,7,41,34,7,32,22,44
18684,15905,15918,12,14,27,7,7,13,34,47,-13,21,33,28
18685,15905,15918,43,1,27,22,2,3,66,22,44,46,8,68
18686,15905,15918,22,5,27,12,8,7,47,33,14,32,22,44
18687,15905,15918,40,11,27,6,12,9,32,37,-5,24,30,30
18688,15905,15918,57,13,27,6,11,10,22,42,-20,23,31,29
18689,15954,15960,22,5,33,16,8,9,55,38,17,40,26,56
18690,15954,15960,40,8,33,10,13,10,44,45,-1,33,33,43
18691,15954,15960,57,14,33,7,13,13,27,51,-24,27,39,34
18692,15954,15960,43,1,33,25,5,3,76,26,50,55,11,80
18693,15954,15960,25,6,33,14,9,10,50,44,6,37,29,51
18694,15954,15960,35,7,33,11,11,11,33,38,-5,33,33,44
18695,15954,15960,17,9,33,8,15,10,33,37,-4,31,35,39
18696,15954,15960,42,15,33,7,12,14,29,51,-22,26,40,33
18697,15954,15960,4,12,33,7,16,10,31,34,-3,30,36,37
18698,15954,15960,31,17,33,7,7,19,34,65,-31,21,45,28
18699,15954,15960,21,18,33,7,6,20,28,62,-34,20,46,27
18700,15954,15960,49,3,33,17,11,5,66,30,36,45,21,62
18701,15954,15960,37,13,33,10,5,18,40,56,-16,25,41,35
18702,15954,15960,27,16,33,7,9,17,34,47,-13,23,43,30
18703,15954,15960,1,2,33,21,6,6,74,31,43,48,18,69
18704,15954,15960,12,10,33,10,8,15,44,53,-9,28,38,38
18705,15954,15960,33,4,33,15,13,5,63,41,22,43,23,58
18706,15954,15960,28,11,33,9,11,13,36,48,-12,29,37,38
18707,16122,16128,33,8,10,4,3,3,11,9,2,11,9,15
18708,16122,16128,28,15,10,2,3,5,8,16,-8,7,13,9
18709,16122,16128,27,7,10,5,1,4,13,15,-2,11,9,16
18710,16122,16128,12,6,10,5,2,3,12,10,2,12,8,17
18711,16122,16128,25,13,10,3,2,5,9,14,-5,8,12,11
18712,16122,16128,1,1,10,8,2,0,26,4,22,18,2,26
18713,16122,16128,17,10,10,4,1,5,16,17,-1,9,11,13
18714,16122,16128,42,17,10,1,3,6,9,16,-7,5,15,6
18715,16122,16128,35,14,10,3,1,6,11,15,-4,7,13,10
18716,16122,16128,49,5,10,5,2,3,13,9,4,12,8,17
18717,16122,16128,37,12,10,3,3,4,14,12,2,9,11,12
18718,16122,16128,46,16,10,2,1,7,7,17,-10,5,15,7
18719,16122,16128,9,18,10,0,4,6,10,21,-11,4,16,4
18720,16122,16128,4,3,10,7,0,3,20,15,5,14,6,21
18721,16122,16128,43,2,10,8,0,2,24,11,13,16,4,24
18722,16122,16128,40,4,10,5,2,3,16,10,6,12,8,17
18723,16122,16128,22,9,10,3,5,2,11,12,-1,11,9,14
18724,16122,16128,57,11,10,4,1,5,18,25,-7,9,11,13
18725,16136,16142,43,2,12,9,1,2,28,14,14,19,5,28
18726,16136,16142,40,4,12,6,2,4,21,12,9,14,10,20
18727,16136,16142,22,7,12,5,5,2,14,12,2,15,9,20
18728,16136,16142,57,8,12,6,1,5,21,26,-5,13,11,19
18729,16136,16142,12,9,12,5,3,4,14,14,0,13,11,18
18730,16136,16142,25,13,12,4,2,6,10,16,-6,10,14,14
18731,16136,16142,4,3,12,8,0,4,24,17,7,16,8,24
18732,16136,16142,9,18,12,0,4,8,10,23,-13,4,20,4
18733,16136,16142,1,1,12,10,2,0,32,5,27,22,2,32
18734,16136,16142,49,5,12,6,2,4,17,15,2,14,10,20
18735,16136,16142,37,11,12,4,3,5,17,15,2,11,13,15
18736,16136,16142,46,16,12,2,1,9,8,23,-15,5,19,7
18737,16136,16142,35,14,12,4,1,7,14,17,-3,9,15,13
18738,16136,16142,17,10,12,5,2,5,20,19,1,12,12,17
18739,16136,16142,42,17,12,1,3,8,11,23,-12,5,19,6
18740,16136,16142,27,6,12,6,2,4,15,16,-1,14,10,20
18741,16136,16142,33,12,12,4,3,5,13,15,-2,11,13,15
18742,16136,16142,28,15,12,3,3,6,10,17,-7,9,15,12
18743,16178,16205,33,12,17,6,3,8,25,22,3,15,19,21
18744,16178,16205,28,15,17,4,4,9,17,27,-10,12,22,16
18745,16178,16205,17,8,17,7,3,7,31,28,3,17,17,24
18746,16178,16205,42,18,17,1,3,13,15,36,-21,5,29,6
18747,16178,16205,1,1,17,14,2,1,45,9,36,30,4,44
18748,16178,16205,27,3,17,10,3,4,26,19,7,23,11,33
18749,16178,16205,49,5,17,9,3,5,28,20,8,21,13,30
18750,16178,16205,37,11,17,6,4,7,23,22,1,16,18,22
18751,16178,16205,46,16,17,4,2,11,16,34,-18,10,24,14
18752,16178,16205,4,4,17,10,2,5,31,22,9,22,12,32
18753,16178,16205,9,17,17,1,5,11,15,35,-20,7,27,8
18754,16178,16205,25,9,17,7,2,8,17,27,-10,16,18,23
18755,16178,16205,12,10,17,6,5,6,18,21,-3,17,17,23
18756,16178,16205,35,14,17,5,2,10,16,21,-5,12,22,17
18757,16178,16205,43,2,17,13,1,3,37,17,20,27,7,40
18758,16178,16205,22,6,17,8,6,3,23,17,6,22,12,30
18759,8625,8631,1,3,30,14,10,6,59,35,24,38,22,52
18760,8625,8631,37,1,30,18,7,5,51,32,19,43,17,61
18761,8625,8631,49,4,30,15,6,9,52,38,14,36,24,51
18762,8625,8631,21,8,30,11,10,9,47,39,8,32,28,43
18763,8625,8631,4,13,30,9,7,14,34,40,-6,25,35,34
18764,8625,8631,43,2,30,17,7,6,70,34,36,41,19,58
18765,8625,8631,57,10,30,11,7,12,32,35,-3,29,31,40
18766,8625,8631,24,11,30,9,13,8,39,40,-1,31,29,40
18767,8625,8631,13,5,30,14,5,11,54,45,9,33,27,47
18768,8625,8631,20,6,30,13,7,10,49,40,9,33,27,46
18769,8625,8631,56,12,30,9,8,13,31,39,-8,26,34,35
18770,8625,8631,41,14,30,8,8,14,32,45,-13,24,36,32
18771,8625,8631,19,7,30,13,6,11,40,40,0,32,28,45
18772,8625,8631,17,15,30,8,7,15,35,54,-19,23,37,31
18773,8625,8631,8,18,30,7,6,17,27,59,-32,20,40,27
18774,8625,8631,12,9,30,11,7,12,39,40,-1,29,31,40
18775,8625,8631,53,16,30,6,11,13,39,63,-24,23,37,29
18776,8625,8631,52,17,30,6,10,14,30,42,-12,22,38,28
18777,8632,8637,52,18,31,6,10,15,31,45,-14,22,40,28
18778,8632,8637,12,10,31,11,7,13,39,44,-5,29,33,40
18779,8632,8637,53,17,31,6,11,14,40,65,-25,23,39,29
18780,8632,8637,19,7,31,13,6,12,42,43,-1,32,30,45
18781,8632,8637,17,14,31,9,7,15,37,55,-18,25,37,34
18782,8632,8637,8,16,31,8,6,17,30,60,-30,22,40,30
18783,8632,8637,13,5,31,15,5,11,57,46,11,35,27,50
18784,8632,8637,20,6,31,13,7,11,49,42,7,33,29,46
18785,8632,8637,56,12,31,10,8,13,34,41,-7,28,34,38
18786,8632,8637,41,15,31,8,8,15,33,48,-15,24,38,32
18787,8632,8637,43,2,31,18,7,6,73,35,38,43,19,61
18788,8632,8637,24,9,31,10,13,8,41,40,1,33,29,43
18789,8632,8637,57,11,31,11,7,13,33,38,-5,29,33,40
18790,8632,8637,21,8,31,11,10,10,47,41,6,32,30,43
18791,8632,8637,4,13,31,10,7,14,36,40,-4,27,35,37
18792,8632,8637,37,1,31,19,7,5,53,32,21,45,17,64
18793,8632,8637,49,4,31,15,6,10,52,40,12,36,26,51
18794,8632,8637,1,3,31,15,10,6,63,35,28,40,22,55
18795,8835,8841,4,5,13,6,3,4,31,20,11,15,11,21
18796,8835,8841,21,9,13,4,6,3,16,18,-2,14,12,18
18797,8835,8841,20,2,13,8,2,3,26,15,11,18,8,26
18798,8835,8841,41,3,13,6,6,1,28,12,16,18,8,24
18799,8835,8841,13,10,13,4,5,4,19,21,-2,13,13,17
18800,8835,8841,56,11,13,4,4,5,17,20,-3,12,14,16
18801,8835,8841,43,1,13,9,4,0,43,12,31,22,4,31
18802,8835,8841,57,13,13,3,5,5,13,16,-3,11,15,14
18803,8835,8841,24,14,13,3,5,5,15,24,-9,11,15,14
18804,8835,8841,2,18,13,2,2,9,14,34,-20,6,20,8
18805,8835,8841,17,16,13,2,4,7,8,24,-16,8,18,10
18806,8835,8841,19,17,13,1,6,6,5,16,-11,8,18,9
18807,8835,8841,12,6,13,6,3,4,20,22,-2,15,11,21
18808,8835,8841,53,12,13,4,2,7,18,24,-6,10,16,14
18809,8835,8841,11,15,13,3,4,6,13,24,-11,10,16,13
18810,8835,8841,37,7,13,6,2,5,28,15,13,14,12,20
18811,8835,8841,49,8,13,5,3,5,19,17,2,13,13,18
18812,8835,8841,1,4,13,6,4,3,19,18,1,16,10,22
18813,8849,8855,1,3,15,8,4,3,23,20,3,20,10,28
18814,8849,8855,37,6,15,8,2,5,33,16,17,18,12,26
18815,8849,8855,49,9,15,5,4,6,21,20,1,14,16,19
18816,8849,8855,12,7,15,6,3,6,22,27,-5,15,15,21
18817,8849,8855,53,12,15,4,3,8,22,30,-8,11,19,15
18818,8849,8855,11,15,15,3,5,7,16,28,-12,11,19,14
18819,8849,8855,17,16,15,3,4,8,11,26,-15,10,20,13
18820,8849,8855,19,18,15,1,7,7,6,20,-14,9,21,10
18821,8849,8855,43,1,15,11,4,0,48,12,36,26,4,37
18822,8849,8855,57,13,15,3,6,6,14,18,-4,12,18,15
18823,8849,8855,24,14,15,3,6,6,19,29,-10,12,18,15
18824,8849,8855,2,17,15,3,2,10,18,38,-20,8,22,11
18825,8849,8855,20,2,15,10,2,3,31,15,16,22,8,32
18826,8849,8855,41,5,15,7,6,2,30,15,15,20,10,27
18827,8849,8855,13,10,15,4,6,5,19,24,-5,14,16,18
18828,8849,8855,56,11,15,4,5,6,18,25,-7,13,17,17
18829,8849,8855,4,4,15,8,3,4,34,20,14,19,11,27
18830,8849,8855,21,8,15,4,8,3,17,19,-2,16,14,20
18831,9171,9177,37,4,11,6,2,3,20,17,3,14,8,20
18832,9171,9177,49,9,11,4,4,3,15,14,1,12,10,16
18833,9171,9177,20,6,11,5,3,3,20,8,12,13,9,18
18834,9171,9177,41,7,11,5,2,4,15,13,2,12,10,17
18835,9171,9177,13,12,11,2,5,4,7,10,-3,9,13,11
18836,9171,9177,56,18,11,1,4,6,8,17,-9,6,16,7
18837,14449,14455,28,15,28,7,5,16,31,56,-25,19,37,26
18838,14449,14455,4,4,28,16,3,9,64,46,18,35,21,51
18839,14449,14455,35,7,28,12,7,9,45,40,5,31,25,43
18840,14449,14455,6,18,28,3,11,14,28,56,-28,17,39,20
18841,14449,14455,1,3,28,16,4,8,57,27,30,36,20,52
18842,14449,14455,47,13,28,8,5,15,45,57,-12,21,35,29
18843,14449,14455,17,5,28,14,6,8,59,37,22,34,22,48
18844,14449,14455,43,1,28,19,8,1,73,27,46,46,10,65
18845,14449,14455,22,9,28,12,6,10,52,48,4,30,26,42
18846,14449,14455,24,10,28,11,5,12,42,56,-14,27,29,38
18847,14449,14455,34,12,28,11,2,15,49,57,-8,24,32,35
18848,14449,14455,49,2,28,17,2,9,61,40,21,36,20,53
18849,14449,14455,37,14,28,7,8,13,40,52,-12,22,34,29
18850,14449,14455,27,16,28,5,7,16,32,56,-24,17,39,22
18851,14449,14455,25,8,28,12,7,9,51,59,-8,31,25,43
18852,14449,14455,12,11,28,9,9,10,45,51,-6,27,29,36
18853,14449,14455,58,17,28,3,11,14,22,49,-27,17,39,20
18854,14456,14462,25,9,29,12,8,9,52,60,-8,32,26,44
18855,14456,14462,12,12,29,9,9,11,46,53,-7,27,31,36
18856,14456,14462,58,16,29,4,11,14,25,51,-26,19,39,23
18857,14456,14462,27,17,29,5,7,17,33,59,-26,17,41,22
18858,14456,14462,49,3,29,17,2,10,61,42,19,36,22,53
18859,14456,14462,37,13,29,8,8,13,43,53,-10,24,34,32
18860,14456,14462,43,1,29,20,8,1,78,27,51,48,10,68
18861,14456,14462,22,8,29,13,6,10,54,49,5,32,26,45
18862,14456,14462,24,10,29,11,5,13,42,61,-19,27,31,38
18863,14456,14462,34,11,29,11,3,15,50,58,-8,25,33,36
18864,14456,14462,17,6,29,14,6,9,60,40,20,34,24,48
18865,14456,14462,47,14,29,8,5,16,47,60,-13,21,37,29
18866,14456,14462,1,2,29,17,4,8,60,28,32,38,20,55
18867,14456,14462,35,7,29,13,7,9,47,40,7,33,25,46
18868,14456,14462,6,18,29,3,11,15,28,60,-32,17,41,20
18869,14456,14462,4,4,29,16,3,10,64,48,16,35,23,51
18870,14456,14462,33,5,29,15,6,8,64,42,22,36,22,51
18871,14456,14462,28,15,29,8,5,16,33,56,-23,21,37,29
18872,14463,14469,33,5,30,15,6,9,65,44,21,36,24,51
18873,14463,14469,28,14,30,8,6,16,34,57,-23,22,38,30
18874,14463,14469,4,3,30,17,3,10,68,48,20,37,23,54
18875,14463,14469,35,7,30,14,7,9,50,40,10,35,25,49
18876,14463,14469,6,18,30,3,11,16,28,61,-33,17,43,20
18877,14463,14469,1,2,30,18,4,8,62,29,33,40,20,58
18878,14463,14469,47,15,30,8,5,17,47,64,-17,21,39,29
18879,14463,14469,17,6,30,14,7,9,62,42,20,35,25,49
18880,14463,14469,43,1,30,20,8,2,78,32,46,48,12,68
18881,14463,14469,22,9,30,13,6,11,54,52,2,32,28,45
18882,14463,14469,24,10,30,12,5,13,46,61,-15,29,31,41
18883,14463,14469,34,12,30,11,3,16,50,62,-12,25,35,36
18884,14463,14469,49,4,30,17,2,11,62,44,18,36,24,53
18885,14463,14469,37,13,30,9,8,13,44,53,-9,26,34,35
18886,14463,14469,27,17,30,5,8,17,34,60,-26,18,42,23
18887,14463,14469,25,8,30,13,8,9,57,60,-3,34,26,47
18888,14463,14469,12,11,30,10,9,11,48,54,-6,29,31,39
18889,14463,14469,58,16,30,4,12,14,27,53,-26,20,40,24
18890,14260,14266,25,7,6,3,1,2,13,14,-1,7,5,10
18891,14260,14266,58,16,6,0,4,2,4,11,-7,4,8,4
18892,14260,14266,12,17,6,0,3,3,4,9,-5,3,9,3
18893,14260,14266,27,8,6,3,0,3,11,10,1,6,6,9
18894,14260,14266,37,14,6,1,1,4,10,16,-6,3,9,4
18895,14260,14266,49,15,6,1,1,4,4,12,-8,3,9,4
18896,14260,14266,43,1,6,5,1,0,18,8,10,11,1,16
18897,14260,14266,34,5,6,3,1,2,13,9,4,7,5,10
18898,14260,14266,24,9,6,3,0,3,8,11,-3,6,6,9
18899,14260,14266,22,10,6,2,3,1,16,11,5,7,5,9
18900,14260,14266,33,11,6,2,2,2,12,12,0,6,6,8
18901,14260,14266,28,18,6,0,2,4,5,16,-11,2,10,2
18902,14260,14266,17,2,6,5,0,1,16,7,9,10,2,15
18903,14260,14266,47,12,6,1,3,2,7,9,-2,5,7,6
18904,14260,14266,1,3,6,4,1,1,14,5,9,9,3,13
18905,14260,14266,35,6,6,3,1,2,12,9,3,7,5,10
18906,14260,14266,6,13,6,1,2,3,8,12,-4,4,8,5
18907,14260,14266,4,4,6,4,0,2,17,11,6,8,4,12
18908,14708,14714,27,5,16,9,1,6,28,30,-2,19,13,28
18909,14708,14714,33,4,16,9,2,5,37,21,16,20,12,29
18910,14708,14714,28,14,16,3,4,9,17,29,-12,10,22,13
18911,14708,14714,25,7,16,8,3,5,28,24,4,19,13,27
18912,14708,14714,12,10,16,5,6,5,22,24,-2,16,16,21
18913,14708,14714,4,6,16,8,4,4,33,25,8,20,12,28
18914,14708,14714,21,12,16,6,1,9,20,24,-4,13,19,19
18915,21246,21252,4,5,14,7,2,5,29,26,3,16,12,23
18916,21246,21252,9,8,14,5,3,6,16,26,-10,13,15,18
18917,21246,21252,49,7,14,5,5,4,19,16,3,15,13,20
18918,21246,21252,22,1,14,10,4,0,39,15,24,24,4,34
18919,21246,21252,43,4,14,8,3,3,27,16,11,19,9,27
18920,21246,21252,57,12,14,4,4,6,16,26,-10,12,16,16
18921,21246,21252,27,9,14,5,2,7,19,20,-1,12,16,17
18922,21246,21252,15,10,14,5,1,8,18,27,-9,11,17,16
18923,21246,21252,10,13,14,1,8,5,16,20,-4,10,18,11
18924,21246,21252,45,16,14,2,3,9,21,35,-14,7,21,9
18925,21246,21252,56,11,14,4,4,6,20,24,-4,12,16,16
18926,21246,21252,12,14,14,2,4,8,12,23,-11,8,20,10
18927,21246,21252,1,2,14,9,4,1,36,14,22,22,6,31
18928,21344,21350,1,2,25,13,7,5,53,27,26,33,17,46
18929,21344,21350,28,5,25,11,9,5,42,30,12,31,19,42
18930,21344,21350,12,16,25,4,5,16,23,45,-22,13,37,17
18931,21344,21350,22,1,25,17,6,2,57,24,33,40,10,57
18932,21344,21350,43,6,25,11,5,9,40,31,9,27,23,38
18933,21344,21350,57,13,25,7,6,12,30,47,-17,20,30,27
18934,21344,21350,49,4,25,12,7,6,38,27,11,31,19,43
18935,21344,21350,21,3,25,13,6,6,36,28,8,32,18,45
18936,21344,21350,4,7,25,11,5,9,43,40,3,27,23,38
18937,21344,21350,9,14,25,6,6,13,24,44,-20,18,32,24
18938,21344,21350,27,8,25,10,5,10,36,35,1,25,25,35
18939,21344,21350,15,11,25,9,1,15,28,46,-18,19,31,28
18940,21344,21350,45,12,25,7,6,12,40,50,-10,20,30,27
18941,21344,21350,10,15,25,4,10,11,28,37,-9,18,32,22
18942,21344,21350,38,10,25,8,5,12,25,30,-5,21,29,29
18943,21344,21350,56,9,25,9,7,9,33,35,-2,25,25,34
18944,21365,21371,56,8,28,11,7,10,42,40,2,29,27,40
18945,21365,21371,28,5,28,12,10,6,46,33,13,34,22,46
18946,21365,21371,38,10,28,10,6,12,30,31,-1,26,30,36
18947,21365,21371,27,9,28,11,6,11,40,40,0,28,28,39
18948,21365,21371,45,11,28,8,7,13,45,56,-11,23,33,31
18949,21365,21371,15,12,28,9,2,17,32,52,-20,20,36,29
18950,21365,21371,21,3,28,14,7,7,38,30,8,35,21,49
18951,21365,21371,4,7,28,13,5,10,49,44,5,31,25,44
18952,21365,21371,49,4,28,13,8,7,43,31,12,34,22,47
18953,21365,21371,22,1,28,17,8,3,59,28,31,42,14,59
18954,21365,21371,43,6,28,13,6,9,45,34,11,32,24,45
18955,21365,21371,12,16,28,4,5,19,25,51,-26,13,43,17
18956,21365,21371,10,15,28,5,11,12,33,45,-12,21,35,26
18957,21365,21371,9,14,28,6,9,13,28,48,-20,21,35,27
18958,21365,21371,1,2,28,15,8,5,59,30,29,38,18,53
18959,21365,21371,57,13,28,7,7,14,33,54,-21,21,35,28
18960,21372,21378,22,1,29,18,8,3,60,28,32,44,14,62
18961,21372,21378,43,5,29,14,6,9,47,34,13,34,24,48
18962,21372,21378,57,13,29,7,7,15,34,56,-22,21,37,28
18963,21372,21378,1,2,29,16,8,5,63,30,33,40,18,56
18964,21372,21378,21,4,29,14,7,8,39,32,7,35,23,49
18965,21372,21378,4,6,29,14,5,10,51,45,6,33,25,47
18966,21372,21378,9,14,29,6,9,14,29,50,-21,21,37,27
18967,21372,21378,27,8,29,12,6,11,42,41,1,30,28,42
18968,21372,21378,45,11,29,8,8,13,46,57,-11,24,34,32
18969,21372,21378,15,12,29,9,2,18,32,56,-24,20,38,29
18970,21372,21378,10,15,29,5,12,12,34,46,-12,22,36,27
18971,21372,21378,12,16,29,4,5,20,25,52,-27,13,45,17
18972,21372,21378,56,9,29,11,7,11,42,42,0,29,29,40
18973,21372,21378,28,7,29,12,11,6,47,34,13,35,23,47
18974,21372,21378,38,10,29,10,7,12,31,32,-1,27,31,37
18975,21372,21378,49,3,29,14,8,7,45,32,13,36,22,50
18976,21603,21606,9,13,12,3,2,7,15,25,-10,8,16,11
18977,21603,21606,49,2,12,7,3,2,25,10,15,17,7,24
18978,21603,21606,38,9,12,4,4,4,14,14,0,12,12,16
18979,21603,21606,28,12,12,3,4,5,12,22,-10,10,14,13
18980,21603,21606,56,10,12,4,2,6,21,20,1,10,14,14
18981,21603,21606,45,7,12,5,4,3,20,14,6,14,10,19
18982,21603,21606,27,8,12,5,4,3,17,13,4,14,10,19
18983,21603,21606,15,14,12,2,4,6,9,24,-15,8,16,10
18984,21603,21606,10,15,12,1,4,7,9,25,-16,6,18,7
18985,21603,21606,21,3,12,7,2,3,26,17,9,16,8,23
18986,21603,21606,4,5,12,6,3,3,24,15,9,15,9,21
18987,21603,21606,1,1,12,8,4,0,27,4,23,20,4,28
18988,21603,21606,24,4,12,7,2,3,22,18,4,16,8,23
18989,21603,21606,22,6,12,6,2,4,19,15,4,14,10,20
18990,21603,21606,43,11,12,3,4,5,12,13,-1,10,14,13
18991,21603,21606,57,16,12,1,0,11,8,31,-23,2,22,3
18992,21701,21707,22,6,24,11,4,9,37,34,3,26,22,37
18993,9171,9177,52,13,11,2,5,4,9,16,-7,9,13,11
18994,9171,9177,43,2,11,7,3,1,29,13,16,17,5,24
18995,9171,9177,57,10,11,4,2,5,14,17,-3,10,12,14
18996,9171,9177,24,16,11,1,6,4,7,16,-9,8,14,9
18997,9171,9177,17,8,11,4,4,3,14,12,2,12,10,16
18998,9171,9177,19,15,11,2,3,6,12,27,-15,7,15,9
18999,9171,9177,27,17,11,2,2,7,12,18,-6,6,16,8
19000,9171,9177,4,3,11,6,2,3,18,10,8,14,8,20
19001,9171,9177,21,14,11,2,4,5,10,18,-8,8,14,10
19002,9171,9177,53,5,11,5,4,2,17,13,4,14,8,19
19003,9171,9177,12,11,11,3,4,4,15,20,-5,10,12,13
19004,9171,9177,1,1,11,8,1,2,29,12,17,17,5,25
19005,9178,9184,1,1,12,9,1,2,31,12,19,19,5,28
19006,9178,9184,53,6,12,5,5,2,19,15,4,15,9,20
19007,9178,9184,12,12,12,3,4,5,15,22,-7,10,14,13
19008,9178,9184,4,3,12,7,2,3,21,10,11,16,8,23
19009,9178,9184,21,14,12,2,5,5,12,20,-8,9,15,11
19010,9178,9184,27,17,12,2,2,8,14,22,-8,6,18,8
19011,9178,9184,17,10,12,4,4,4,15,14,1,12,12,16
19012,9178,9184,19,16,12,2,3,7,12,28,-16,7,17,9
19013,9178,9184,43,2,12,8,3,1,30,13,17,19,5,27
19014,9178,9184,57,9,12,5,2,5,18,18,0,12,12,17
19015,9178,9184,24,13,12,2,6,4,11,18,-7,10,14,12
19016,9178,9184,52,15,12,2,5,5,10,20,-10,9,15,11
19017,9178,9184,41,4,12,6,2,4,19,14,5,14,10,20
19018,9178,9184,20,8,12,5,3,4,20,9,11,13,11,18
19019,9178,9184,13,11,12,3,5,4,8,10,-2,11,13,14
19020,9178,9184,56,18,12,1,4,7,9,21,-12,6,18,7
19021,9178,9184,37,5,12,6,2,4,20,20,0,14,10,20
19022,9178,9184,49,7,12,5,4,3,17,15,2,14,10,19
19023,9115,9121,37,5,2,1,0,1,5,5,0,2,2,3
19024,9115,9121,49,6,2,1,0,1,3,4,-1,2,2,3
19025,9115,9121,21,3,2,1,1,0,4,2,2,3,1,4
19026,9115,9121,4,9,2,1,0,1,2,5,-3,2,2,3
19027,9115,9121,19,8,2,1,0,1,3,5,-2,2,2,3
19028,9115,9121,17,10,2,0,2,0,2,2,0,2,2,2
19029,9115,9121,41,2,2,1,1,0,4,1,3,3,1,4
19030,9115,9121,13,7,2,1,0,1,2,3,-1,2,2,3
19031,9115,9121,20,14,2,0,2,0,0,0,0,2,2,2
19032,9115,9121,56,15,2,0,1,1,3,4,-1,1,3,1
19033,9115,9121,52,12,2,0,2,0,1,1,0,2,2,2
19034,9115,9121,53,4,2,1,1,0,3,1,2,3,1,4
19035,9115,9121,12,10,2,0,2,0,2,2,0,2,2,2
19036,9115,9121,43,1,2,1,1,0,6,2,4,3,1,4
19037,9115,9121,57,16,2,0,1,1,2,3,-1,1,3,1
19038,9115,9121,24,17,2,0,1,1,1,2,-1,1,3,1
19039,9115,9121,27,12,2,0,2,0,1,1,0,2,2,2
19040,9115,9121,1,17,2,0,1,1,1,2,-1,1,3,1
19041,9269,9275,37,4,22,10,5,7,34,30,4,25,19,35
19042,9269,9275,49,8,22,8,8,6,30,22,8,24,20,32
19043,9269,9275,27,14,22,6,3,13,26,37,-11,15,29,21
19044,9269,9275,43,2,22,13,7,2,56,22,34,33,11,46
19045,9269,9275,57,9,22,8,6,8,38,33,5,22,22,30
19046,9269,9275,24,12,22,5,10,7,22,30,-8,20,24,25
19047,9269,9275,53,5,22,9,8,5,34,30,4,26,18,35
19048,9269,9275,12,11,22,7,6,9,29,37,-8,20,24,27
19049,9269,9275,20,6,22,10,4,8,34,24,10,24,20,34
19050,9269,9275,41,7,22,10,4,8,34,30,4,24,20,34
19051,9269,9275,56,13,22,6,5,11,24,33,-9,17,27,23
19052,9269,9275,13,15,22,4,8,10,14,25,-11,16,28,20
19053,9269,9275,52,16,22,4,7,11,18,40,-22,15,29,19
19054,9269,9275,19,17,22,4,7,11,19,42,-23,15,29,19
19055,9269,9275,17,18,22,4,6,12,21,40,-19,14,30,18
19056,9269,9275,4,3,22,12,5,5,38,20,18,29,15,41
19057,9269,9275,21,10,22,7,8,7,24,29,-5,22,22,29
19058,9269,9275,1,1,22,16,3,3,48,19,29,35,9,51
19059,9276,9282,1,1,23,17,3,3,51,20,31,37,9,54
19060,9276,9282,4,3,23,12,6,5,39,21,18,30,16,42
19061,9276,9282,21,10,23,7,8,8,24,32,-8,22,24,29
19062,9276,9282,19,17,23,4,8,11,19,42,-23,16,30,20
19063,9276,9282,17,18,23,4,6,13,22,43,-21,14,32,18
19064,9276,9282,52,15,23,5,7,11,21,41,-20,17,29,22
19065,9276,9282,20,4,23,11,4,8,37,24,13,26,20,37
19066,9276,9282,41,6,23,10,5,8,34,30,4,25,21,35
19067,9276,9282,56,14,23,6,5,12,25,35,-10,17,29,23
19068,9276,9282,13,16,23,4,9,10,15,26,-11,17,29,21
19069,9276,9282,53,5,23,9,9,5,34,30,4,27,19,36
19070,9276,9282,12,11,23,7,6,10,30,41,-11,20,26,27
19071,9276,9282,43,2,23,14,7,2,57,22,35,35,11,49
19072,9276,9282,57,9,23,8,6,9,39,36,3,22,24,30
19073,16892,16898,12,14,15,3,7,5,12,17,-5,13,17,16
19074,16892,16898,42,17,15,3,4,8,12,20,-8,10,20,13
19075,16892,16898,17,18,15,0,2,13,7,31,-24,2,28,2
19076,16892,16898,27,6,15,7,5,3,19,15,4,19,11,26
19077,16892,16898,45,15,15,3,6,6,17,23,-6,12,18,15
19078,16892,16898,33,10,15,4,6,5,21,25,-4,14,16,18
19079,16892,16898,28,11,15,5,1,9,20,24,-4,11,19,16
19080,16892,16898,4,5,15,8,3,4,24,22,2,19,11,27
19081,17011,17017,4,4,27,14,5,8,44,33,11,33,21,47
19082,17011,17017,27,6,27,12,8,7,39,33,6,32,22,44
19083,17011,17017,45,12,27,8,8,11,32,39,-7,24,30,32
19084,17011,17017,42,10,27,9,6,12,29,33,-4,24,30,33
19085,17011,17017,17,18,27,4,4,19,21,54,-33,12,42,16
19086,17011,17017,25,7,27,11,7,9,32,31,1,29,25,40
19087,17011,17017,12,16,27,5,11,11,24,35,-11,21,33,26
19088,17011,17017,22,1,27,18,6,3,61,27,34,42,12,60
19089,17011,17017,43,2,27,17,8,2,52,26,26,42,12,59
19090,17011,17017,51,9,27,9,8,10,41,45,-4,26,28,35
19091,17011,17017,57,11,27,9,6,12,23,27,-4,24,30,33
19092,17011,17017,1,5,27,13,6,8,47,30,17,32,22,45
19093,17011,17017,46,15,27,5,12,10,26,38,-12,22,32,27
19094,17011,17017,37,17,27,5,7,15,24,46,-22,17,37,22
19095,17011,17017,49,3,27,16,5,6,54,32,22,37,17,53
19096,17011,17017,35,8,27,9,8,10,38,39,-1,26,28,35
19097,17011,17017,33,13,27,7,9,11,36,45,-9,23,31,30
19098,17011,17017,28,14,27,7,6,14,31,41,-10,20,34,27
19099,17340,17346,45,7,23,9,5,9,29,36,-7,23,23,32
19100,17340,17346,27,10,23,7,6,10,23,29,-6,20,26,27
19101,17340,17346,49,2,23,13,10,0,42,14,28,36,10,49
19102,17340,17346,23,13,23,7,4,12,24,37,-13,18,28,25
19103,17340,17346,46,18,23,3,3,17,18,52,-34,9,37,12
19104,17340,17346,35,4,23,12,6,5,33,19,14,30,16,42
19105,17340,17346,57,3,23,13,6,4,52,22,30,32,14,45
19106,17340,17346,43,5,23,11,7,5,33,24,9,29,17,40
19107,17340,17346,22,9,23,8,7,8,33,36,-3,23,23,31
19108,17340,17346,51,11,23,6,9,8,28,36,-8,21,25,27
19109,17340,17346,24,14,23,6,7,10,27,35,-8,19,27,25
19110,17340,17346,25,8,23,8,8,7,33,24,9,24,22,32
19111,17340,17346,12,12,23,5,11,7,20,23,-3,21,25,26
19112,17340,17346,42,16,23,4,6,13,23,36,-13,14,32,18
19113,17340,17346,4,6,23,10,8,5,44,30,14,28,18,38
19114,17340,17346,33,15,23,6,5,12,25,33,-8,17,29,23
19115,17340,17346,28,17,23,4,6,13,19,38,-19,14,32,18
19116,17340,17346,1,1,23,15,6,2,33,15,18,36,10,51
19117,17396,17402,33,12,31,10,6,15,35,41,-6,26,36,36
19118,17396,17402,28,17,31,5,8,18,27,51,-24,18,44,23
19119,17396,17402,4,7,31,12,9,10,51,44,7,33,29,45
19120,17396,17402,25,6,31,12,9,10,42,30,12,33,29,45
19121,17396,17402,12,14,31,7,14,10,26,31,-5,28,34,35
19122,17396,17402,43,2,31,18,7,6,51,29,22,43,19,61
19123,17396,17402,57,4,31,16,8,7,59,31,28,40,22,56
19124,17396,17402,22,10,31,11,8,12,50,50,0,30,32,41
19125,17396,17402,24,11,31,9,10,12,39,45,-6,28,34,37
19126,17396,17402,51,13,31,8,11,12,34,50,-16,27,35,35
19127,17396,17402,35,5,31,15,6,10,42,30,12,36,26,51
19128,17396,17402,49,1,31,20,11,0,55,17,38,51,11,71
19129,17396,17402,23,16,31,8,6,17,31,52,-21,22,40,30
19130,17396,17402,27,8,31,12,7,12,37,39,-2,31,31,43
19131,17396,17402,45,9,31,12,7,12,42,49,-7,31,31,43
19132,17396,17402,46,18,31,4,6,21,25,62,-37,14,48,18
19133,17396,17402,1,3,31,18,7,6,40,28,12,43,19,61
19134,17396,17402,42,15,31,7,10,14,35,42,-7,24,38,31
19135,17515,17521,1,8,1,0,1,0,1,1,0,1,1,1
19136,17515,17521,49,3,1,1,0,0,3,1,2,2,0,3
19137,17515,17521,23,16,1,0,0,1,1,3,-2,0,2,0
19138,17515,17521,56,6,1,0,1,0,2,2,0,1,1,1
19139,17515,17521,35,8,1,0,1,0,1,1,0,1,1,1
19140,17515,17521,43,2,1,1,0,0,3,0,3,2,0,3
19141,17515,17521,51,6,1,0,1,0,2,2,0,1,1,1
19142,17515,17521,24,8,1,0,1,0,1,1,0,1,1,1
19143,17515,17521,22,8,1,0,1,0,1,1,0,1,1,1
19144,17515,17521,32,14,1,0,0,1,1,2,-1,0,2,0
19145,17515,17521,57,17,1,0,0,1,0,3,-3,0,2,0
19146,17515,17521,25,5,1,1,0,0,1,0,1,2,0,3
19147,17515,17521,12,12,1,0,1,0,0,0,0,1,1,1
19148,17515,17521,42,18,1,0,0,1,0,5,-5,0,2,0
19149,17515,17521,45,12,1,0,1,0,0,0,0,1,1,1
19150,17515,17521,27,15,1,0,0,1,0,1,-1,0,2,0
19151,17515,17521,4,1,1,1,0,0,5,0,5,2,0,3
19152,8863,8911,37,6,17,8,3,6,33,18,15,19,15,27
19153,8863,8911,49,8,17,6,4,7,23,21,2,16,18,22
19154,8863,8911,20,2,17,11,2,4,36,24,12,24,10,35
19155,8863,8911,41,5,17,8,6,3,32,17,15,22,12,30
19156,8863,8911,13,10,17,5,6,6,21,27,-6,16,18,21
19157,8863,8911,56,11,17,5,5,7,21,29,-8,15,19,20
19158,8863,8911,1,4,17,9,5,3,29,21,8,23,11,32
19159,8863,8911,17,15,17,4,4,9,15,30,-15,12,22,16
19160,8863,8911,19,17,17,2,7,8,7,21,-14,11,23,13
19161,8863,8911,12,9,17,6,4,7,26,33,-7,16,18,22
19162,8863,8911,53,12,17,5,4,8,26,33,-7,14,20,19
19163,8863,8911,11,16,17,3,5,9,19,33,-14,11,23,14
19164,9017,9020,12,10,31,9,10,12,48,52,-4,28,34,37
19165,9017,9020,53,16,31,7,7,17,36,58,-22,21,41,28
19166,9017,9020,11,17,31,5,9,17,36,71,-35,19,43,24
19167,9017,9020,4,6,31,12,11,8,58,35,23,35,27,47
19168,9017,9020,21,7,31,10,13,8,37,43,-6,33,29,43
19169,9017,9020,1,3,31,17,10,4,68,41,27,44,18,61
19170,9017,9020,20,2,31,19,6,6,61,33,28,44,18,63
19171,9017,9020,41,4,31,15,11,5,56,33,23,41,21,56
19172,9017,9020,13,12,31,9,8,14,41,57,-16,26,36,35
19173,9017,9020,56,14,31,7,10,14,37,59,-22,24,38,31
19174,9017,9020,37,5,31,15,6,10,60,29,31,36,26,51
19175,9017,9020,49,9,31,9,11,11,38,40,-2,29,33,38
19176,9017,9020,43,1,31,24,7,0,91,19,72,55,7,79
19177,9017,9020,57,8,31,10,8,13,31,44,-13,28,34,38
19178,9017,9020,24,13,31,8,10,13,34,49,-15,26,36,34
19179,9017,9020,19,11,31,8,12,11,25,36,-11,28,34,36
19180,9017,9020,17,15,31,7,9,15,24,49,-25,23,39,30
19181,9017,9020,2,18,31,5,8,18,34,67,-33,18,44,23
19182,8786,8792,20,5,6,3,1,2,11,10,1,7,5,10
19183,8786,8792,41,7,6,2,3,1,9,6,3,7,5,9
19184,8786,8792,56,12,6,1,3,2,9,10,-1,5,7,6
19185,8786,8792,13,13,6,1,3,2,8,10,-2,5,7,6
19186,8786,8792,4,3,6,3,3,0,16,6,10,9,3,12
19187,8786,8792,21,14,6,1,3,2,6,9,-3,5,7,6
19188,8786,8792,43,1,6,4,2,0,24,6,18,10,2,14
19189,8786,8792,24,10,6,1,5,0,10,5,5,7,5,8
19190,8786,8792,57,15,6,0,4,2,5,8,-3,4,8,4
19191,8786,8792,2,18,6,0,1,5,6,19,-13,1,11,1
19192,8786,8792,1,4,6,3,2,1,9,8,1,8,4,11
19193,8786,8792,19,16,6,0,4,2,2,7,-5,4,8,4
19194,8786,8792,17,17,6,1,0,5,4,16,-12,2,10,3
19195,8786,8792,37,2,6,4,1,1,14,6,8,9,3,13
19196,8786,8792,49,9,6,2,2,2,11,12,-1,6,6,8
19197,8786,8792,12,6,6,3,1,2,9,13,-4,7,5,10
19198,8786,8792,11,8,6,2,3,1,7,4,3,7,5,9
19199,8786,8792,53,11,6,2,1,3,8,13,-5,5,7,7
19200,8793,8799,12,5,7,4,1,2,13,13,0,9,5,13
19201,8793,8799,11,8,7,2,3,2,8,6,2,7,7,9
19202,8793,8799,53,13,7,2,1,4,9,16,-7,5,9,7
19203,8793,8799,37,4,7,4,1,2,14,7,7,9,5,13
19204,8793,8799,49,11,7,2,2,3,12,14,-2,6,8,8
19205,8793,8799,19,16,7,0,5,2,3,8,-5,5,9,5
19206,8793,8799,17,18,7,1,0,6,4,20,-16,2,12,3
19207,8793,8799,1,3,7,4,2,1,11,9,2,10,4,14
19208,8793,8799,43,1,7,4,3,0,25,7,18,11,3,15
19209,8793,8799,24,12,7,1,5,1,11,7,4,7,7,8
19210,8793,8799,57,14,7,1,4,2,7,9,-2,6,8,7
19211,8793,8799,2,17,7,1,1,5,7,19,-12,3,11,4
19212,8793,8799,4,2,7,4,3,0,19,7,12,11,3,15
19213,8793,8799,21,15,7,1,4,2,7,10,-3,6,8,7
19214,8793,8799,20,6,7,3,1,3,11,11,0,7,7,10
19215,8793,8799,41,7,7,2,4,1,10,7,3,8,6,10
19216,8793,8799,56,9,7,2,3,2,11,11,0,7,7,9
19217,8793,8799,13,10,7,2,3,2,9,10,-1,7,7,9
19218,9297,9303,24,12,26,5,13,8,26,36,-10,23,29,28
19219,9297,9303,4,3,26,13,7,6,40,25,15,33,19,46
19220,9297,9303,21,10,26,8,9,9,28,37,-9,25,27,33
19221,9297,9303,17,17,26,4,8,14,25,49,-24,16,36,20
19222,9297,9303,19,18,26,4,8,14,19,50,-31,16,36,20
19223,9297,9303,20,4,26,13,5,8,44,26,18,31,21,44
19224,9297,9303,43,2,26,16,7,3,64,25,39,39,13,55
19225,9297,9303,57,8,26,10,7,9,45,38,7,27,25,37
19226,9297,9303,1,1,26,17,6,3,55,24,31,40,12,57
19227,9297,9303,41,5,26,12,6,8,39,31,8,30,22,42
19228,9297,9303,56,13,26,7,5,14,29,39,-10,19,33,26
19229,9297,9303,13,15,26,5,10,11,19,30,-11,20,32,25
19230,9297,9303,49,6,26,11,9,6,39,24,15,31,21,42
19231,9297,9303,37,7,26,11,7,8,39,33,6,29,23,40
19232,14708,14714,35,9,16,7,1,8,27,25,2,15,17,22
19233,14708,14714,1,1,16,15,0,1,54,10,44,30,2,45
19234,14708,14714,17,8,16,7,3,6,26,23,3,17,15,24
19235,14708,14714,47,18,16,2,1,13,20,55,-35,5,27,7
19236,14708,14714,22,13,16,4,6,6,18,21,-3,14,18,18
19237,14708,14714,34,15,16,3,4,9,17,38,-21,10,22,13
19238,14708,14714,24,16,16,2,3,11,20,37,-17,7,25,9
19239,14708,14714,40,17,16,1,5,10,12,31,-19,7,25,8
19240,14708,14714,49,3,16,9,4,3,41,21,20,22,10,31
19241,14708,14714,37,11,16,5,5,6,15,29,-14,15,17,20
19242,14708,14714,43,2,16,13,3,0,46,14,32,29,3,42
19243,14771,14777,27,10,22,10,3,9,36,40,-4,23,21,33
19244,14771,14777,25,5,22,11,5,6,43,33,10,27,17,38
19245,14771,14777,12,9,22,9,7,6,34,30,4,25,19,34
19246,14771,14777,49,3,22,12,6,4,53,25,28,30,14,42
19247,14771,14777,37,11,22,8,5,9,21,42,-21,21,23,29
19248,14771,14777,33,6,22,11,4,7,45,30,15,26,18,37
19249,14771,14777,28,16,22,3,4,15,20,41,-21,10,34,13
19250,14771,14777,43,1,22,18,4,0,64,18,46,40,4,58
19251,14771,14777,22,12,22,7,6,9,27,32,-5,20,24,27
19252,14771,14777,34,14,22,5,4,13,22,48,-26,14,30,19
19253,14771,14777,24,17,22,2,5,15,27,53,-26,9,35,11
19254,14771,14777,40,18,22,1,7,14,15,44,-29,9,35,10
19255,14771,14777,17,8,22,10,4,8,35,29,6,24,20,34
19256,14771,14777,47,15,22,5,1,16,27,62,-35,11,33,16
19257,14771,14777,1,2,22,17,4,1,63,16,47,38,6,55
19258,14771,14777,35,7,22,11,2,9,40,32,8,24,20,35
19259,14771,14777,4,4,22,12,5,5,44,32,12,29,15,41
19260,14771,14777,21,13,22,7,2,13,25,34,-9,16,28,23
19261,14638,14651,4,5,8,5,1,2,22,15,7,11,5,16
19262,14638,14651,21,13,8,2,0,6,7,15,-8,4,12,6
19263,14638,14651,1,1,8,8,0,0,32,8,24,16,0,24
19264,14638,14651,17,6,8,5,0,3,17,11,6,10,6,15
19265,14638,14651,47,15,8,1,1,6,12,27,-15,3,13,4
19266,14638,14651,33,4,8,5,1,2,21,9,12,11,5,16
19267,14638,14651,28,17,8,0,3,5,6,13,-7,3,13,3
19268,14638,14651,43,2,8,6,2,0,26,11,15,14,2,20
19269,14638,14651,22,11,8,2,3,3,9,10,-1,7,9,9
19270,14638,14651,40,14,8,1,3,4,5,16,-11,5,11,6
19271,14638,14651,34,16,8,1,1,6,6,23,-17,3,13,4
19272,14638,14651,24,18,8,0,2,6,10,24,-14,2,14,2
19273,14638,14651,49,3,8,5,1,2,24,12,12,11,5,16
19274,14638,14651,37,12,8,2,2,4,6,14,-8,6,10,8
19275,14638,14651,25,8,8,4,2,2,16,14,2,10,6,14
19276,14638,14651,12,9,8,3,4,1,12,10,2,10,6,13
19277,14638,14651,27,7,8,5,0,3,17,16,1,10,6,15
19278,14638,14651,35,10,8,4,0,4,13,13,0,8,8,12
19279,15023,15029,27,8,10,4,2,4,10,12,-2,10,10,14
19280,15023,15029,12,6,10,5,1,4,15,10,5,11,9,16
19281,15023,15029,17,12,10,3,3,4,11,13,-2,9,11,12
19282,15023,15029,22,3,10,6,3,1,29,14,15,15,5,21
19283,15023,15029,43,4,10,6,3,1,22,11,11,15,5,21
19284,15023,15029,34,9,10,4,1,5,11,22,-11,9,11,13
19285,15023,15029,40,18,10,1,2,7,11,26,-15,4,16,5
19286,15023,15029,49,5,10,5,3,2,16,12,4,13,7,18
19287,15023,15029,37,17,10,1,3,6,9,27,-18,5,15,6
19288,15023,15029,1,2,10,8,0,2,23,9,14,16,4,24
19289,15023,15029,25,14,10,3,1,6,16,18,-2,7,13,10
19290,15023,15029,4,1,10,8,1,1,19,10,9,17,3,25
19291,15023,15029,21,15,10,2,2,6,14,18,-4,6,14,8
19292,15023,15029,28,7,10,4,3,3,18,16,2,11,9,15
19293,15023,15029,33,11,10,4,0,6,19,14,5,8,12,12
19294,15023,15029,52,16,10,2,1,7,10,18,-8,5,15,7
19295,15023,15029,35,10,10,3,4,3,20,17,3,10,10,13
19296,15023,15029,6,13,10,3,3,4,18,24,-6,9,11,12
19297,15128,15134,35,9,21,7,8,6,40,30,10,22,20,29
19298,15128,15134,6,12,21,6,6,9,32,38,-6,18,24,24
19299,15128,15134,33,7,21,10,2,9,44,29,15,22,20,32
19300,15128,15134,28,8,21,9,4,8,32,30,2,22,20,31
19301,15128,15134,52,13,21,6,3,12,28,39,-11,15,27,21
19302,15128,15134,4,5,21,12,5,4,36,26,10,29,13,41
19303,15128,15134,21,16,21,4,5,12,27,41,-14,13,29,17
19304,15128,15134,1,1,21,15,1,5,52,25,27,31,11,46
19305,15128,15134,49,4,21,12,5,4,42,25,17,29,13,41
19306,15128,15134,37,18,21,2,6,13,21,56,-35,10,32,12
19307,15128,15134,12,6,21,11,6,4,33,21,12,28,14,39
19308,15128,15134,25,10,21,7,3,11,33,40,-7,17,25,24
19309,15128,15134,22,2,21,12,8,1,57,26,31,32,10,44
19310,15128,15134,43,3,21,12,7,2,45,23,22,31,11,43
19311,21701,21707,24,8,24,10,4,10,34,39,-5,24,24,34
19312,21701,21707,43,9,24,8,9,7,28,25,3,25,23,33
19313,21701,21707,57,16,24,3,2,19,20,50,-30,8,40,11
19314,21701,21707,1,1,24,17,6,1,51,11,40,40,8,57
19315,21701,21707,45,7,24,10,4,10,37,33,4,24,24,34
19316,21701,21707,15,13,24,7,5,12,20,35,-15,19,29,26
19317,21701,21707,49,5,24,12,5,7,43,29,14,29,19,41
19318,21701,21707,56,12,24,7,5,12,33,39,-6,19,29,26
19319,21701,21707,28,10,24,8,5,11,27,40,-13,21,27,29
19320,21701,21707,38,11,24,6,9,9,31,35,-4,21,27,27
19321,21701,21707,27,4,24,12,8,4,38,20,18,32,16,44
19322,21701,21707,10,15,24,5,5,14,19,48,-29,15,33,20
19323,21701,21707,4,2,24,14,6,4,50,25,25,34,14,48
19324,21701,21707,21,3,24,13,6,5,43,28,15,32,16,45
19325,21701,21707,9,14,24,6,3,15,24,44,-20,15,33,21
19326,21736,21742,4,2,29,16,7,6,59,34,25,39,19,55
19327,21736,21742,21,4,29,15,8,6,49,32,17,38,20,53
19328,21736,21742,9,15,29,6,4,19,29,58,-29,16,42,22
19329,21736,21742,49,5,29,14,7,8,47,32,15,35,23,49
19330,21736,21742,27,3,29,15,9,5,49,23,26,39,19,54
19331,21736,21742,45,9,29,10,6,13,41,49,-8,26,32,36
19332,21736,21742,15,13,29,8,6,15,28,51,-23,22,36,30
19333,21736,21742,10,16,29,5,5,19,21,60,-39,15,43,20
19334,21736,21742,38,10,29,9,9,11,38,40,-2,27,31,36
19335,21736,21742,28,12,29,9,6,14,33,50,-17,24,34,33
19336,21736,21742,56,11,29,9,6,14,40,44,-4,24,34,33
19337,21736,21742,1,1,29,21,7,1,58,14,44,49,9,70
19338,21736,21742,57,14,29,7,2,20,27,54,-27,16,42,23
19339,21736,21742,24,6,29,13,5,11,46,43,3,31,27,44
19340,21736,21742,22,7,29,13,5,11,45,42,3,31,27,44
19341,21736,21742,43,8,29,11,10,8,45,29,16,32,26,43
19342,21967,21973,43,7,10,4,5,1,20,15,5,13,7,17
19343,21967,21973,22,8,10,4,4,2,16,15,1,12,8,16
19344,21967,21973,57,9,10,5,0,5,17,14,3,10,10,15
19345,21967,21973,24,16,10,2,2,6,11,17,-6,6,14,8
19346,21967,21973,1,2,10,6,1,3,23,8,15,13,7,19
19347,21967,21973,56,11,10,4,2,4,12,13,-1,10,10,14
19348,21967,21973,27,3,10,6,1,3,15,9,6,13,7,19
19349,21967,21973,15,12,10,2,6,2,11,13,-2,10,10,12
19350,21967,21973,10,13,10,3,1,6,16,22,-6,7,13,10
19351,21967,21973,45,17,10,2,1,7,11,24,-13,5,15,7
19352,21967,21973,49,5,10,5,3,2,13,9,4,13,7,18
19353,21967,21973,16,6,10,5,3,2,17,15,2,13,7,18
19354,21967,21973,28,15,10,2,3,5,11,19,-8,7,13,9
19355,21967,21973,38,18,10,1,3,6,5,15,-10,5,15,6
19356,21967,21973,21,1,10,6,2,2,21,14,7,14,6,20
19357,21967,21973,9,10,10,4,3,3,15,10,5,11,9,15
19358,21967,21973,4,14,10,3,0,7,15,18,-3,6,14,9
19359,21967,21973,53,4,10,6,0,4,24,23,1,12,8,18
19360,22009,22015,53,3,15,9,1,5,38,34,4,19,11,28
19361,22009,22015,56,9,15,5,5,5,21,21,0,15,15,20
19362,22009,22015,21,4,15,7,4,4,28,23,5,18,12,25
19363,22009,22015,9,11,15,5,4,6,20,19,1,14,16,19
19364,22009,22015,4,13,15,5,1,9,22,25,-3,11,19,16
19365,22009,22015,16,5,15,7,4,4,27,25,2,18,12,25
19366,22009,22015,49,6,15,6,7,2,19,14,5,19,11,25
19367,22009,22015,22,1,15,9,4,2,35,20,15,22,8,31
19368,22009,22015,43,8,15,5,8,2,25,20,5,18,12,23
19369,22009,22015,57,12,15,6,0,9,22,27,-5,12,18,18
19370,22009,22015,24,16,15,3,5,7,22,28,-6,11,19,14
19371,22009,22015,28,17,15,2,5,8,17,28,-11,9,21,11
19372,22009,22015,38,18,15,2,4,9,9,25,-16,8,22,10
19373,22009,22015,27,7,15,7,3,5,22,16,6,17,13,24
19374,22009,22015,15,10,15,4,8,3,18,21,-3,16,14,20
19375,22009,22015,10,14,15,4,3,8,21,30,-9,11,19,15
19376,22009,22015,45,14,15,4,3,8,21,30,-9,11,19,15
19377,22009,22015,1,2,15,9,3,3,30,11,19,21,9,30
19378,21897,21903,1,7,2,1,0,1,4,1,3,2,2,3
19379,21897,21903,56,10,2,1,0,1,3,4,-1,2,2,3
19380,21897,21903,28,10,2,1,0,1,3,4,-1,2,2,3
19381,21897,21903,38,14,2,0,1,1,1,2,-1,1,3,1
19382,21897,21903,43,4,2,1,1,0,5,3,2,3,1,4
19383,21897,21903,24,5,2,1,1,0,3,2,1,3,1,4
19384,21897,21903,22,5,2,1,1,0,3,2,1,3,1,4
19385,21897,21903,57,9,2,1,0,1,2,2,0,2,2,3
19386,21897,21903,21,13,2,0,1,1,2,3,-1,1,3,1
19387,21897,21903,4,16,2,0,0,2,2,4,-2,0,4,0
19388,21897,21903,9,17,2,0,0,2,1,3,-2,0,4,0
19389,21897,21903,53,1,2,2,0,0,5,2,3,4,0,6
19390,16178,16205,40,7,17,9,2,6,28,17,11,20,14,29
19391,16178,16205,57,13,17,6,2,9,26,43,-17,14,20,20
19392,16241,16257,43,2,23,15,4,4,47,23,24,34,12,49
19393,16241,16257,22,3,23,13,6,4,35,23,12,32,14,45
19394,16241,16257,40,7,23,10,6,7,32,21,11,26,20,36
19395,16241,16257,35,14,23,5,5,13,21,29,-8,15,31,20
19396,16241,16257,17,10,23,8,5,10,39,41,-2,21,25,29
19397,16241,16257,42,16,23,5,3,15,28,40,-12,13,33,18
19398,16241,16257,25,8,23,10,3,10,24,34,-10,23,23,33
19399,16241,16257,12,9,23,8,8,7,26,26,0,24,22,32
19400,16241,16257,57,12,23,7,4,12,32,57,-25,18,28,25
19401,16241,16257,49,4,23,13,5,5,38,21,17,31,15,44
19402,16241,16257,37,11,23,7,5,11,31,38,-7,19,27,26
19403,16241,16257,46,18,23,5,2,16,20,43,-23,12,34,17
19404,16241,16257,1,1,23,19,3,1,61,15,46,41,5,60
19405,16241,16257,33,13,23,6,6,11,32,33,-1,18,28,24
19406,16241,16257,28,15,23,5,5,13,24,41,-17,15,31,20
19407,16241,16257,4,6,23,12,4,7,34,24,10,28,18,40
19408,16241,16257,9,17,23,4,6,13,21,44,-23,14,32,18
19409,16241,16257,27,5,23,12,6,5,30,22,8,30,16,42
19410,16290,16296,4,6,28,15,4,9,41,30,11,34,22,49
19411,16290,16296,9,18,28,5,7,16,27,53,-26,17,39,22
19412,16290,16296,33,13,28,8,6,14,36,38,-2,22,34,30
19413,16290,16296,28,15,28,7,6,15,29,44,-15,20,36,27
19414,16290,16296,25,7,28,11,4,13,28,43,-15,26,30,37
19415,16290,16296,12,10,28,8,11,9,27,30,-3,27,29,35
19416,16290,16296,1,1,28,21,5,2,69,19,50,47,9,68
19417,16290,16296,49,3,28,17,6,5,49,23,26,40,16,57
19418,16290,16296,37,12,28,8,7,13,38,45,-7,23,33,31
19419,16290,16296,46,16,28,7,2,19,24,52,-28,16,40,23
19420,16290,16296,27,5,28,15,7,6,37,29,8,37,19,52
19421,16290,16296,17,11,28,9,5,14,43,51,-8,23,33,32
19422,16290,16296,42,17,28,6,4,18,35,48,-13,16,40,22
19423,16290,16296,35,14,28,8,6,14,27,34,-7,22,34,30
19424,16290,16296,43,2,28,20,4,4,62,26,36,44,12,64
19425,16290,16296,22,4,28,16,6,6,44,32,12,38,18,54
19426,16290,16296,40,8,28,10,7,11,35,31,4,27,29,37
19427,16290,16296,57,9,28,10,5,13,40,63,-23,25,31,35
19428,16409,16415,17,12,1,0,0,1,1,3,-2,0,2,0
19429,16409,16415,43,1,1,1,0,0,6,0,6,2,0,3
19430,16409,16415,22,9,1,0,1,0,1,1,0,1,1,1
19431,16409,16415,51,11,1,0,0,1,0,1,-1,0,2,0
19432,16409,16415,57,14,1,0,0,1,0,2,-2,0,2,0
19433,16409,16415,40,18,1,0,0,1,0,6,-6,0,2,0
19434,16409,16415,25,4,1,1,0,0,2,0,2,2,0,3
19435,16409,16415,12,9,1,0,1,0,1,1,0,1,1,1
19436,16409,16415,35,14,1,0,0,1,0,2,-2,0,2,0
19437,16409,16415,45,2,1,1,0,0,3,1,2,2,0,3
19438,16409,16415,27,4,1,1,0,0,2,0,2,2,0,3
19439,16409,16415,1,4,1,1,0,0,2,0,2,2,0,3
19440,16409,16415,49,2,1,1,0,0,3,1,2,2,0,3
19441,16409,16415,46,4,1,1,0,0,2,0,2,2,0,3
19442,16409,16415,37,14,1,0,0,1,0,2,-2,0,2,0
19443,16409,16415,4,12,1,0,0,1,1,3,-2,0,2,0
19444,16409,16415,28,8,1,1,0,0,1,0,1,2,0,3
19445,16409,16415,33,14,1,0,0,1,0,2,-2,0,2,0
19446,16514,16520,28,14,14,4,1,9,14,20,-6,9,19,13
19447,16514,16520,33,15,14,4,1,9,13,25,-12,9,19,13
19448,16514,16520,1,4,14,7,4,3,22,15,7,18,10,25
19449,16514,16520,4,9,14,5,4,5,18,17,1,14,14,19
19450,16514,16520,45,3,14,8,2,4,27,22,5,18,10,26
19451,16514,16520,27,11,14,4,6,4,17,17,0,14,14,18
19452,16514,16520,49,1,14,10,1,3,25,15,10,21,7,31
19453,16514,16520,46,8,14,5,5,4,18,15,3,15,13,20
19454,16514,16520,37,13,14,5,1,8,18,21,-3,11,17,16
19455,16514,16520,43,2,14,8,5,1,35,14,21,21,7,29
19456,16514,16520,22,7,14,6,5,3,23,17,6,17,11,23
19457,16514,16520,51,10,14,5,3,6,26,21,5,13,15,18
19458,16514,16520,57,12,14,5,2,7,18,24,-6,12,16,17
19459,16514,16520,40,16,14,3,4,7,14,28,-14,10,18,13
19460,16514,16520,17,18,14,1,5,8,6,23,-17,7,21,8
19461,16514,16520,25,5,14,7,3,4,19,10,9,17,11,24
19462,16514,16520,12,6,14,7,3,4,21,19,2,17,11,24
19463,16514,16520,35,17,14,3,3,8,17,28,-11,9,19,12
19464,16605,16611,43,2,23,13,7,3,49,22,27,33,13,46
19465,16605,16611,22,5,23,10,7,6,37,29,8,27,19,37
19466,16605,16611,51,11,23,7,8,8,37,30,7,22,24,29
19467,16605,16611,57,13,23,7,4,12,29,43,-14,18,28,25
19468,16605,16611,40,17,23,4,9,10,21,40,-19,17,29,21
19469,9297,9303,27,14,26,7,5,14,32,44,-12,19,33,26
19470,9297,9303,53,9,26,9,10,7,35,35,0,28,24,37
19471,9297,9303,12,11,26,8,7,11,34,45,-11,23,29,31
19472,9297,9303,52,16,26,5,9,12,24,45,-21,19,33,24
19473,9325,9331,52,13,29,7,9,13,29,48,-19,23,35,30
19474,9325,9331,53,9,29,10,12,7,36,35,1,32,26,42
19475,9325,9331,12,11,29,9,7,13,40,54,-14,25,33,34
19476,9325,9331,21,10,29,8,12,9,28,37,-9,28,30,36
19477,9325,9331,27,12,29,8,6,15,34,48,-14,22,36,30
19478,9325,9331,49,5,29,12,10,7,43,28,15,34,24,46
19479,9325,9331,37,7,29,12,9,8,44,34,10,33,25,45
19480,9325,9331,19,17,29,5,9,15,20,51,-31,19,39,24
19481,9325,9331,17,18,29,4,10,15,27,54,-27,18,40,22
19482,9325,9331,1,2,29,18,7,4,62,27,35,43,15,61
19483,9325,9331,43,1,29,19,7,3,71,28,43,45,13,64
19484,9325,9331,57,8,29,11,9,9,50,40,10,31,27,42
19485,9325,9331,24,14,29,5,15,9,28,40,-12,25,33,30
19486,9325,9331,4,4,29,13,10,6,43,28,15,36,22,49
19487,9325,9331,41,3,29,14,7,8,42,32,10,35,23,49
19488,9325,9331,20,6,29,13,6,10,45,30,15,32,26,45
19489,9325,9331,56,15,29,7,6,16,32,46,-14,20,38,27
19490,9325,9331,13,16,29,5,11,13,19,33,-14,21,37,26
19491,9360,9492,41,6,34,15,9,10,43,35,8,39,29,54
19492,9360,9492,20,7,34,14,7,13,49,38,11,35,33,49
19493,9360,9492,56,15,34,8,9,17,40,52,-12,25,43,33
19494,9360,9492,13,16,34,6,13,15,23,39,-16,25,43,31
19495,9360,9492,4,4,34,15,11,8,51,38,13,41,27,56
19496,9360,9492,21,10,34,11,13,10,38,43,-5,35,33,46
19497,9360,9492,43,1,34,22,8,4,84,33,51,52,16,74
19498,9360,9492,57,9,34,12,10,12,55,47,8,34,34,46
19499,9360,9492,24,12,34,7,17,10,35,46,-11,31,37,38
19500,9360,9492,1,2,34,22,8,4,78,34,44,52,16,74
19501,9360,9492,19,17,34,6,10,18,23,56,-33,22,46,28
19502,9360,9492,17,18,34,5,11,18,34,67,-33,21,47,26
19503,9360,9492,49,3,34,15,12,7,57,29,28,42,26,57
19504,9360,9492,37,5,34,15,10,9,51,37,14,40,28,55
19505,9360,9492,27,11,34,11,6,17,41,63,-22,28,40,39
19506,9360,9492,53,8,34,12,13,9,43,44,-1,37,31,49
19507,9360,9492,12,14,34,9,8,17,45,68,-23,26,42,35
19508,9360,9492,52,13,34,9,9,16,36,57,-21,27,41,36
19509,9125,9128,52,15,4,0,3,1,2,4,-2,3,5,3
19510,9125,9128,53,3,4,2,2,0,5,1,4,6,2,8
19511,9125,9128,12,13,4,0,3,1,2,3,-1,3,5,3
19512,9125,9128,27,18,4,0,2,2,2,5,-3,2,6,2
19513,9125,9128,4,5,4,2,1,1,5,5,0,5,3,7
19514,9125,9128,21,7,4,1,3,0,6,4,2,5,3,6
19515,9125,9128,17,16,4,0,3,1,4,7,-3,3,5,3
19516,9125,9128,19,12,4,1,1,2,5,9,-4,3,5,4
19517,9125,9128,1,4,4,2,1,1,7,5,2,5,3,7
19518,9125,9128,37,2,4,3,0,1,8,6,2,6,2,9
19519,9125,9128,49,9,4,1,2,1,5,6,-1,4,4,5
19520,9125,9128,43,1,4,3,1,0,13,4,9,7,1,10
19521,9125,9128,57,10,4,1,1,2,7,8,-1,3,5,4
19522,9125,9128,24,14,4,0,3,1,1,2,-1,3,5,3
19523,9125,9128,13,6,4,2,1,1,4,4,0,5,3,7
19524,9125,9128,20,8,4,1,2,1,4,3,1,4,4,5
19525,9125,9128,41,10,4,1,1,2,7,8,-1,3,5,4
19526,9125,9128,56,17,4,0,2,2,6,9,-3,2,6,2
19527,10011,10031,20,4,21,12,3,6,39,25,14,27,15,39
19528,10011,10031,41,6,21,8,10,3,30,20,10,26,16,34
19529,10011,10031,56,15,21,5,5,11,24,42,-18,15,27,20
19530,10011,10031,24,1,21,15,2,4,35,18,17,32,10,47
19531,10011,10031,43,5,21,9,7,5,36,19,17,25,17,34
19532,10011,10031,57,8,21,8,4,9,30,29,1,20,22,28
19533,10011,10031,2,17,21,4,3,14,15,40,-25,11,31,15
19534,10011,10031,22,18,21,4,3,14,20,56,-36,11,31,15
19535,10011,10031,21,3,21,13,6,2,50,21,29,32,10,45
19536,10011,10031,4,14,21,7,2,12,20,35,-15,16,26,23
19537,10011,10031,1,2,21,14,3,4,49,25,24,31,11,45
19538,10011,10031,27,10,21,7,6,8,24,33,-9,20,22,27
19539,10011,10031,49,7,21,8,5,8,33,29,4,21,21,29
19540,10011,10031,37,16,21,4,7,10,24,25,-1,15,27,19
19541,10011,10031,28,11,21,7,5,9,17,25,-8,19,23,26
19542,10011,10031,52,12,21,6,7,8,23,27,-4,19,23,25
19543,10011,10031,53,9,21,8,4,9,28,27,1,20,22,28
19544,10011,10031,12,13,21,6,6,9,27,28,-1,18,24,24
19545,10249,10255,53,10,10,3,3,4,14,17,-3,9,11,12
19546,10249,10255,28,6,10,5,3,2,14,12,2,13,7,18
19547,10249,10255,52,15,10,2,2,6,5,14,-9,6,14,8
19548,6763,6765,40,17,22,4,6,12,30,51,-21,14,30,18
19549,6763,6765,12,6,22,9,8,5,28,22,6,26,18,35
19550,6763,6765,53,9,22,8,6,8,30,26,4,22,22,30
19551,6763,6765,27,10,22,8,4,10,23,29,-6,20,24,28
19552,6763,6765,52,5,22,10,6,6,31,23,8,26,18,36
19553,6763,6765,48,14,22,3,11,8,13,25,-12,17,27,20
19554,6763,6765,1,4,22,9,10,3,33,23,10,28,16,37
19555,6791,6800,1,6,27,11,10,6,40,38,2,32,22,43
19556,6791,6800,27,11,27,9,6,12,29,35,-6,24,30,33
19557,6791,6800,12,4,27,12,9,6,39,26,13,33,21,45
19558,6791,6800,53,10,27,9,7,11,35,38,-3,25,29,34
19559,6791,6800,43,2,27,18,2,7,61,27,34,38,16,56
19560,6791,6800,22,13,27,7,9,11,36,43,-7,23,31,30
19561,6791,6800,40,16,27,6,7,14,37,61,-24,19,35,25
19562,6791,6800,20,14,27,6,12,9,25,33,-8,24,30,30
19563,6791,6800,41,15,27,7,6,14,34,42,-8,20,34,27
19564,6791,6800,56,18,27,4,9,14,20,46,-26,17,37,21
19565,6791,6800,37,1,27,17,7,3,54,19,35,41,13,58
19566,6791,6800,49,5,27,12,9,6,37,26,11,33,21,45
19567,6791,6800,21,9,27,8,11,8,32,34,-2,27,27,35
19568,6791,6800,19,7,27,9,10,8,34,31,3,28,26,37
19569,6791,6800,17,8,27,10,6,11,33,35,-2,26,28,36
19570,6791,6800,8,12,27,7,10,10,26,31,-5,24,30,31
19571,6791,6800,52,3,27,13,6,8,41,32,9,32,22,45
19572,6791,6800,48,17,27,4,12,11,19,35,-16,20,34,24
19573,6994,7000,17,10,11,4,1,6,18,18,0,9,13,13
19574,6994,7000,19,17,11,1,4,6,11,21,-10,6,16,7
19575,6994,7000,8,18,11,1,2,8,10,18,-8,4,18,5
19576,6994,7000,21,13,11,2,4,5,10,13,-3,8,14,10
19577,6994,7000,49,5,11,6,3,2,34,14,20,15,7,21
19578,6994,7000,37,8,11,4,4,3,15,15,0,12,10,16
19579,6994,7000,57,3,11,7,2,2,24,13,11,16,6,23
19580,6994,7000,43,7,11,6,1,4,25,14,11,13,9,19
19581,6994,7000,22,11,11,3,3,5,10,27,-17,9,13,12
19582,6994,7000,20,9,11,3,6,2,13,12,1,12,10,15
19583,6994,7000,41,14,11,2,3,6,13,22,-9,7,15,9
19584,6994,7000,12,1,11,8,2,1,20,5,15,18,4,26
19585,6994,7000,53,6,11,5,5,1,13,12,1,15,7,20
19586,6994,7000,27,12,11,3,1,7,6,23,-17,7,15,10
19587,6994,7000,59,16,11,2,2,7,9,21,-12,6,16,8
19588,6994,7000,52,4,11,6,4,1,13,7,6,16,6,22
19589,6994,7000,48,15,11,1,6,4,13,20,-7,8,14,9
19590,6994,7000,1,2,11,8,1,2,25,7,18,17,5,25
19591,7106,7119,27,16,24,5,5,14,14,48,-34,15,33,20
19592,7106,7119,59,18,24,2,4,18,14,62,-48,8,40,10
19593,7106,7119,12,2,24,15,3,6,48,19,29,33,15,48
19594,7106,7119,53,10,24,7,9,8,29,31,-2,23,25,30
19595,7106,7119,43,5,24,14,3,7,50,23,27,31,17,45
19596,7106,7119,57,6,24,12,4,8,41,38,3,28,20,40
19597,7106,7119,22,14,24,6,9,9,22,47,-25,21,27,27
19598,7106,7119,41,9,24,9,5,10,34,33,1,23,25,32
19599,7106,7119,20,13,24,6,10,8,24,31,-7,22,26,28
19600,7106,7119,49,3,24,13,7,4,55,23,32,33,15,46
19601,7106,7119,52,4,24,13,7,4,39,22,17,33,15,46
19602,7106,7119,48,17,24,3,10,11,26,42,-16,16,32,19
19603,7106,7119,37,8,24,8,10,6,28,28,0,26,22,34
19604,7106,7119,21,12,24,7,7,10,30,30,0,21,27,28
19605,7106,7119,17,7,24,12,3,9,46,32,14,27,21,39
19606,7106,7119,19,11,24,7,8,9,28,33,-5,22,26,29
19607,7106,7119,8,15,24,5,6,13,22,38,-16,16,32,21
19608,7106,7119,1,1,24,15,4,5,50,20,30,34,14,49
19609,7148,7154,1,1,28,18,5,5,62,27,35,41,15,59
19610,7148,7154,21,14,28,8,7,13,34,38,-4,23,33,31
19611,7148,7154,49,2,28,16,7,5,63,26,37,39,17,55
19612,7148,7154,37,8,28,10,10,8,32,32,0,30,26,40
19613,7148,7154,52,3,28,15,8,5,43,25,18,38,18,53
19614,7148,7154,48,17,28,4,10,14,30,51,-21,18,38,22
19615,7148,7154,41,9,28,11,6,11,43,39,4,28,28,39
19616,7148,7154,20,12,28,8,11,9,29,35,-6,27,29,35
19617,7148,7154,43,4,28,16,4,8,58,27,31,36,20,52
19618,7148,7154,57,7,28,12,5,11,45,46,-1,29,27,41
19619,7148,7154,22,11,28,9,10,9,28,50,-22,28,28,37
19620,7148,7154,12,5,28,16,4,8,51,22,29,36,20,52
19621,7148,7154,53,13,28,8,9,11,32,38,-6,25,31,33
19622,7148,7154,17,6,28,14,4,10,53,35,18,32,24,46
19623,7148,7154,19,10,28,10,8,10,38,37,1,28,28,38
19624,7148,7154,8,15,28,7,7,14,29,44,-15,21,35,28
19625,7148,7154,27,16,28,6,5,17,17,58,-41,17,39,23
19626,9934,9940,27,14,14,3,5,6,16,24,-8,11,17,14
19627,9934,9940,21,2,14,8,6,0,29,11,18,22,6,30
19628,9934,9940,4,12,14,5,1,8,15,25,-10,11,17,16
19629,9934,9940,20,4,14,8,1,5,28,17,11,17,11,25
19630,9934,9940,41,5,14,6,6,2,21,14,7,18,10,24
19631,9934,9940,56,17,14,3,3,8,15,26,-11,9,19,12
19632,9934,9940,24,3,14,9,2,3,20,11,9,20,8,29
19633,9934,9940,43,6,14,6,5,3,24,10,14,17,11,23
19634,9934,9940,57,8,14,5,4,5,19,16,3,14,14,19
19635,9934,9940,2,15,14,4,1,9,11,23,-12,9,19,13
19636,9934,9940,22,16,14,4,0,10,16,36,-20,8,20,12
19637,9941,9947,24,2,15,10,2,3,21,11,10,22,8,32
19638,9941,9947,43,6,15,6,6,3,25,11,14,18,12,24
19639,9941,9947,57,9,15,5,4,6,21,21,0,14,16,19
19640,9941,9947,2,15,15,4,2,9,12,24,-12,10,20,14
19641,9941,9947,22,17,15,4,0,11,18,39,-21,8,22,12
19642,9941,9947,20,4,15,9,1,5,30,18,12,19,11,28
19643,9941,9947,41,5,15,7,6,2,25,14,11,20,10,27
19644,9941,9947,56,16,15,3,4,8,16,27,-11,10,20,13
19645,9941,9947,21,1,15,9,6,0,34,13,21,24,6,33
19646,9941,9947,4,13,15,5,1,9,15,26,-11,11,19,16
19647,9941,9947,28,7,15,6,5,4,15,16,-1,17,13,23
19648,9941,9947,52,14,15,4,4,7,15,23,-8,12,18,16
19649,9941,9947,53,8,15,6,2,7,20,21,-1,14,16,20
19650,9941,9947,12,11,15,5,4,6,17,20,-3,14,16,19
19651,9941,9947,27,12,15,4,5,6,19,26,-7,13,17,17
19652,9941,9947,49,10,15,5,4,6,22,24,-2,14,16,19
19653,9941,9947,37,18,15,2,5,8,16,21,-5,9,21,11
19654,9941,9947,1,3,15,9,3,3,32,18,14,21,9,30
19655,9969,10003,1,3,19,12,3,4,45,24,21,27,11,39
19656,9969,10003,49,8,19,7,4,8,28,28,0,18,20,25
19657,9969,10003,37,16,19,3,7,9,21,24,-3,13,25,16
19658,9969,10003,27,10,19,6,6,7,22,29,-7,18,20,24
19659,9969,10003,53,9,19,7,4,8,24,25,-1,18,20,25
19660,9969,10003,12,11,19,6,5,8,26,26,0,17,21,23
19661,9969,10003,28,12,19,6,5,8,16,24,-8,17,21,23
19662,9969,10003,52,13,19,5,7,7,18,24,-6,17,21,22
19663,9969,10003,41,6,19,7,9,3,29,20,9,23,15,30
19664,9969,10003,56,15,19,5,4,10,22,37,-15,14,24,19
19665,9969,10003,21,1,19,13,6,0,50,17,33,32,6,45
19666,9969,10003,4,14,19,6,2,11,19,30,-11,14,24,20
19667,9969,10003,20,4,19,11,2,6,38,25,13,24,14,35
19668,9969,10003,24,2,19,13,2,4,28,16,12,28,10,41
19669,9969,10003,43,5,19,9,6,4,35,17,18,24,14,33
19670,9969,10003,57,7,19,7,4,8,29,27,2,18,20,25
19671,9969,10003,2,17,19,4,2,13,15,39,-24,10,28,14
19672,9969,10003,22,18,19,4,2,13,19,52,-33,10,28,14
19673,10053,10059,41,4,25,10,12,3,40,22,18,32,18,42
19674,10053,10059,20,6,25,12,4,9,40,36,4,28,22,40
19675,10053,10059,56,16,25,6,6,13,28,51,-23,18,32,24
19676,10053,10059,24,1,25,18,3,4,40,19,21,39,11,57
19677,10053,10059,43,5,25,11,8,6,44,21,23,30,20,41
19678,10053,10059,57,8,25,9,6,10,38,36,2,24,26,33
19679,10053,10059,2,17,25,6,3,16,19,47,-28,15,35,21
19680,10053,10059,22,18,25,5,4,16,24,65,-41,14,36,19
19681,10053,10059,21,3,25,15,7,3,57,27,30,37,13,52
19682,10053,10059,4,12,25,8,4,13,26,41,-15,20,30,28
19683,10053,10059,1,2,25,17,3,5,59,28,31,37,13,54
19684,10053,10059,27,9,25,9,6,10,31,37,-6,24,26,33
19685,10053,10059,28,11,25,8,7,10,21,28,-7,23,27,31
19686,10053,10059,52,13,25,6,10,9,26,34,-8,22,28,28
19687,10053,10059,53,10,25,9,5,11,32,32,0,23,27,32
19688,10053,10059,12,15,25,6,7,12,29,35,-6,19,31,25
19689,10053,10059,49,7,25,9,7,9,37,34,3,25,25,34
19690,10053,10059,37,14,25,6,8,11,28,26,2,20,30,26
19691,10074,10080,27,10,27,9,7,11,32,39,-7,25,29,34
19692,10074,10080,53,11,27,9,5,13,32,37,-5,23,31,32
19693,10074,10080,12,15,27,7,7,13,30,36,-6,21,33,28
19694,10074,10080,28,8,27,9,8,10,22,28,-6,26,28,35
19695,10074,10080,52,12,27,7,10,10,29,38,-9,24,30,31
19696,10074,10080,1,1,27,18,4,5,62,30,32,40,14,58
19697,10074,10080,21,2,27,17,7,3,61,27,34,41,13,58
19698,10074,10080,4,14,27,8,4,15,29,47,-18,20,34,28
19699,10074,10080,41,5,27,11,13,3,41,22,19,35,19,46
19700,10074,10080,20,6,27,13,4,10,43,40,3,30,24,43
19701,10074,10080,56,13,27,8,6,13,35,51,-16,22,32,30
19702,10074,10080,24,3,27,18,3,6,41,22,19,39,15,57
19703,10074,10080,43,4,27,13,8,6,50,23,27,34,20,47
19704,21897,21903,27,3,2,2,0,0,2,0,2,4,0,6
19705,21897,21903,10,8,2,1,0,1,4,3,1,2,2,3
19706,21897,21903,15,15,2,0,1,1,1,5,-4,1,3,1
19707,21897,21903,45,18,2,0,0,2,2,5,-3,0,4,0
19708,21897,21903,49,2,2,2,0,0,3,1,2,4,0,6
19709,21897,21903,16,12,2,0,2,0,2,2,0,2,2,2
19710,22086,22092,53,7,27,12,3,12,49,52,-3,27,27,39
19711,22086,22092,21,2,27,14,6,7,44,33,11,34,20,48
19712,22086,22092,9,5,27,11,7,9,40,34,6,29,25,40
19713,22086,22092,4,12,27,10,6,11,40,33,7,26,28,36
19714,22086,22092,16,9,27,10,7,10,43,46,-3,27,27,37
19715,22086,22092,49,11,27,9,10,8,37,33,4,28,26,37
19716,22086,22092,28,14,27,8,7,12,34,40,-6,23,31,31
19717,22086,22092,38,17,27,6,8,13,24,42,-18,20,34,26
19718,22086,22092,27,6,27,11,7,9,39,34,5,29,25,40
19719,22086,22092,45,8,27,11,4,12,43,49,-6,26,28,37
19720,22086,22092,15,15,27,6,12,9,31,43,-12,24,30,30
19721,22086,22092,10,18,27,6,7,14,33,54,-21,19,35,25
19722,22086,22092,56,13,27,9,6,12,33,39,-6,24,30,33
19723,22086,22092,1,1,27,19,4,4,57,18,39,42,12,61
19724,22086,22092,22,3,27,12,7,8,51,38,13,31,23,43
19725,22086,22092,43,4,27,10,12,5,36,28,8,32,22,42
19726,22086,22092,24,10,27,10,7,10,39,44,-5,27,27,37
19727,22086,22092,57,16,27,8,2,17,31,44,-13,18,36,26
19728,22359,22365,24,4,15,8,2,5,27,25,2,18,12,26
19729,22359,22365,43,6,15,5,7,3,28,21,7,17,13,22
19730,22359,22365,22,8,15,6,3,6,28,25,3,15,15,21
19731,22359,22365,57,17,15,2,4,9,15,23,-8,8,22,10
19732,22359,22365,1,3,15,7,6,2,26,19,7,20,10,27
19733,22359,22365,56,11,15,5,6,4,18,17,1,16,14,21
19734,22359,22365,13,15,15,5,1,9,19,28,-9,11,19,16
19735,22359,22365,28,10,15,6,3,6,17,21,-4,15,15,21
19736,22359,22365,39,1,15,11,1,3,40,14,26,23,7,34
19737,22359,22365,27,5,15,7,5,3,27,19,8,19,11,26
19738,22359,22365,15,9,15,6,3,6,24,22,2,15,15,21
19739,22359,22365,45,16,15,3,5,7,23,35,-12,11,19,14
19740,22359,22365,49,12,15,5,5,5,17,23,-6,15,15,20
19741,22359,22365,16,14,15,3,8,4,19,25,-6,14,16,17
19742,22359,22365,21,2,15,8,3,4,26,18,8,19,11,27
19743,22359,22365,4,7,15,6,3,6,23,16,7,15,15,21
19744,22359,22365,9,13,15,5,2,8,19,32,-13,12,18,17
19745,22359,22365,53,18,15,2,3,10,15,28,-13,7,23,9
19746,22443,22449,53,18,27,4,4,19,27,56,-29,12,42,16
19747,22443,22449,21,2,27,16,5,6,47,28,19,37,17,53
19748,22443,22449,4,5,27,12,7,8,39,27,12,31,23,43
19749,22443,22449,9,14,27,8,4,15,27,52,-25,20,34,28
19750,22443,22449,16,9,27,10,9,8,44,42,2,29,25,39
19751,22443,22449,49,13,27,8,8,11,30,42,-12,24,30,32
19752,22443,22449,39,1,27,19,3,5,59,22,37,41,13,60
19753,22443,22449,27,6,27,12,7,8,42,35,7,31,23,43
19754,22443,22449,15,15,27,7,6,14,32,46,-14,20,34,27
19755,22443,22449,45,16,27,6,8,13,37,56,-19,20,34,26
19756,22443,22449,28,11,27,10,4,13,30,37,-7,24,30,34
19757,22443,22449,56,12,27,8,10,9,32,34,-2,26,28,34
19758,22443,22449,13,17,27,7,2,18,26,53,-27,16,38,23
19759,22443,22449,1,3,27,14,9,4,49,32,17,37,17,51
19760,22443,22449,43,4,27,13,9,5,58,32,26,35,19,48
19761,22443,22449,24,7,27,13,3,11,46,50,-4,29,25,42
19762,22443,22449,22,8,27,12,5,10,54,39,15,29,25,41
19763,22443,22449,57,10,27,10,5,12,38,34,4,25,29,35
19764,22261,22267,22,5,4,2,1,1,10,6,4,5,3,7
19765,22261,22267,43,6,4,2,1,1,7,5,2,5,3,7
19766,22261,22267,57,10,4,1,2,1,4,4,0,4,4,5
19767,22261,22267,24,15,4,1,0,3,4,8,-4,2,6,3
19768,22261,22267,1,3,4,2,2,0,8,3,5,6,2,8
19769,22261,22267,56,8,4,2,0,2,4,4,0,4,4,6
19770,22261,22267,13,16,4,1,0,3,3,8,-5,2,6,3
19771,22261,22267,39,1,4,3,0,1,8,2,6,6,2,9
19772,22261,22267,15,4,4,2,2,0,8,5,3,6,2,8
19773,22261,22267,27,9,4,1,3,0,5,2,3,5,3,6
19774,22261,22267,45,14,4,1,1,2,5,8,-3,3,5,4
19775,22261,22267,49,7,4,2,1,1,6,7,-1,5,3,7
19776,22261,22267,16,17,4,0,3,1,3,7,-4,3,5,3
19777,22261,22267,9,2,4,3,0,1,8,8,0,6,2,9
19778,22261,22267,21,11,4,1,1,2,8,7,1,3,5,4
19779,22261,22267,4,12,4,1,1,2,5,5,0,3,5,4
19780,22261,22267,53,18,4,0,1,3,2,7,-5,1,7,1
19781,22261,22267,28,13,4,1,1,2,4,6,-2,3,5,4
19782,22716,22757,25,7,17,8,2,7,34,30,4,18,16,26
19783,22716,22757,49,6,17,9,1,7,29,22,7,19,15,28
19784,7484,7490,53,17,23,5,4,14,20,34,-14,14,32,19
19785,7484,7490,20,11,23,8,6,9,30,31,-1,22,24,30
19786,7484,7490,56,12,23,7,5,11,25,35,-10,19,27,26
19787,7484,7490,41,13,23,7,4,12,32,33,-1,18,28,25
19788,7484,7490,1,5,23,11,3,9,51,34,17,25,21,36
19789,7337,7343,1,11,7,3,1,3,12,13,-1,7,7,10
19790,7337,7343,56,10,7,3,1,3,10,10,0,7,7,10
19791,7337,7343,20,13,7,3,0,4,10,10,0,6,8,9
19792,7337,7343,41,18,7,0,1,6,6,16,-10,1,13,1
19793,7337,7343,43,1,7,5,1,1,20,9,11,11,3,16
19794,7337,7343,22,6,7,4,0,3,13,11,2,8,6,12
19795,7337,7343,57,12,7,3,1,3,15,18,-3,7,7,10
19796,7337,7343,37,2,7,5,0,2,12,7,5,10,4,15
19797,7337,7343,49,3,7,4,2,1,18,10,8,10,4,14
19798,7337,7343,21,14,7,2,2,3,6,14,-8,6,8,8
19799,7337,7343,4,15,7,1,2,4,3,9,-6,4,10,5
19800,7337,7343,17,7,7,3,2,2,14,9,5,8,6,11
19801,7337,7343,19,9,7,3,1,3,14,13,1,7,7,10
19802,7337,7343,8,16,7,1,2,4,9,16,-7,4,10,5
19803,7337,7343,52,4,7,4,2,1,9,5,4,10,4,14
19804,7337,7343,48,8,7,3,2,2,10,12,-2,8,6,11
19805,7337,7343,12,5,7,4,1,2,11,5,6,9,5,13
19806,7337,7343,53,17,7,1,1,5,9,14,-5,3,11,4
19807,7757,7763,12,7,15,7,3,5,19,15,4,17,13,24
19808,7757,7763,4,3,15,8,5,2,23,12,11,21,9,29
19809,7757,7763,21,4,15,8,4,3,24,11,13,20,10,28
19810,7757,7763,49,6,15,7,5,3,22,14,8,19,11,26
19811,7757,7763,37,8,15,6,6,3,17,11,6,18,12,24
19812,7757,7763,1,17,15,3,3,9,19,27,-8,9,21,12
19813,7757,7763,17,5,15,8,4,3,22,17,5,20,10,28
19814,7757,7763,8,13,15,4,4,7,13,21,-8,12,18,16
19815,7757,7763,19,16,15,3,5,7,16,28,-12,11,19,14
19816,7757,7763,52,9,15,6,1,8,20,24,-4,13,17,19
19817,7757,7763,3,12,15,4,4,7,18,24,-6,12,18,16
19818,7757,7763,43,1,15,9,3,3,28,17,11,21,9,30
19819,7757,7763,22,14,15,4,4,7,10,22,-12,12,18,16
19820,7757,7763,57,15,15,4,3,8,21,28,-7,11,19,15
19821,7757,7763,24,18,15,1,4,10,13,24,-11,6,24,7
19822,7757,7763,56,2,15,9,2,4,23,17,6,20,10,29
19823,7757,7763,41,10,15,5,4,6,19,17,2,14,16,19
19824,7757,7763,20,11,15,5,4,6,15,13,2,14,16,19
19825,7666,7672,41,11,2,1,0,1,4,5,-1,2,2,3
19826,7666,7672,20,14,2,0,2,0,1,1,0,2,2,2
19827,7666,7672,56,17,2,0,1,1,0,2,-2,1,3,1
19828,7666,7672,43,3,2,1,1,0,3,2,1,3,1,4
19829,7666,7672,22,8,2,1,0,1,4,4,0,2,2,3
19830,7666,7672,57,15,2,0,1,1,3,4,-1,1,3,1
19831,7666,7672,24,18,2,0,0,2,2,4,-2,0,4,0
19832,7666,7672,52,9,2,1,0,1,3,3,0,2,2,3
19833,7666,7672,3,10,2,1,0,1,2,2,0,2,2,3
19834,7666,7672,37,2,2,1,1,0,2,0,2,3,1,4
19835,7666,7672,49,13,2,0,2,0,3,3,0,2,2,2
19836,7666,7672,1,6,2,1,0,1,5,3,2,2,2,3
19837,7666,7672,21,5,2,1,1,0,2,1,1,3,1,4
19838,7666,7672,4,7,2,1,0,1,4,3,1,2,2,3
19839,7666,7672,12,3,2,1,1,0,3,2,1,3,1,4
19840,7666,7672,17,1,2,1,1,0,3,1,2,3,1,4
19841,7666,7672,8,12,2,1,0,1,2,4,-2,2,2,3
19842,7666,7672,19,16,2,0,1,1,2,4,-2,1,3,1
19843,7862,7868,12,4,26,12,8,6,44,27,17,32,20,44
19844,7862,7868,21,3,26,13,6,7,33,18,15,32,20,45
19845,7862,7868,4,5,26,11,11,4,30,16,14,33,19,44
19846,7862,7868,49,2,26,13,10,3,40,21,19,36,16,49
19847,7862,7868,37,8,26,10,9,7,31,22,9,29,23,39
19848,7862,7868,17,6,26,12,5,9,36,39,-3,29,23,41
19849,7862,7868,19,11,26,9,7,10,35,42,-7,25,27,34
19850,7862,7868,8,16,26,6,7,13,24,39,-15,19,33,25
19851,7862,7868,52,10,26,10,4,12,34,32,2,24,28,34
19852,7862,7868,3,14,26,7,7,12,28,47,-19,21,31,28
19853,7862,7868,56,7,26,11,7,8,30,28,2,29,23,40
19854,7862,7868,20,9,26,9,8,9,26,23,3,26,26,35
19855,7862,7868,41,13,26,8,6,12,30,36,-6,22,30,30
19856,7862,7868,43,1,26,15,7,4,45,25,20,37,15,52
19857,7862,7868,22,12,26,8,7,11,19,30,-11,23,29,31
19858,7862,7868,57,15,26,6,8,12,38,47,-9,20,32,26
19859,7862,7868,24,18,26,5,4,17,23,43,-20,14,38,19
19860,7862,7868,1,17,26,5,7,14,33,44,-11,17,35,22
19861,8019,8022,1,11,1,0,0,1,1,2,-1,0,2,0
19862,8019,8022,43,1,1,1,0,0,4,2,2,2,0,3
19863,8019,8022,22,13,1,0,0,1,0,1,-1,0,2,0
19864,8019,8022,57,15,1,0,0,1,2,4,-2,0,2,0
19865,16605,16611,49,1,23,14,4,5,41,21,20,32,14,46
19866,16605,16611,46,8,23,8,8,7,25,24,1,24,22,32
19867,16605,16611,37,16,23,6,3,14,25,37,-12,15,31,21
19868,16605,16611,35,12,23,8,4,11,31,37,-6,20,26,28
19869,16605,16611,4,7,23,10,5,8,30,27,3,25,21,35
19870,16605,16611,25,6,23,10,5,8,31,27,4,25,21,35
19871,16605,16611,12,9,23,8,8,7,32,33,-1,24,22,32
19872,16605,16611,33,14,23,7,3,13,31,35,-4,17,29,24
19873,16605,16611,28,15,23,5,7,11,24,34,-10,17,29,22
19874,16605,16611,45,4,23,12,4,7,42,34,8,28,18,40
19875,16605,16611,27,10,23,8,6,9,22,28,-6,22,24,30
19876,16605,16611,1,3,23,13,7,3,38,21,17,33,13,46
19877,16605,16611,17,18,23,4,7,12,14,37,-23,15,31,19
19878,16612,16618,17,16,24,5,7,12,16,38,-22,17,31,22
19879,16612,16618,1,3,24,13,8,3,39,22,17,34,14,47
19880,16612,16618,45,4,24,13,4,7,43,34,9,30,18,43
19881,16612,16618,27,10,24,8,7,9,23,29,-6,23,25,31
19882,16612,16618,33,14,24,7,3,14,31,36,-5,17,31,24
19883,16612,16618,28,15,24,5,8,11,25,35,-10,18,30,23
19884,16612,16618,25,7,24,10,5,9,32,29,3,25,23,35
19885,16612,16618,12,8,24,9,8,7,35,34,1,26,22,35
19886,16612,16618,4,6,24,11,5,8,31,27,4,27,21,38
19887,16612,16618,35,11,24,8,5,11,31,37,-6,21,27,29
19888,16612,16618,49,2,24,14,5,5,42,22,20,33,15,47
19889,16612,16618,46,9,24,8,8,8,25,25,0,24,24,32
19890,16612,16618,37,17,24,6,3,15,26,40,-14,15,33,21
19891,16612,16618,43,1,24,14,7,3,51,22,29,35,13,49
19892,16612,16618,22,5,24,11,7,6,38,29,9,29,19,40
19893,16612,16618,51,12,24,7,8,9,37,32,5,22,26,29
19894,16612,16618,57,13,24,7,5,12,29,43,-14,19,29,26
19895,16612,16618,40,18,24,4,9,11,21,41,-20,17,31,21
19896,17018,17024,43,1,28,18,8,2,53,26,27,44,12,62
19897,17018,17024,22,2,28,18,6,4,62,29,33,42,14,60
19898,17018,17024,51,9,28,9,8,11,42,48,-6,26,30,35
19899,17018,17024,57,11,28,9,7,12,24,28,-4,25,31,34
19900,17018,17024,35,8,28,10,8,10,40,40,0,28,28,38
19901,17018,17024,25,7,28,11,7,10,32,32,0,29,27,40
19902,17018,17024,12,16,28,5,12,11,26,37,-11,22,34,27
19903,17018,17024,42,10,28,9,7,12,30,34,-4,25,31,34
19904,17018,17024,17,18,28,4,5,19,22,55,-33,13,43,17
19905,17018,17024,49,3,28,16,5,7,54,33,21,37,19,53
19906,17018,17024,46,15,28,5,13,10,28,40,-12,23,33,28
19907,17018,17024,37,17,28,5,8,15,25,47,-22,18,38,23
19908,17018,17024,27,5,28,13,8,7,40,33,7,34,22,47
19909,17018,17024,45,12,28,8,9,11,34,41,-7,25,31,33
19910,17018,17024,4,4,28,15,5,8,47,34,13,35,21,50
19911,17018,17024,1,6,28,13,7,8,49,32,17,33,23,46
19912,17018,17024,33,13,28,7,10,11,38,47,-9,24,32,31
19913,17018,17024,28,14,28,7,7,14,33,43,-10,21,35,28
19914,17214,17220,33,6,10,5,2,3,17,12,5,12,8,17
19915,17214,17220,28,17,10,1,1,8,8,21,-13,3,17,4
19916,17214,17220,12,7,10,5,2,3,9,7,2,12,8,17
19917,17214,17220,25,11,10,3,3,4,11,8,3,9,11,12
19918,17214,17220,49,1,10,7,3,0,25,8,17,17,3,24
19919,17214,17220,46,15,10,2,1,7,6,18,-12,5,15,7
19920,17214,17220,1,2,10,6,3,1,16,9,7,15,5,21
19921,17214,17220,4,10,10,3,5,2,19,13,6,11,9,14
19922,17214,17220,27,8,10,4,2,4,11,10,1,10,10,14
19923,17214,17220,45,9,10,4,2,4,14,16,-2,10,10,14
19924,17214,17220,23,16,10,1,3,6,7,18,-11,5,15,6
19925,17214,17220,35,12,10,3,3,4,12,12,0,9,11,12
19926,17214,17220,42,14,10,2,3,5,12,15,-3,7,13,9
19927,17214,17220,24,18,10,0,4,6,8,19,-11,4,16,4
19928,17214,17220,57,3,10,6,2,2,24,11,13,14,6,20
19929,17214,17220,43,4,10,5,4,1,16,10,6,14,6,19
19930,17214,17220,22,5,10,5,4,1,13,12,1,14,6,19
19931,17214,17220,51,13,10,2,5,3,10,19,-9,9,11,11
19932,17312,17318,25,8,19,6,7,6,28,19,9,19,19,25
19933,17312,17318,12,11,19,5,9,5,17,18,-1,19,19,24
19934,17312,17318,49,2,19,12,7,0,40,13,27,31,7,43
19935,17312,17318,23,14,19,5,4,10,18,31,-13,14,24,19
19936,17312,17318,35,4,19,11,3,5,29,17,12,25,13,36
19937,17312,17318,4,5,19,8,7,4,39,26,13,23,15,31
19938,17312,17318,1,1,19,13,5,1,28,12,16,31,7,44
19939,17312,17318,33,12,19,6,5,8,23,26,-3,17,21,23
19940,17312,17318,28,16,19,3,4,12,15,34,-19,10,28,13
19941,17312,17318,57,3,19,12,4,3,46,17,29,28,10,40
19942,17312,17318,43,6,19,8,7,4,26,20,6,23,15,31
19943,17515,17521,33,4,1,1,0,0,2,1,1,2,0,3
19944,17613,17619,4,9,13,5,4,4,26,18,8,14,12,19
19945,17613,17619,27,10,13,5,3,5,17,19,-2,13,13,18
19946,17613,17619,45,12,13,4,2,7,15,17,-2,10,16,14
19947,17613,17619,42,14,13,2,5,6,10,16,-6,9,17,11
19948,17613,17619,25,5,13,7,3,3,19,16,3,17,9,24
19949,17613,17619,12,6,13,5,7,1,17,9,8,17,9,22
19950,17613,17619,43,3,13,8,2,3,31,16,15,18,8,26
19951,17613,17619,22,4,13,7,3,3,21,15,6,17,9,24
19952,17613,17619,57,8,13,6,1,6,18,20,-2,13,13,19
19953,17613,17619,32,15,13,3,1,9,14,25,-11,7,19,10
19954,17613,17619,24,16,13,2,4,7,13,24,-11,8,18,10
19955,17613,17619,51,18,13,1,4,8,9,22,-13,6,20,7
19956,17613,17619,49,2,13,8,3,2,23,13,10,19,7,27
19957,17613,17619,23,13,13,3,5,5,18,23,-5,11,15,14
19958,17613,17619,56,11,13,4,4,5,11,19,-8,12,14,16
19959,17613,17619,35,17,13,1,6,6,12,18,-6,8,18,9
19960,17613,17619,33,7,13,6,3,4,20,16,4,15,11,21
19961,17613,17619,1,1,13,8,4,1,24,12,12,20,6,28
19962,17711,17717,42,18,24,3,8,13,26,39,-13,14,34,17
19963,17711,17717,1,3,24,13,5,6,41,31,10,31,17,44
19964,17711,17717,33,11,24,8,8,8,33,31,2,24,24,32
19965,17711,17717,49,2,24,16,4,4,49,23,26,36,12,52
19966,17711,17717,23,15,24,5,6,13,30,42,-12,16,32,21
19967,17711,17717,35,10,24,8,8,8,34,29,5,24,24,32
19968,17711,17717,56,13,24,7,9,8,24,35,-11,23,25,30
19969,17711,17717,43,1,24,17,3,4,58,26,32,37,11,54
19970,17711,17717,22,4,24,12,4,8,36,32,4,28,20,40
19971,17711,17717,57,8,24,10,5,9,35,38,-3,25,23,35
19972,17711,17717,24,12,24,7,9,8,34,40,-6,23,25,30
19973,17711,17717,32,16,24,5,3,16,25,60,-35,13,35,18
19974,17711,17717,51,17,24,4,5,15,24,47,-23,13,35,17
19975,17711,17717,25,6,24,10,7,7,28,26,2,27,21,37
19976,17711,17717,12,9,24,8,10,6,28,22,6,26,22,34
19977,17711,17717,45,5,24,11,5,8,40,29,11,27,21,38
19978,17711,17717,27,14,24,7,5,12,32,40,-8,19,29,26
19979,17711,17717,4,7,24,10,6,8,48,35,13,26,22,36
19980,17543,17549,4,5,4,2,1,1,11,6,5,5,3,7
19981,17543,17549,45,11,4,1,1,2,3,5,-2,3,5,4
19982,17543,17549,27,8,4,2,0,2,4,5,-1,4,4,6
19983,17543,17549,42,14,4,1,0,3,5,10,-5,2,6,3
19984,17543,17549,25,7,4,2,1,1,3,4,-1,5,3,7
19985,17543,17549,12,9,4,1,2,1,5,3,2,4,4,5
19986,17543,17549,43,2,4,3,1,0,11,3,8,7,1,10
19987,17543,17549,22,6,4,2,1,1,6,5,1,5,3,7
19988,17543,17549,57,13,4,1,0,3,5,9,-4,2,6,3
19989,17543,17549,51,16,4,0,2,2,3,7,-4,2,6,2
19990,17543,17549,24,17,4,0,2,2,2,6,-4,2,6,2
19991,17543,17549,32,18,4,0,1,3,3,10,-7,1,7,1
19992,17543,17549,35,9,4,1,2,1,5,3,2,4,4,5
19993,17543,17549,56,12,4,1,1,2,4,9,-5,3,5,4
19994,17543,17549,23,15,4,0,2,2,4,7,-3,2,6,2
19995,17543,17549,33,1,4,4,0,0,11,5,6,8,0,12
19996,17543,17549,49,3,4,3,1,0,9,2,7,7,1,10
19997,17543,17549,1,4,4,2,2,0,8,3,5,6,2,8
19998,17949,17955,45,7,11,4,4,3,18,16,2,12,10,16
19999,17949,17955,27,12,12,3,4,5,14,21,-7,10,14,13
20000,17949,17955,49,4,12,5,6,1,21,11,10,16,8,21
20001,17949,17955,35,8,11,4,3,4,12,15,-3,11,11,15
20002,17949,17955,56,11,11,3,4,4,12,13,-1,10,12,13
20003,17949,17955,43,2,11,7,2,2,20,10,10,16,6,23
20004,17949,17955,24,3,12,7,0,5,19,17,2,14,10,21
20005,17949,17955,22,9,11,3,5,3,15,13,2,11,11,14
20006,17949,17955,57,13,11,2,4,5,18,19,-1,8,14,10
20007,17949,17955,51,15,11,1,2,8,14,29,-15,4,18,5
20008,17949,17955,25,10,11,3,2,6,12,20,-8,8,14,11
20009,17949,17955,12,14,11,2,2,7,12,21,-9,6,16,8
20010,17949,17955,4,5,11,5,2,4,20,14,6,12,10,17
20011,17949,17955,28,6,11,5,2,4,15,15,0,12,10,17
20012,17949,17955,1,1,11,8,2,1,26,14,12,18,4,26
20013,18047,18053,28,7,23,9,5,9,28,30,-2,23,23,32
20014,18047,18053,4,3,23,12,5,6,43,26,17,29,17,41
20015,18047,18053,43,1,22,17,3,2,49,17,32,37,7,54
20016,18047,18053,24,6,23,10,2,11,30,39,-9,22,24,32
20017,18047,18053,22,10,22,6,9,7,27,24,3,21,23,27
20018,18047,18053,57,12,22,7,5,10,33,34,-1,19,25,26
20019,18047,18053,51,14,22,4,4,14,27,50,-23,12,32,16
20020,18047,18053,45,4,22,10,6,6,34,26,8,26,18,36
20021,18047,18053,27,13,23,5,7,11,26,35,-9,17,29,22
20022,18047,18053,49,5,23,9,8,6,35,28,7,26,20,35
20023,10074,10080,57,7,27,10,6,11,42,39,3,26,28,36
20024,10074,10080,22,17,27,7,4,16,27,66,-39,18,36,25
20025,10074,10080,2,18,27,6,4,17,19,50,-31,16,38,22
20026,10074,10080,49,9,27,9,7,11,40,39,1,25,29,34
20027,10074,10080,37,16,27,6,9,12,29,30,-1,21,33,27
20028,10088,10094,49,8,29,10,7,12,42,41,1,27,31,37
20029,10088,10094,37,14,29,7,9,13,30,31,-1,23,35,30
20030,10088,10094,24,2,29,20,3,6,45,22,23,43,15,63
20031,10088,10094,43,4,29,14,9,6,53,24,29,37,21,51
20032,10088,10094,57,7,29,11,6,12,43,41,2,28,30,39
20033,10088,10094,2,17,29,7,5,17,20,50,-30,19,39,26
20034,10088,10094,22,18,29,7,5,17,27,71,-44,19,39,26
20035,10088,10094,41,5,29,12,14,3,45,23,22,38,20,50
20036,10088,10094,20,6,29,13,5,11,44,42,2,31,27,44
20037,10088,10094,56,11,29,9,7,13,37,52,-15,25,33,34
20038,10088,10094,21,3,29,18,8,3,67,28,39,44,14,62
20039,10088,10094,4,15,29,8,5,16,31,50,-19,21,37,29
20040,10088,10094,1,1,29,20,4,5,65,31,34,44,14,64
20041,10088,10094,28,10,29,9,9,11,24,31,-7,27,31,36
20042,10088,10094,52,13,29,7,11,11,29,41,-12,25,33,32
20043,10088,10094,27,9,29,9,9,11,33,40,-7,27,31,36
20044,10088,10094,53,12,29,9,5,15,32,39,-7,23,35,32
20045,10088,10094,12,16,29,7,7,15,30,40,-10,21,37,28
20046,9892,9898,1,2,9,6,2,1,19,10,9,14,4,20
20047,9892,9898,27,16,9,1,4,4,9,12,-3,6,12,7
20048,9892,9898,28,7,9,4,3,2,9,9,0,11,7,15
20049,9892,9898,52,11,9,3,3,3,10,14,-4,9,9,12
20050,9892,9898,49,8,9,4,2,3,17,14,3,10,8,14
20051,9892,9898,37,14,9,2,1,6,10,13,-3,5,13,7
20052,9892,9898,53,9,9,4,1,4,12,13,-1,9,9,13
20053,9892,9898,12,10,9,3,4,2,11,10,1,10,8,13
20054,9892,9898,4,17,9,1,0,8,9,23,-14,2,16,3
20055,9892,9898,56,18,9,0,3,6,7,19,-12,3,15,3
20056,9892,9898,20,5,9,5,1,3,19,12,7,11,7,16
20057,9892,9898,41,6,9,4,4,1,15,9,6,12,6,16
20058,9892,9898,21,4,9,5,4,0,20,9,11,14,4,19
20059,9892,9898,43,1,9,6,3,0,21,3,18,15,3,21
20060,9892,9898,24,3,9,6,1,2,13,8,5,13,5,19
20061,9892,9898,22,12,9,3,0,6,9,22,-13,6,12,9
20062,9892,9898,57,13,9,2,3,4,11,13,-2,7,11,9
20063,9892,9898,2,15,9,2,1,6,9,17,-8,5,13,7
20064,10214,10220,24,4,3,2,1,0,7,1,6,5,1,7
20065,10214,10220,57,12,3,0,1,2,3,8,-5,1,5,1
20066,10214,10220,22,15,3,0,1,2,1,8,-7,1,5,1
20067,10214,10220,49,8,3,2,0,1,3,2,1,4,2,6
20068,10214,10220,37,11,3,0,1,2,3,5,-2,1,5,1
20069,10214,10220,54,17,3,0,0,3,4,11,-7,0,6,0
20070,10214,10220,21,6,3,2,1,0,8,3,5,5,1,7
20071,10214,10220,17,13,3,0,1,2,2,7,-5,1,5,1
20072,10214,10220,41,4,3,2,1,0,7,1,6,5,1,7
20073,10214,10220,20,7,3,2,1,0,6,3,3,5,1,7
20074,10214,10220,56,10,3,0,3,0,1,1,0,3,3,3
20075,10214,10220,43,1,3,3,0,0,11,3,8,6,0,9
20076,10214,10220,12,9,3,1,2,0,4,0,4,4,2,5
20077,10214,10220,53,14,3,0,1,2,1,6,-5,1,5,1
20078,10214,10220,28,2,3,3,0,0,8,2,6,6,0,9
20079,10214,10220,52,18,3,0,0,3,0,7,-7,0,6,0
20080,10214,10220,1,3,3,2,1,0,8,1,7,5,1,7
20081,10214,10220,27,16,3,0,1,2,1,9,-8,1,5,1
20082,10445,10451,27,14,30,6,14,10,26,42,-16,26,34,32
20083,10445,10451,1,5,30,14,9,7,56,36,20,37,23,51
20084,10445,10451,28,7,30,11,10,9,37,41,-4,32,28,43
20085,10445,10451,52,15,30,9,4,17,30,52,-22,22,38,31
20086,10445,10451,54,17,30,8,6,16,30,51,-21,22,38,30
20087,10445,10451,37,10,30,9,8,13,34,42,-8,26,34,35
20088,10445,10451,41,3,30,15,10,5,55,19,36,40,20,55
20089,10445,10451,56,8,30,9,14,7,49,39,10,32,28,41
20090,10445,10451,20,9,30,11,6,13,47,47,0,28,32,39
20091,10445,10451,49,6,30,13,8,9,42,35,7,34,26,47
20092,10445,10451,21,4,30,14,10,6,55,34,21,38,22,52
20093,10445,10451,17,16,30,8,7,15,23,44,-21,23,37,31
20094,10445,10451,24,1,30,22,6,2,56,16,40,50,10,72
20095,10445,10451,43,2,30,18,9,3,72,32,40,45,15,63
20096,10445,10451,57,11,30,9,6,15,33,43,-10,24,36,33
20097,10445,10451,22,18,30,2,9,19,20,65,-45,13,47,15
20098,10445,10451,12,12,30,8,8,14,38,51,-13,24,36,32
20099,10445,10451,53,13,30,8,8,14,37,51,-14,24,36,32
20100,10473,10479,24,1,33,24,7,2,62,19,43,55,11,79
20101,10473,10479,43,2,33,21,9,3,79,34,45,51,15,72
20102,10473,10479,57,12,33,10,7,16,39,50,-11,27,39,37
20103,15128,15134,40,15,21,4,7,10,24,42,-18,15,27,19
20104,15128,15134,34,17,21,4,3,14,18,49,-31,11,31,15
20105,15128,15134,27,11,21,7,3,11,19,40,-21,17,25,24
20106,15128,15134,17,14,21,5,6,10,33,36,-3,16,26,21
20107,15317,15323,17,10,0,0,0,0,0,0,0,0,0,0
20108,15317,15323,42,16,1,0,0,1,0,3,-3,0,2,0
20109,15317,15323,35,4,1,1,0,0,3,2,1,2,0,3
20110,15317,15323,43,3,1,1,0,0,2,0,2,2,0,3
20111,15317,15323,24,7,1,1,0,0,1,0,1,2,0,3
20112,15317,15323,22,11,1,0,0,1,2,3,-1,0,2,0
20113,15317,15323,40,13,1,0,0,1,1,2,-1,0,2,0
20114,15317,15323,33,1,1,1,0,0,3,0,3,2,0,3
20115,15317,15323,28,11,1,0,0,1,2,3,-1,0,2,0
20116,15317,15323,1,6,1,1,0,0,2,1,1,2,0,3
20117,15317,15323,12,4,1,1,0,0,3,2,1,2,0,3
20118,15317,15323,25,15,1,0,0,1,0,2,-2,0,2,0
20119,15317,15323,21,8,1,0,1,0,0,0,0,1,1,1
20120,15317,15323,4,8,1,0,1,0,0,0,0,1,1,1
20121,15317,15323,27,14,1,0,0,1,0,1,-1,0,2,0
20122,15317,15323,37,1,1,1,0,0,3,0,3,2,0,3
20123,15317,15323,49,16,1,0,0,1,0,3,-3,0,2,0
20124,15324,15330,37,6,2,1,0,1,3,3,0,2,2,3
20125,15324,15330,49,15,2,0,1,1,3,6,-3,1,3,1
20126,15324,15330,27,11,2,0,1,1,3,4,-1,1,3,1
20127,15324,15330,4,13,2,0,1,1,1,2,-1,1,3,1
20128,15324,15330,21,14,2,0,1,1,2,4,-2,1,3,1
20129,15324,15330,12,4,2,2,0,0,6,3,3,4,0,6
20130,15324,15330,25,17,2,0,0,2,1,4,-3,0,4,0
20131,15324,15330,1,2,2,2,0,0,5,1,4,4,0,6
20132,15324,15330,33,2,2,2,0,0,5,1,4,4,0,6
20133,15324,15330,28,16,1,0,0,1,2,3,-1,0,2,0
20134,15324,15330,43,1,2,2,0,0,6,1,5,4,0,6
20135,15324,15330,22,5,2,1,0,1,6,5,1,2,2,3
20136,15324,15330,24,8,2,1,0,1,2,4,-2,2,2,3
20137,15324,15330,40,12,2,0,1,1,2,3,-1,1,3,1
20138,15324,15330,35,7,2,1,0,1,4,5,-1,2,2,3
20139,15324,15330,42,8,2,1,0,1,2,4,-2,2,2,3
20140,15324,15330,17,10,1,0,1,0,1,1,0,1,1,1
20141,15583,15589,27,16,29,6,6,17,36,63,-27,18,40,24
20142,15583,15589,49,8,29,13,8,8,47,35,12,34,24,47
20143,15583,15589,37,12,29,10,1,18,44,69,-25,21,37,31
20144,15583,15589,43,2,30,22,2,6,71,28,43,46,14,68
20145,15583,15589,22,6,29,14,6,9,67,49,18,34,24,48
20146,15583,15589,40,15,29,6,8,15,31,41,-10,20,38,26
20147,15583,15589,24,17,29,2,6,21,14,82,-68,10,48,12
20148,15583,15589,1,1,30,24,3,3,90,30,60,51,9,75
20149,15583,15589,17,5,29,14,8,7,46,37,9,36,22,50
20150,15583,15589,42,9,30,13,4,13,45,40,5,30,30,43
20151,15583,15589,12,3,29,18,5,6,66,44,22,41,17,59
20152,15583,15589,25,10,29,10,3,16,32,44,-12,23,35,33
20153,15583,15589,4,7,29,15,2,12,48,46,2,32,26,47
20154,15583,15589,28,4,29,15,6,8,59,41,18,36,22,51
20155,15583,15589,33,11,29,9,5,15,40,62,-22,23,35,32
20156,15583,15589,35,14,29,7,6,16,43,54,-11,20,38,27
20157,15583,15589,21,13,29,7,7,15,38,52,-14,21,37,28
20158,15366,15372,21,9,7,2,3,2,10,12,-2,7,7,9
20159,15366,15372,4,10,7,2,2,3,8,10,-2,6,8,8
20160,15366,15372,35,11,6,2,1,3,10,14,-4,5,7,7
20161,15366,15372,37,14,6,1,0,5,5,17,-12,2,10,3
20162,15366,15372,49,17,7,0,2,5,6,15,-9,2,12,2
20163,15366,15372,28,4,6,4,1,1,20,8,12,9,3,13
20164,15366,15372,33,8,7,3,1,3,18,18,0,7,7,10
20165,15366,15372,27,16,7,0,3,4,6,16,-10,3,11,3
20166,15366,15372,17,5,6,4,1,1,13,3,10,9,3,13
20167,15366,15372,42,6,7,4,1,2,12,6,6,9,5,13
20168,15366,15372,1,1,7,6,1,0,16,4,12,13,1,19
20169,15366,15372,12,3,6,5,1,0,15,6,9,11,1,16
20170,15366,15372,25,12,7,2,0,5,4,14,-10,4,10,6
20171,15366,15372,43,2,7,5,1,1,20,9,11,11,3,16
20172,15366,15372,22,7,6,3,2,1,15,10,5,8,4,11
20173,15366,15372,24,13,7,1,1,5,5,18,-13,3,11,4
20174,15366,15372,40,15,6,0,3,3,5,8,-3,3,9,3
20175,15758,15764,43,1,10,9,1,0,31,6,25,19,1,28
20176,15758,15764,22,2,10,6,2,2,21,13,8,14,6,20
20177,15758,15764,40,7,10,3,6,1,15,9,6,12,8,15
20178,15758,15764,57,12,10,2,5,3,6,11,-5,9,11,11
20179,15758,15764,27,18,10,0,4,6,3,10,-7,4,16,4
20180,15758,15764,25,6,10,4,3,3,14,17,-3,11,9,15
20181,15758,15764,12,16,10,1,3,6,10,20,-10,5,15,6
20182,15758,15764,1,5,10,5,3,2,23,12,11,13,7,18
20183,15758,15764,17,10,10,3,4,3,12,13,-1,10,10,13
20184,17312,17318,22,7,19,8,6,5,31,30,1,22,16,30
20185,17312,17318,51,13,19,5,6,8,26,36,-10,16,22,21
20186,17312,17318,24,15,19,4,6,9,24,32,-8,14,24,18
20187,17312,17318,27,9,19,7,3,9,22,27,-5,17,21,24
20188,17312,17318,45,10,19,7,3,9,25,34,-9,17,21,24
20189,17312,17318,42,18,19,2,4,13,18,34,-16,8,30,10
20190,17312,17318,46,17,19,3,2,14,15,44,-29,8,30,11
20191,17361,17367,49,1,26,16,10,0,49,17,32,42,10,58
20192,17361,17367,23,15,26,7,5,14,26,43,-17,19,33,26
20193,17361,17367,46,18,26,4,4,18,21,54,-33,12,40,16
20194,17361,17367,42,16,26,6,7,13,30,39,-9,19,33,25
20195,17361,17367,1,2,26,16,6,4,34,19,15,38,14,54
20196,17361,17367,45,7,26,10,5,11,33,42,-9,25,27,35
20197,17361,17367,27,12,26,8,6,12,26,34,-8,22,30,30
20198,17361,17367,57,3,26,14,7,5,53,25,28,35,17,49
20199,17361,17367,43,4,26,14,7,5,41,24,17,35,17,49
20200,17361,17367,24,9,26,8,8,10,34,38,-4,24,28,32
20201,17361,17367,22,10,26,8,8,10,36,41,-5,24,28,32
20202,17361,17367,51,14,26,6,9,11,29,45,-16,21,31,27
20203,17361,17367,33,11,26,8,6,12,30,34,-4,22,30,30
20204,17361,17367,28,17,26,4,8,14,21,41,-20,16,36,20
20205,17361,17367,4,6,26,12,8,6,47,33,14,32,20,44
20206,17361,17367,25,8,26,9,8,9,36,28,8,26,26,35
20207,17361,17367,12,13,26,6,12,8,21,25,-4,24,28,30
20208,17361,17367,35,5,26,13,6,7,38,23,15,32,20,45
20209,17410,17416,35,5,33,16,7,10,46,33,13,39,27,55
20210,17410,17416,42,16,33,7,12,14,36,43,-7,26,40,33
20211,17410,17416,49,1,33,21,11,1,59,19,40,53,13,74
20212,17410,17416,23,15,33,9,6,18,33,56,-23,24,42,33
20213,17410,17416,46,18,33,4,7,22,26,64,-38,15,51,19
20214,17410,17416,4,6,33,13,10,10,54,46,8,36,30,49
20215,17410,17416,43,2,33,20,7,6,57,30,27,47,19,67
20216,17410,17416,57,4,33,16,9,8,59,32,27,41,25,57
20217,17410,17416,22,9,33,12,9,12,54,53,1,33,33,45
20218,17410,17416,24,11,33,10,10,13,43,49,-6,30,36,40
20219,17410,17416,51,14,33,9,11,13,36,52,-16,29,37,38
20220,17410,17416,33,12,33,11,6,16,37,43,-6,28,38,39
20221,17410,17416,28,17,33,5,9,19,29,56,-27,19,47,24
20222,17410,17416,27,7,33,13,7,13,40,42,-2,33,33,46
20223,17410,17416,45,10,33,12,8,13,45,53,-8,32,34,44
20224,17410,17416,25,8,33,12,9,12,43,33,10,33,33,45
20225,17410,17416,12,13,33,8,15,10,29,33,-4,31,35,39
20226,17410,17416,1,3,33,19,7,7,41,30,11,45,21,64
20227,17193,17199,12,9,8,3,2,3,7,7,0,8,8,11
20228,17193,17199,25,14,8,2,2,4,4,7,-3,6,10,8
20229,17193,17199,33,7,8,4,1,3,13,10,3,9,7,13
20230,17193,17199,28,18,8,0,1,7,5,15,-10,1,15,1
20231,17193,17199,49,1,8,6,2,0,21,6,15,14,2,20
20232,17193,17199,46,15,8,2,1,5,5,12,-7,5,11,7
20233,17193,17199,23,16,8,1,3,4,7,15,-8,5,11,6
20234,17193,17199,27,6,8,4,2,2,10,6,4,10,6,14
20235,17193,17199,45,10,8,3,2,3,11,13,-2,8,8,11
20236,17193,17199,4,8,8,3,4,1,17,10,7,10,6,13
20237,17193,17199,1,3,8,4,3,1,11,8,3,11,5,15
20238,17193,17199,35,12,8,2,3,3,8,9,-1,7,9,9
20239,17193,17199,42,13,8,2,2,4,10,12,-2,6,10,8
20240,17193,17199,43,2,8,4,3,1,12,7,5,11,5,15
20241,17193,17199,22,4,8,4,3,1,10,10,0,11,5,15
20242,17193,17199,57,5,8,4,2,2,15,10,5,10,6,14
20243,17193,17199,51,11,8,2,4,2,8,11,-3,8,8,10
20244,17193,17199,24,17,8,0,4,4,7,13,-6,4,12,4
20245,17592,17598,25,6,10,5,3,2,15,12,3,13,7,18
20246,17592,17598,57,11,10,4,1,5,14,16,-2,9,11,13
20247,17592,17598,24,15,10,2,2,6,12,22,-10,6,14,8
20248,17592,17598,51,17,10,1,2,7,5,17,-12,4,16,5
20249,17592,17598,32,18,10,1,1,8,7,21,-14,3,17,4
20250,17592,17598,42,13,10,2,3,5,9,14,-5,7,13,9
20251,17592,17598,56,12,10,3,3,4,10,18,-8,9,11,12
20252,17592,17598,35,16,10,1,5,4,9,11,-2,7,13,8
20253,17592,17598,12,8,10,3,6,1,11,6,5,12,8,15
20254,17592,17598,1,1,10,7,2,1,19,8,11,16,4,23
20255,17592,17598,49,4,10,6,2,2,16,10,6,14,6,20
20256,17592,17598,23,14,10,2,3,5,14,20,-6,7,13,9
20257,17592,17598,27,9,10,4,2,4,11,13,-2,10,10,14
20258,17592,17598,45,10,10,4,1,5,13,12,1,9,11,13
20259,17592,17598,43,2,10,7,1,2,26,12,14,15,5,22
20260,17592,17598,22,3,10,6,2,2,17,11,6,14,6,20
20261,17592,17598,4,5,10,5,3,2,21,11,10,13,7,18
20262,17592,17598,33,7,10,5,2,3,17,12,5,12,8,17
20263,18047,18053,35,8,23,9,5,9,26,34,-8,23,23,32
20264,18047,18053,56,9,22,8,7,7,27,25,2,23,21,31
20265,18047,18053,25,11,22,6,6,10,21,30,-9,18,26,24
20266,18047,18053,12,15,22,3,3,16,17,39,-22,9,35,12
20267,18047,18053,1,2,22,14,3,5,42,28,14,31,13,45
20268,18075,18088,1,2,26,15,6,5,47,32,15,36,16,51
20269,18075,18088,28,6,26,11,6,9,32,32,0,28,24,39
20270,18075,18088,49,7,26,10,8,8,37,31,6,28,24,38
20271,18075,18088,56,4,26,11,8,7,35,28,7,30,22,41
20272,18075,18088,35,10,26,9,8,9,29,37,-8,26,26,35
20273,18075,18088,12,14,26,5,3,18,21,47,-26,13,39,18
20274,18075,18088,43,1,26,20,3,3,56,20,36,43,9,63
20275,18075,18088,24,8,27,11,3,13,34,45,-11,25,29,36
20276,18075,18088,57,9,26,10,5,11,41,37,4,25,27,35
20277,18075,18088,22,11,26,8,9,9,32,28,4,25,27,33
20278,18075,18088,51,15,26,4,5,17,29,57,-28,13,39,17
20279,18075,18088,4,3,26,12,7,7,45,29,16,31,21,43
20280,18075,18088,25,12,26,7,7,12,26,33,-7,21,31,28
20281,18075,18088,45,5,26,10,10,6,37,29,8,30,22,40
20282,18075,18088,27,13,27,5,8,14,27,43,-16,18,36,23
20283,18089,18095,45,6,27,10,11,6,38,30,8,31,23,41
20284,18089,18095,27,13,28,5,8,15,28,45,-17,18,38,23
20285,18089,18095,4,3,27,13,7,7,47,30,17,33,21,46
20286,18089,18095,43,1,27,21,3,3,58,20,38,45,9,66
20287,18089,18095,24,8,27,11,3,13,34,45,-11,25,29,36
20288,18089,18095,57,9,27,10,5,12,42,39,3,25,29,35
20289,18089,18095,22,12,27,8,9,10,32,30,2,25,29,33
20290,18089,18095,51,15,27,4,5,18,29,58,-29,13,41,17
20291,18089,18095,25,11,27,8,7,12,28,34,-6,23,31,31
20292,18089,18095,12,14,27,5,3,19,22,50,-28,13,41,18
20293,18089,18095,56,4,27,12,8,7,38,29,9,32,22,44
20294,18089,18095,35,10,27,9,8,10,29,39,-10,26,28,35
20295,18089,18095,49,7,27,10,9,8,38,32,6,29,25,39
20296,18089,18095,28,5,27,12,6,9,34,32,2,30,24,42
20297,18089,18095,1,2,27,16,6,5,48,32,16,38,16,54
20298,18348,18354,17,15,17,1,6,10,13,34,-21,8,26,9
20299,18348,18354,28,12,17,5,2,10,13,34,-21,12,22,17
20300,18348,18354,56,8,17,7,4,6,19,17,2,18,16,25
20301,18348,18354,35,13,17,3,5,9,11,26,-15,11,23,14
20302,18348,18354,49,4,17,9,3,5,35,22,13,21,13,30
20303,18348,18354,12,5,17,8,6,3,26,21,5,22,12,30
20304,18348,18354,25,10,17,6,6,5,21,21,0,18,16,24
20305,18348,18354,45,11,17,4,9,4,24,21,3,17,17,21
20306,18348,18354,15,14,17,3,3,11,20,30,-10,9,25,12
20307,18348,18354,27,16,17,1,4,12,11,34,-23,6,28,7
20308,18348,18354,43,1,17,11,4,2,36,13,23,26,8,37
20309,18348,18354,22,2,17,11,3,3,44,17,27,25,9,36
20310,18348,18354,24,6,17,8,5,4,23,20,3,21,13,29
20311,18348,18354,57,7,17,7,5,5,20,22,-2,19,15,26
20312,18348,18354,4,3,17,10,2,5,34,27,7,22,12,32
20313,18348,18354,1,9,17,7,3,7,33,24,9,17,17,24
20314,18257,18270,1,8,5,2,0,3,8,8,0,4,6,6
20315,18257,18270,4,3,5,4,0,1,7,6,1,8,2,12
20316,18257,18270,22,1,5,5,0,0,19,3,16,10,0,15
20317,18257,18270,24,2,5,4,1,0,7,2,5,9,1,13
20318,18257,18270,43,4,5,3,2,0,11,1,10,8,2,11
20319,18257,18270,57,10,5,1,3,1,5,7,-2,5,5,6
20320,18257,18270,45,9,5,1,3,1,7,4,3,5,5,6
20321,18257,18270,27,12,5,1,2,2,4,9,-5,4,6,5
20322,18257,18270,15,16,5,0,0,5,3,13,-10,0,10,0
20323,18257,18270,25,11,5,1,2,2,3,4,-1,4,6,5
20324,18257,18270,12,13,5,0,3,2,5,10,-5,3,7,3
20325,18257,18270,49,6,5,2,2,1,9,6,3,6,4,8
20326,18257,18270,56,5,5,3,1,1,6,3,3,7,3,10
20327,18257,18270,35,14,5,0,2,3,1,7,-6,2,8,2
20328,18257,18270,28,7,5,2,1,2,3,6,-3,5,5,7
20329,18257,18270,17,15,5,0,0,5,3,12,-9,0,10,0
20330,18726,18732,56,4,17,9,3,5,24,19,5,21,13,30
20331,18726,18732,35,8,17,6,6,5,28,23,5,18,16,24
20332,18726,18732,12,11,17,4,7,6,23,25,-2,15,19,19
20333,18726,18732,25,16,17,2,4,11,13,30,-17,8,26,10
20334,18726,18732,45,13,17,2,9,6,17,24,-7,13,21,15
20335,18726,18732,49,6,17,8,6,3,23,21,2,22,12,30
20336,18726,18732,16,12,17,4,4,9,19,31,-12,12,22,16
20337,18726,18732,42,9,17,6,5,6,31,29,2,17,17,23
20338,18726,18732,17,14,17,2,7,8,12,25,-13,11,23,13
20339,18726,18732,43,1,17,11,3,3,33,15,18,25,9,36
20340,18726,18732,57,5,17,8,6,3,22,15,7,22,12,30
20341,18726,18732,22,7,17,7,5,5,32,24,8,19,15,26
20342,10473,10479,22,18,33,2,10,21,20,67,-47,14,52,16
20343,10473,10479,17,11,33,10,8,15,29,46,-17,28,38,38
20344,10473,10479,41,3,33,16,12,5,58,21,37,44,22,60
20345,10473,10479,56,8,33,9,16,8,51,42,9,34,32,43
20346,10473,10479,20,9,33,11,7,15,48,52,-4,29,37,40
20347,10473,10479,21,5,33,15,10,8,60,39,21,40,26,55
20348,10473,10479,49,6,33,14,8,11,46,41,5,36,30,50
20349,10473,10479,37,10,33,10,8,15,39,49,-10,28,38,38
20350,10473,10479,12,13,33,9,10,14,42,54,-12,28,38,37
20351,10473,10479,53,16,33,8,10,15,40,57,-17,26,40,34
20352,10473,10479,28,7,33,12,10,11,39,44,-5,34,32,46
20353,10473,10479,52,14,33,10,5,18,33,55,-22,25,41,35
20354,10473,10479,54,15,33,9,8,16,34,53,-19,26,40,35
20355,10473,10479,27,17,33,6,16,11,29,47,-18,28,38,34
20356,10473,10479,1,4,33,16,9,8,63,41,22,41,25,57
20357,10662,10668,27,9,12,5,1,6,15,14,1,11,13,16
20358,10662,10668,28,17,12,1,5,6,7,18,-11,7,17,8
20359,10662,10668,54,18,12,1,2,9,10,24,-14,4,20,5
20360,10662,10668,1,2,12,7,3,2,20,12,8,17,7,24
20361,10662,10668,12,6,12,5,4,3,15,15,0,14,10,19
20362,10662,10668,53,16,12,2,5,5,8,19,-11,9,15,11
20363,10662,10668,49,8,12,4,5,3,16,12,4,13,11,17
20364,10662,10668,37,10,12,4,3,5,13,20,-7,11,13,15
20365,10662,10668,21,5,12,6,5,1,25,10,15,17,7,23
20366,10662,10668,4,7,12,5,3,4,15,14,1,13,11,18
20367,10662,10668,43,1,12,8,3,1,27,4,23,19,5,27
20368,10662,10668,24,3,12,6,6,0,20,4,16,18,6,24
20369,10662,10668,57,4,12,7,2,3,18,12,6,16,8,23
20370,10662,10668,56,10,12,4,3,5,13,20,-7,11,13,15
20371,10662,10668,35,13,12,4,1,7,16,19,-3,9,15,13
20372,10662,10668,41,14,12,3,2,7,9,13,-4,8,16,11
20373,10662,10668,20,15,12,3,2,7,14,23,-9,8,16,11
20374,10662,10668,17,12,12,4,3,5,15,23,-8,11,13,15
20375,10606,10612,4,7,5,2,1,2,7,10,-3,5,5,7
20376,10606,10612,21,10,5,1,3,1,5,5,0,5,5,6
20377,10606,10612,24,1,5,4,1,0,12,2,10,9,1,13
20378,10606,10612,57,2,5,4,0,1,9,4,5,8,2,12
20379,10606,10612,43,3,5,3,2,0,12,3,9,8,2,11
20380,10606,10612,49,8,5,1,4,0,7,3,4,6,4,7
20381,10606,10612,37,11,5,1,3,1,6,7,-1,5,5,6
20382,10606,10612,53,12,5,1,3,1,2,5,-3,5,5,6
20383,10606,10612,12,15,5,1,1,3,7,12,-5,3,7,4
20384,10606,10612,27,6,5,2,1,2,7,5,2,5,5,7
20385,10606,10612,56,4,5,3,1,1,11,6,5,7,3,10
20386,10606,10612,20,5,5,2,2,1,8,9,-1,6,4,8
20387,10606,10612,41,13,5,1,1,3,2,3,-1,3,7,4
20388,10606,10612,35,14,5,1,1,3,5,8,-3,3,7,4
20389,10606,10612,28,16,5,0,3,2,2,6,-4,3,7,3
20390,10606,10612,54,18,5,0,1,4,4,10,-6,1,9,1
20391,10606,10612,1,9,5,1,3,1,9,8,1,5,5,6
20392,10606,10612,17,17,5,0,3,2,2,11,-9,3,7,3
20393,11029,11032,12,6,13,6,3,4,18,12,6,15,11,21
20394,11029,11032,53,14,13,3,3,7,19,31,-12,9,17,12
20395,11029,11032,1,5,13,7,4,2,19,13,6,18,8,25
20396,11029,11032,27,11,13,3,6,4,15,14,1,12,14,15
20397,11029,11032,52,13,13,3,3,7,15,24,-9,9,17,12
20398,11029,11032,28,18,13,2,4,7,10,23,-13,8,18,10
20399,11029,11032,4,1,13,9,4,0,32,12,20,22,4,31
20400,11029,11032,21,7,13,4,6,3,20,16,4,14,12,18
20401,11029,11032,43,2,13,8,3,2,35,10,25,19,7,27
20402,11029,11032,24,4,13,7,4,2,26,13,13,18,8,25
20403,11029,11032,57,10,13,4,3,6,17,21,-4,11,15,15
20404,11029,11032,22,15,13,3,3,7,10,28,-18,9,17,12
20405,11029,11032,35,8,13,4,5,4,21,20,1,13,13,17
20406,11029,11032,41,9,13,4,3,6,15,16,-1,11,15,15
20407,11029,11032,20,12,13,3,4,6,12,20,-8,10,16,13
20408,11029,11032,56,16,13,3,2,8,14,26,-12,8,18,11
20409,11029,11032,17,17,13,2,5,6,8,17,-9,9,17,11
20410,11029,11032,49,3,13,7,5,1,25,15,10,19,7,26
20411,11138,11151,4,1,26,17,7,2,58,26,32,41,11,58
20412,11138,11151,21,7,26,9,11,6,44,32,12,29,23,38
20413,11138,11151,43,2,26,17,6,3,61,19,42,40,12,57
20414,11138,11151,24,3,26,15,7,4,44,21,23,37,15,52
20415,11138,11151,57,11,26,8,6,12,31,51,-20,22,30,30
20416,11138,11151,22,14,26,5,7,14,22,57,-35,17,35,22
20417,11138,11151,27,10,26,6,14,6,25,22,3,26,26,32
20418,11138,11151,12,8,26,9,7,10,32,30,2,25,27,34
20419,11138,11151,53,17,26,5,5,16,29,53,-24,15,37,20
20420,11138,11151,49,6,26,12,9,5,40,33,7,33,19,45
20421,22716,22757,16,8,17,7,4,6,30,26,4,18,16,25
20422,22716,22757,21,3,17,11,2,4,30,17,13,24,10,35
20423,22716,22757,4,5,17,9,3,5,32,18,14,21,13,30
20424,22716,22757,9,14,17,5,2,10,20,37,-17,12,22,17
20425,22716,22757,39,2,17,11,3,3,35,22,13,25,9,36
20426,22716,22757,27,13,17,6,1,10,22,34,-12,13,21,19
20427,22716,22757,15,15,17,5,1,11,24,38,-14,11,23,16
20428,22716,22757,45,16,17,3,4,10,23,40,-17,10,24,13
20429,22716,22757,28,10,17,6,5,6,17,19,-2,17,17,23
20430,22716,22757,56,17,17,3,3,11,14,33,-19,9,25,12
20431,22716,22757,13,18,17,3,2,12,16,33,-17,8,26,11
20432,22716,22757,1,4,17,10,3,4,34,20,14,23,11,33
20433,22716,22757,22,1,17,15,1,1,45,15,30,31,3,46
20434,22716,22757,57,9,17,7,4,6,24,24,0,18,16,25
20435,22716,22757,24,11,17,6,3,8,29,30,-1,15,19,21
20436,22716,22757,43,12,17,6,2,9,25,25,0,14,20,20
20437,22611,22617,22,4,2,1,0,1,5,4,1,2,2,3
20438,22611,22617,43,6,2,1,0,1,2,1,1,2,2,3
20439,22611,22617,57,12,2,1,0,1,1,2,-1,2,2,3
20440,22611,22617,24,17,2,0,0,2,1,4,-3,0,4,0
20441,22611,22617,1,8,2,1,0,1,4,4,0,2,2,3
20442,22611,22617,39,3,2,1,1,0,2,1,1,3,1,4
20443,22611,22617,27,5,2,1,0,1,3,2,1,2,2,3
20444,22611,22617,45,6,2,1,0,1,2,1,1,2,2,3
20445,22611,22617,15,10,2,1,0,1,3,4,-1,2,2,3
20446,22611,22617,28,15,2,0,2,0,2,2,0,2,2,2
20447,22611,22617,16,1,2,2,0,0,4,0,4,4,0,6
20448,22611,22617,49,16,2,0,1,1,3,5,-2,1,3,1
20449,22611,22617,21,2,2,2,0,0,3,0,3,4,0,6
20450,22611,22617,9,11,2,1,0,1,2,3,-1,2,2,3
20451,22611,22617,4,14,2,0,2,0,3,3,0,2,2,2
20452,22611,22617,25,9,2,1,0,1,2,2,0,2,2,3
20453,22611,22617,56,12,2,1,0,1,1,2,-1,2,2,3
20454,22611,22617,13,18,2,0,0,2,0,3,-3,0,4,0
20455,22783,22785,25,8,21,9,3,9,41,38,3,21,21,30
20456,22783,22785,49,6,21,10,4,7,33,24,9,24,18,34
20457,22783,22785,16,9,21,8,6,7,36,32,4,22,20,30
20458,22783,22785,21,3,21,13,3,5,38,22,16,29,13,42
20459,22783,22785,4,5,21,10,5,6,34,21,13,25,17,35
20460,22783,22785,9,17,21,5,2,14,22,47,-25,12,30,17
20461,22783,22785,28,7,21,8,7,6,23,21,2,23,19,31
20462,22783,22785,39,2,21,14,4,3,44,24,20,32,10,46
20463,22783,22785,27,11,21,8,2,11,26,37,-11,18,24,26
20464,22783,22785,15,15,21,6,2,13,27,43,-16,14,28,20
20465,22783,22785,45,16,21,5,4,12,28,45,-17,14,28,19
20466,22783,22785,56,14,21,6,3,12,22,39,-17,15,27,21
20467,22783,22785,13,18,21,4,3,14,21,39,-18,11,31,15
20468,22783,22785,1,4,21,10,6,5,38,26,12,26,16,36
20469,22783,22785,22,1,21,18,1,2,52,19,33,37,5,55
20470,22783,22785,57,10,21,7,6,8,27,29,-2,20,22,27
20471,22783,22785,24,12,21,7,4,10,32,36,-4,18,24,25
20472,22783,22785,43,13,21,7,3,11,30,32,-2,17,25,24
20473,22828,22834,22,1,28,21,4,3,67,27,40,46,10,67
20474,22828,22834,57,8,28,10,10,8,40,38,2,30,26,40
20475,22828,22834,43,10,28,10,6,12,40,38,2,26,30,36
20476,22828,22834,24,13,28,9,6,13,42,51,-9,24,32,33
20477,22828,22834,1,4,28,12,10,6,47,35,12,34,22,46
20478,22828,22834,39,2,28,18,5,5,57,34,23,41,15,59
20479,22828,22834,27,9,28,11,5,12,35,42,-7,27,29,38
20480,22828,22834,15,15,28,7,5,16,35,55,-20,19,37,26
20481,22828,22834,45,17,28,5,8,15,37,61,-24,18,38,23
20482,22828,22834,28,12,28,9,9,10,28,32,-4,27,29,36
20483,22828,22834,21,3,28,17,6,5,51,24,27,40,16,57
20484,22828,22834,4,5,28,13,6,9,47,32,15,32,24,45
20485,22828,22834,9,16,28,6,5,17,29,57,-28,17,39,23
20486,22828,22834,49,6,28,13,6,9,46,36,10,32,24,45
20487,22828,22834,16,11,28,9,9,10,43,41,2,27,29,36
20488,22828,22834,25,7,28,12,6,10,53,47,6,30,26,42
20489,22828,22834,56,14,28,7,6,15,33,51,-18,20,36,27
20490,22828,22834,13,18,28,5,4,19,25,54,-29,14,42,19
20491,22632,22638,56,13,5,1,1,3,3,6,-3,3,7,4
20492,22632,22638,13,17,5,1,0,4,4,8,-4,2,8,3
20493,22632,22638,25,10,5,2,0,3,11,11,0,4,6,6
20494,22632,22638,28,12,5,1,3,1,3,5,-2,5,5,6
20495,22632,22638,16,7,5,3,0,2,9,8,1,6,4,9
20496,22632,22638,49,14,5,1,1,3,8,12,-4,3,7,4
20497,22632,22638,21,1,5,5,0,0,12,4,8,10,0,15
20498,22632,22638,4,3,5,3,2,0,9,5,4,8,2,11
20499,22632,22638,9,11,5,2,0,3,6,8,-2,4,6,6
20500,22632,22638,57,16,5,1,1,3,2,6,-4,3,7,4
20501,22632,22638,45,15,5,1,1,3,5,9,-4,3,7,4
20502,22632,22638,15,18,5,1,0,4,6,12,-6,2,8,3
20503,22632,22638,27,6,5,3,0,2,8,6,2,6,4,9
20504,22632,22638,39,9,5,2,1,2,6,9,-3,5,5,7
20505,22632,22638,1,4,5,3,1,1,10,6,4,7,3,10
20506,22632,22638,22,2,5,4,0,1,15,8,7,8,2,12
20507,22632,22638,43,5,5,3,0,2,8,3,5,6,4,9
20508,22632,22638,24,8,5,2,1,2,9,8,1,5,5,7
20509,22996,23002,43,4,4,3,0,1,4,3,1,6,2,9
20510,22996,23002,22,6,4,2,1,1,5,1,4,5,3,7
20511,22996,23002,57,9,4,2,0,2,3,2,1,4,4,6
20512,22996,23002,24,11,4,1,1,2,5,3,2,3,5,4
20513,22996,23002,1,1,4,3,1,0,14,2,12,7,1,10
20514,22996,23002,56,16,4,0,0,4,3,13,-10,0,8,0
20515,22996,23002,28,7,4,2,1,1,4,3,1,5,3,7
20516,22996,23002,39,3,4,3,0,1,8,5,3,6,2,9
20517,22996,23002,15,8,4,2,1,1,6,8,-2,5,3,7
20518,22996,23002,27,12,4,0,3,1,2,4,-2,3,5,3
20519,22996,23002,4,2,4,3,1,0,9,5,4,7,1,10
20520,22996,23002,21,5,4,2,1,1,8,2,6,5,3,7
20521,22996,23002,16,13,4,0,2,2,4,9,-5,2,6,2
20522,22996,23002,49,14,4,0,1,3,1,4,-3,1,7,1
20523,22996,23002,55,10,4,2,0,2,4,12,-8,4,4,6
20524,22996,23002,25,15,4,0,1,3,4,8,-4,1,7,1
20525,18726,18732,24,10,17,5,4,8,22,33,-11,14,20,19
20526,18726,18732,4,3,17,10,3,4,38,19,19,23,11,33
20527,18726,18732,28,15,17,2,4,11,24,40,-16,8,26,10
20528,18726,18732,1,2,17,10,4,3,30,18,12,24,10,34
20529,18796,18802,28,16,26,2,8,16,28,56,-28,12,40,14
20530,18796,18802,4,3,26,14,5,7,55,31,24,33,19,47
20531,18796,18802,43,1,26,18,5,3,53,23,30,41,11,59
20532,18796,18802,57,5,26,12,7,7,34,30,4,31,21,43
20533,18796,18802,22,6,26,11,7,8,50,37,13,29,23,40
20534,18796,18802,24,8,26,9,7,10,36,43,-7,25,27,34
20535,18796,18802,45,13,26,5,12,9,29,34,-5,22,30,27
20536,18796,18802,56,7,26,11,7,8,31,26,5,29,23,40
20537,18796,18802,35,10,26,8,8,10,39,42,-3,24,28,32
20538,18796,18802,49,4,26,12,8,6,37,31,6,32,20,44
20539,18796,18802,16,14,26,6,7,13,34,51,-17,19,33,25
20540,18796,18802,12,9,26,8,10,8,36,36,0,26,26,34
20541,18796,18802,25,15,26,4,5,17,24,48,-24,13,39,17
20542,18796,18802,42,11,26,7,8,11,43,49,-6,22,30,29
20543,18796,18802,17,12,26,6,10,10,23,34,-11,22,30,28
20544,18796,18802,1,2,26,16,4,6,47,28,19,36,16,52
20545,18957,18963,1,4,1,1,0,0,3,1,2,2,0,3
20546,18957,18963,42,1,1,1,0,0,5,2,3,2,0,3
20547,18957,18963,17,15,1,0,0,1,0,2,-2,0,2,0
20548,18957,18963,12,2,1,1,0,0,4,2,2,2,0,3
20549,18957,18963,49,11,1,0,0,1,0,1,-1,0,2,0
20550,18957,18963,16,16,1,0,0,1,2,5,-3,0,2,0
20551,18957,18963,56,9,1,0,1,0,1,1,0,1,1,1
20552,18957,18963,35,12,1,0,0,1,2,4,-2,0,2,0
20553,18957,18963,24,2,1,1,0,0,4,2,2,2,0,3
20554,18957,18963,57,7,1,0,1,0,3,3,0,1,1,1
20555,18957,18963,22,7,1,0,1,0,3,3,0,1,1,1
20556,18957,18963,43,9,1,0,1,0,1,1,0,1,1,1
20557,18957,18963,4,5,1,1,0,0,2,0,2,2,0,3
20558,18957,18963,45,6,1,1,0,0,1,0,1,2,0,3
20559,18957,18963,27,12,1,0,0,1,2,4,-2,0,2,0
20560,18957,18963,10,14,1,0,0,1,1,3,-2,0,2,0
20561,19027,19040,43,3,10,5,4,1,18,10,8,14,6,19
20562,19027,19040,22,4,10,4,6,0,17,12,5,14,6,18
20563,19027,19040,24,12,10,3,2,5,16,16,0,8,12,11
20564,19027,19040,57,16,10,1,1,8,8,24,-16,3,17,4
20565,19027,19040,1,1,10,6,4,0,25,12,13,16,4,22
20566,19027,19040,45,2,10,6,1,3,19,13,6,13,7,19
20567,19027,19040,27,14,10,2,1,7,10,23,-13,5,15,7
20568,19027,19040,10,15,10,1,4,5,11,19,-8,6,14,7
20569,19027,19040,12,11,10,3,3,4,14,16,-2,9,11,12
20570,19027,19040,4,6,10,4,4,2,15,13,2,12,8,16
20571,19027,19040,16,8,10,3,5,2,21,17,4,11,9,14
20572,19027,19040,49,9,10,4,1,5,20,18,2,9,11,13
20573,19027,19040,56,5,10,5,2,3,12,10,2,12,8,17
20574,19027,19040,35,7,10,4,2,4,15,15,0,10,10,14
20575,19027,19040,42,10,10,3,3,4,19,20,-1,9,11,12
20576,19027,19040,17,13,10,1,7,2,11,13,-2,9,11,10
20577,19132,19138,42,9,23,9,4,10,39,45,-6,22,24,31
20578,19132,19138,17,14,23,3,10,10,23,43,-20,16,30,19
20579,19132,19138,56,7,23,9,5,9,28,23,5,23,23,32
20580,19132,19138,35,15,23,5,3,15,23,49,-26,13,33,18
20581,19132,19138,49,5,23,12,3,8,45,28,17,27,19,39
20582,19132,19138,16,10,23,6,10,7,41,40,1,22,24,28
20583,19132,19138,45,2,23,14,5,4,37,23,14,33,13,47
20584,19132,19138,27,11,23,7,3,13,23,43,-20,17,29,24
20585,19132,19138,10,13,23,5,8,10,22,37,-15,18,28,23
20586,19132,19138,12,3,23,13,4,6,47,32,15,30,16,43
20587,19132,19138,1,4,23,12,6,5,54,34,20,30,16,42
20588,19132,19138,43,1,23,16,4,3,57,21,36,36,10,52
20589,19132,19138,22,6,23,10,9,4,46,34,12,29,17,39
20590,19132,19138,24,8,23,9,5,9,34,33,1,23,23,32
20591,19132,19138,57,16,23,3,5,15,26,50,-24,11,35,14
20592,19132,19138,4,12,23,5,8,10,24,34,-10,18,28,23
20593,18971,18977,4,9,3,1,1,1,4,4,0,3,3,4
20594,18971,18977,43,1,3,2,1,0,5,1,4,5,1,7
20595,18971,18977,24,5,3,1,2,0,7,5,2,4,2,5
20596,18971,18977,22,6,3,1,2,0,6,5,1,4,2,5
20597,18971,18977,57,15,3,0,1,2,4,8,-4,1,5,1
20598,18971,18977,45,3,3,2,1,0,5,2,3,5,1,7
20599,18971,18977,27,11,3,1,0,2,3,5,-2,2,4,3
20600,18971,18977,10,16,3,0,1,2,2,6,-4,1,5,1
20601,18971,18977,49,8,3,1,1,1,3,2,1,3,3,4
20602,18971,18977,16,13,3,0,2,1,5,8,-3,2,4,2
20603,18971,18977,56,10,3,1,1,1,3,3,0,3,3,4
20604,18971,18977,35,14,3,0,1,2,3,6,-3,1,5,1
20605,15758,15764,42,15,10,1,6,3,7,13,-6,8,12,9
20606,15758,15764,33,4,10,5,4,1,19,10,9,14,6,19
20607,15758,15764,28,9,10,3,4,3,11,11,0,10,10,13
20608,15758,15764,49,3,10,6,1,3,16,9,7,13,7,19
20609,15758,15764,37,14,10,3,0,7,11,21,-10,6,14,9
20610,15758,15764,35,11,10,3,4,3,9,10,-1,10,10,13
20611,15758,15764,4,8,10,3,5,2,13,11,2,11,9,14
20612,15758,15764,21,13,10,3,1,6,7,20,-13,7,13,10
20613,15758,15764,31,17,10,1,2,7,6,18,-12,4,16,5
20614,15919,15925,4,10,28,7,12,9,26,28,-2,26,30,33
20615,15919,15925,21,17,28,6,5,17,23,52,-29,17,39,23
20616,15919,15925,31,18,28,5,6,17,27,55,-28,16,40,21
20617,15919,15925,35,7,28,9,11,8,24,28,-4,29,27,38
20618,15919,15925,49,3,28,15,9,4,56,24,32,39,17,54
20619,15919,15925,37,9,28,10,3,15,35,48,-13,23,33,33
20620,15919,15925,33,4,28,13,11,4,55,34,21,37,19,50
20621,15919,15925,28,8,28,8,10,10,31,39,-8,26,30,34
20622,15919,15925,27,16,28,6,7,15,29,40,-11,19,37,25
20623,15919,15925,42,12,28,7,10,11,26,34,-8,24,32,31
20624,15919,15925,17,13,28,6,13,9,25,33,-8,25,31,31
20625,15919,15925,1,2,28,18,4,6,60,28,32,40,16,58
20626,15919,15925,25,5,28,13,8,7,44,35,9,34,22,47
20627,15919,15925,12,15,28,7,7,14,35,49,-14,21,35,28
20628,15919,15925,43,1,28,22,3,3,66,22,44,47,9,69
20629,15919,15925,22,6,28,12,8,8,48,36,12,32,24,44
20630,15919,15925,40,11,28,7,12,9,34,37,-3,26,30,33
20631,15919,15925,57,14,28,6,11,11,22,44,-22,23,33,29
20632,15702,15715,22,4,4,2,1,1,6,3,3,5,3,7
20633,15702,15715,40,6,4,1,3,0,5,3,2,5,3,6
20634,15702,15715,57,10,4,1,2,1,1,2,-1,4,4,5
20635,15702,15715,27,16,4,0,2,2,0,3,-3,2,6,2
20636,15702,15715,43,1,4,4,0,0,10,2,8,8,0,12
20637,15702,15715,17,9,4,1,2,1,2,2,0,4,4,5
20638,15702,15715,42,18,4,0,2,2,4,9,-5,2,6,2
20639,15702,15715,25,13,4,0,3,1,3,4,-1,3,5,3
20640,15702,15715,12,15,4,0,2,2,2,4,-2,2,6,2
20641,15702,15715,1,2,4,3,1,0,10,3,7,7,1,10
20642,15702,15715,28,7,4,1,2,1,4,4,0,4,4,5
20643,15702,15715,33,14,4,0,3,1,6,8,-2,3,5,3
20644,15702,15715,49,3,4,3,1,0,8,2,6,7,1,10
20645,15702,15715,37,12,4,1,0,3,5,10,-5,2,6,3
20646,15702,15715,35,8,4,1,2,1,3,3,0,4,4,5
20647,15702,15715,4,5,4,2,1,1,9,7,2,5,3,7
20648,15702,15715,21,11,4,1,1,2,3,8,-5,3,5,4
20649,15702,15715,31,17,4,0,2,2,0,4,-4,2,6,2
20650,16206,16212,4,5,18,10,3,5,31,22,9,23,13,33
20651,16206,16212,9,18,18,1,5,12,15,37,-22,7,29,8
20652,16206,16212,35,14,18,5,3,10,16,21,-5,13,23,18
20653,16206,16212,33,12,18,6,3,9,25,24,1,15,21,21
20654,16206,16212,28,15,18,4,4,10,18,31,-13,12,24,16
20655,16206,16212,1,1,18,15,2,1,48,10,38,32,4,47
20656,16206,16212,25,8,18,8,2,8,19,27,-8,18,18,26
20657,16206,16212,12,9,18,7,5,6,22,21,1,19,17,26
20658,16206,16212,17,10,18,7,3,8,32,32,0,17,19,24
20659,16206,16212,42,17,18,2,3,13,19,37,-18,7,29,9
20660,16206,16212,49,4,18,10,3,5,32,21,11,23,13,33
20661,16206,16212,37,11,18,6,4,8,24,25,-1,16,20,22
20662,16206,16212,46,16,18,4,2,12,17,37,-20,10,26,14
20663,16206,16212,43,2,18,14,1,3,39,17,22,29,7,43
20664,16206,16212,22,6,18,9,6,3,26,18,8,24,12,33
20665,16206,16212,40,7,18,9,3,6,28,17,11,21,15,30
20666,16206,16212,57,13,18,6,2,10,26,47,-21,14,22,20
20667,16206,16212,27,3,18,10,4,4,26,19,7,24,12,34
20668,16213,16219,27,4,19,10,5,4,26,19,7,25,13,35
20669,16213,16219,43,2,19,14,2,3,41,19,22,30,8,44
20670,16213,16219,22,3,19,10,6,3,28,19,9,26,12,36
20671,16213,16219,40,7,19,9,4,6,30,19,11,22,16,31
20672,16213,16219,57,13,19,6,3,10,28,49,-21,15,23,21
20673,16213,16219,17,9,19,8,3,8,35,32,3,19,19,27
20674,16213,16219,42,17,19,3,3,13,23,37,-14,9,29,12
20675,16213,16219,12,8,19,8,5,6,24,22,2,21,17,29
20676,16213,16219,25,10,19,8,2,9,19,30,-11,18,20,26
20677,16213,16219,1,1,19,16,2,1,49,10,39,34,4,50
20678,16213,16219,33,12,19,6,3,10,26,26,0,15,23,21
20679,16213,16219,28,15,19,4,5,10,20,33,-13,13,25,17
20680,16213,16219,35,14,19,5,4,10,16,21,-5,14,24,19
20681,16213,16219,4,6,19,10,3,6,31,23,8,23,15,33
20682,16213,16219,9,18,19,1,6,12,15,37,-22,8,30,9
20683,16213,16219,49,5,19,10,4,5,32,21,11,24,14,34
20684,17676,17682,35,13,19,5,6,8,23,24,-1,16,22,21
20685,17676,17682,33,8,19,8,5,6,31,25,6,21,17,29
20686,17676,17682,42,16,19,3,6,10,20,28,-8,12,26,15
20687,17676,17682,49,2,19,12,4,3,34,19,15,28,10,40
20688,17676,17682,23,17,19,3,6,10,23,37,-14,12,26,15
20689,17676,17682,45,10,19,8,3,8,29,26,3,19,19,27
20690,17676,17682,27,12,19,6,3,10,24,31,-7,15,23,21
20691,17676,17682,1,3,19,10,4,5,33,26,7,24,14,34
20692,17676,17682,4,11,19,7,5,7,36,27,9,19,19,26
20693,17676,17682,25,6,19,9,4,6,24,22,2,22,16,31
20694,17676,17682,12,7,19,7,9,3,25,17,8,23,15,30
20695,17676,17682,56,9,19,7,7,5,21,25,-4,21,17,28
20696,17676,17682,43,1,19,13,2,4,46,20,26,28,10,41
20697,17676,17682,22,4,19,10,3,6,29,26,3,23,15,33
20698,17676,17682,57,5,19,10,1,8,31,30,1,21,17,31
20699,17676,17682,24,14,19,4,7,8,21,33,-12,15,23,19
20700,17676,17682,32,15,19,5,3,11,23,38,-15,13,25,18
20701,17676,17682,51,18,19,3,4,12,17,36,-19,10,28,13
20702,17690,17696,24,13,21,5,8,8,27,35,-8,18,24,23
20703,17690,17696,32,15,21,5,3,13,25,46,-21,13,29,18
20704,17690,17696,51,18,21,3,5,13,19,41,-22,11,31,14
20705,17690,17696,25,5,21,10,4,7,26,24,2,24,18,34
20706,17690,17696,12,9,21,7,9,5,26,20,6,23,19,30
20707,17690,17696,1,3,21,12,4,5,38,27,11,28,14,40
20708,17690,17696,45,8,21,9,4,8,32,28,4,22,20,31
20709,17690,17696,27,14,21,6,4,11,28,38,-10,16,26,22
20710,17690,17696,49,2,21,14,4,3,39,19,20,32,10,46
20711,17690,17696,42,17,21,3,7,11,23,32,-9,13,29,16
20712,17690,17696,23,16,21,4,6,11,25,39,-14,14,28,18
20713,17690,17696,56,11,21,7,7,7,22,30,-8,21,21,28
20714,17690,17696,35,12,21,6,7,8,27,27,0,19,23,25
20715,17690,17696,33,10,21,8,5,8,31,29,2,21,21,29
20716,17690,17696,43,1,21,15,2,4,52,23,29,32,10,47
20717,17690,17696,22,4,21,11,3,7,32,29,3,25,17,36
20718,17690,17696,57,6,21,10,3,8,34,33,1,23,19,33
20719,17690,17696,4,7,21,9,5,7,43,29,14,23,19,32
20720,17697,17703,4,8,22,9,6,7,46,32,14,24,20,33
20721,17697,17703,24,13,22,5,9,8,30,38,-8,19,25,24
20722,17697,17703,32,15,22,5,3,14,25,50,-25,13,31,18
20723,17697,17703,51,18,22,3,5,14,20,43,-23,11,33,14
20724,17697,17703,33,10,22,8,6,8,31,29,2,22,22,30
20725,17697,17703,56,11,22,7,8,7,23,31,-8,22,22,29
20726,17697,17703,35,12,22,6,8,8,28,28,0,20,24,26
20727,17697,17703,42,17,22,3,8,11,24,33,-9,14,30,17
20728,17697,17703,1,3,22,12,4,6,38,29,9,28,16,40
20729,17697,17703,49,2,22,15,4,3,43,19,24,34,10,49
20730,17697,17703,23,16,22,4,6,12,25,40,-15,14,30,18
20731,17697,17703,45,6,22,10,4,8,33,28,5,24,20,34
20732,17697,17703,27,14,22,6,4,12,28,39,-11,16,28,22
20733,17697,17703,25,5,22,10,5,7,26,24,2,25,19,35
20734,17697,17703,12,9,22,8,9,5,28,21,7,25,19,33
20735,17697,17703,43,1,22,16,2,4,53,23,30,34,10,50
20736,17697,17703,22,4,22,12,3,7,34,29,5,27,17,39
20737,17697,17703,57,7,22,10,4,8,35,34,1,24,20,34
20738,17732,17745,43,1,27,19,3,5,63,28,35,41,13,60
20739,17732,17745,22,4,27,14,4,9,43,37,6,32,22,46
20740,17732,17745,24,11,27,9,9,9,37,42,-5,27,27,36
20741,17732,17745,57,12,27,10,5,12,36,43,-7,25,29,35
20742,17732,17745,51,16,27,6,6,15,27,47,-20,18,36,24
20743,17732,17745,32,17,27,5,3,19,26,67,-41,13,41,18
20744,17732,17745,35,10,27,9,9,9,36,31,5,27,27,36
20745,17732,17745,56,14,27,7,9,11,28,42,-14,23,31,30
20746,17732,17745,42,18,27,3,8,16,26,44,-18,14,40,17
20747,17732,17745,45,8,27,11,6,10,40,32,8,28,26,39
20748,17732,17745,27,13,27,8,7,12,33,40,-7,23,31,31
20749,17732,17745,1,3,27,15,5,7,48,38,10,35,19,50
20750,17732,17745,4,5,27,13,6,8,55,36,19,32,22,45
20751,17732,17745,49,2,27,18,4,5,52,24,28,40,14,58
20752,17732,17745,23,15,27,6,6,15,35,49,-14,18,36,24
20753,17732,17745,33,9,27,10,8,9,35,33,2,28,26,38
20754,17732,17745,25,6,27,12,7,8,33,29,4,31,23,43
20755,17732,17745,12,7,27,10,11,6,33,24,9,31,23,41
20756,17760,17766,25,7,30,13,7,10,37,33,4,33,27,46
20757,17760,17766,12,8,30,11,12,7,34,25,9,34,26,45
20758,17760,17766,33,10,30,11,8,11,38,39,-1,30,30,41
20759,17760,17766,35,12,30,9,9,12,38,37,1,27,33,36
20760,17760,17766,56,15,30,7,10,13,31,50,-19,24,36,31
20761,17760,17766,43,1,30,21,4,5,65,28,37,46,14,67
20762,10249,10255,54,18,10,1,2,7,13,21,-8,4,16,5
20763,10249,10255,27,14,10,2,3,5,8,20,-12,7,13,9
20764,10249,10255,21,3,10,6,3,1,24,14,10,15,5,21
20765,10249,10255,1,4,10,6,2,2,23,9,14,14,6,20
20766,10249,10255,17,11,10,2,4,4,8,15,-7,8,12,10
20767,10249,10255,12,12,10,2,3,5,12,14,-2,7,13,9
20768,10249,10255,41,5,10,5,4,1,21,8,13,14,6,19
20769,10249,10255,20,8,10,4,2,4,14,18,-4,10,10,14
20770,10249,10255,56,9,10,3,3,4,16,16,0,9,11,12
20771,10249,10255,24,1,10,8,2,0,22,8,14,18,2,26
20772,10249,10255,43,2,10,8,1,1,24,9,15,17,3,25
20773,10249,10255,22,16,10,1,4,5,4,20,-16,6,14,7
20774,10249,10255,57,17,10,1,3,6,8,16,-8,5,15,6
20775,10249,10255,49,7,10,4,3,3,15,12,3,11,9,15
20776,10249,10255,37,13,10,2,3,5,10,12,-2,7,13,9
20777,10256,10262,49,7,11,4,3,4,15,15,0,11,11,15
20778,10256,10262,37,10,11,3,3,5,14,14,0,9,13,12
20779,10256,10262,24,1,11,9,2,0,25,8,17,20,2,29
20780,10256,10262,43,2,11,9,1,1,28,10,18,19,3,28
20781,10256,10262,57,15,11,2,3,6,10,16,-6,7,15,9
20782,10256,10262,22,17,11,1,5,5,6,22,-16,7,15,8
20783,10256,10262,41,4,11,6,4,1,24,8,16,16,6,22
20784,10256,10262,20,8,11,4,2,5,15,20,-5,10,12,14
20785,10256,10262,56,12,11,3,3,5,18,20,-2,9,13,12
20786,10256,10262,53,9,11,3,4,4,16,19,-3,10,12,13
20787,10256,10262,12,11,11,3,3,5,14,15,-1,9,13,12
20788,10256,10262,17,14,11,2,4,5,9,19,-10,8,14,10
20789,10256,10262,1,3,11,7,2,2,25,10,15,16,6,23
20790,10256,10262,21,5,11,6,3,2,25,16,9,15,7,21
20791,10256,10262,27,16,11,2,3,6,8,22,-14,7,15,9
20792,10256,10262,28,6,11,5,3,3,14,15,-1,13,9,18
20793,10256,10262,52,13,11,3,2,6,6,14,-8,8,14,11
20794,10256,10262,54,18,11,1,2,8,13,22,-9,4,18,5
20795,10312,10318,28,6,16,7,4,5,20,22,-2,18,14,25
20796,10312,10318,52,11,16,5,3,8,14,23,-9,13,19,18
20797,10312,10318,54,17,16,3,4,9,18,31,-13,10,22,13
20798,10312,10318,21,5,16,8,5,3,30,20,10,21,11,29
20799,10312,10318,49,9,16,5,5,6,20,22,-2,15,17,20
20800,10312,10318,37,12,16,4,3,9,17,24,-7,11,21,15
20801,10312,10318,1,4,16,9,3,4,34,17,17,21,11,30
20802,10312,10318,27,13,16,3,6,7,14,27,-13,12,20,15
20803,10312,10318,17,15,16,3,5,8,11,24,-13,11,21,14
20804,10312,10318,12,10,16,5,4,7,21,21,0,14,18,19
20805,10312,10318,53,14,16,3,5,8,17,26,-9,11,21,14
20806,10312,10318,41,3,16,10,5,1,38,12,26,25,7,35
20807,10312,10318,20,7,16,7,3,6,25,25,0,17,15,24
20808,10312,10318,56,8,16,6,5,5,26,22,4,17,15,23
20809,10312,10318,24,1,16,12,3,1,31,12,19,27,5,39
20810,10312,10318,43,2,16,11,3,2,35,14,21,25,7,36
20811,10312,10318,57,16,16,3,4,9,17,25,-8,10,22,13
20812,10312,10318,22,18,16,2,6,8,9,30,-21,10,22,12
20813,10396,10402,24,1,22,17,4,1,46,14,32,38,6,55
20814,10396,10402,43,2,22,15,5,2,55,20,35,35,9,50
20815,10396,10402,57,17,22,4,4,14,21,35,-14,12,32,16
20816,10396,10402,22,18,22,2,7,13,13,45,-32,11,33,13
20817,10396,10402,41,3,22,11,8,3,43,16,27,30,14,41
20818,10396,10402,20,6,22,10,3,9,37,34,3,23,21,33
20819,10396,10402,56,9,22,7,9,6,36,30,6,23,21,30
20820,10396,10402,12,13,22,5,7,10,25,32,-7,17,27,22
20821,10396,10402,53,14,22,5,7,10,25,35,-10,17,27,22
20822,10396,10402,17,11,22,6,5,11,15,33,-18,17,27,23
20823,10396,10402,27,12,22,4,11,7,19,31,-12,19,25,23
20824,10396,10402,1,4,22,11,7,4,42,21,21,29,15,40
20825,10396,10402,49,7,22,9,6,7,31,28,3,24,20,33
20826,10396,10402,37,10,22,7,5,10,24,30,-6,19,25,26
20827,10396,10402,21,5,22,10,8,4,40,26,14,28,16,38
20828,10396,10402,28,8,22,9,6,7,25,28,-3,24,20,33
20829,10396,10402,52,15,22,6,3,13,19,41,-22,15,29,21
20830,10396,10402,54,16,22,5,5,12,24,41,-17,15,29,20
20831,10224,10227,28,2,5,4,1,0,11,2,9,9,1,13
20832,10224,10227,54,17,5,0,0,5,5,14,-9,0,10,0
20833,10224,10227,52,18,5,0,0,5,0,10,-10,0,10,0
20834,10224,10227,21,3,5,4,1,0,12,4,8,9,1,13
20835,10224,10227,1,6,5,3,2,0,14,6,8,8,2,11
20836,10224,10227,27,14,5,0,2,3,1,11,-10,2,8,2
20837,10224,10227,12,9,5,2,2,1,6,3,3,6,4,8
20838,10224,10227,53,15,5,0,1,4,5,14,-9,1,9,1
20839,10224,10227,20,5,5,4,1,0,8,3,5,9,1,13
20840,10224,10227,41,7,5,3,2,0,11,3,8,8,2,11
20841,16213,16219,37,11,19,6,4,9,24,29,-5,16,22,22
20842,16213,16219,46,16,19,4,2,13,18,39,-21,10,28,14
20843,16220,16226,49,4,20,11,4,5,36,21,15,26,14,37
20844,16220,16226,37,11,20,6,4,10,26,34,-8,16,24,22
20845,16220,16226,46,17,20,4,2,14,18,40,-22,10,30,14
20846,16220,16226,57,13,20,6,3,11,28,53,-25,15,25,21
20847,16220,16226,4,7,20,10,3,7,31,24,7,23,17,33
20848,16220,16226,9,18,20,1,6,13,18,44,-26,8,32,9
20849,16220,16226,35,14,20,5,5,10,18,23,-5,15,25,20
20850,16220,16226,33,12,20,6,3,11,28,29,-1,15,25,21
20851,16220,16226,28,15,20,5,5,10,23,35,-12,15,25,20
20852,16220,16226,1,1,20,17,2,1,56,13,43,36,4,53
20853,16220,16226,25,8,20,9,2,9,21,31,-10,20,20,29
20854,16220,16226,12,9,20,8,5,7,25,25,0,21,19,29
20855,16220,16226,17,10,20,8,4,8,37,34,3,20,20,28
20856,16220,16226,42,16,20,4,3,13,24,37,-13,11,29,15
20857,16220,16226,43,2,20,15,2,3,46,21,25,32,8,47
20858,16220,16226,22,3,20,11,6,3,31,20,11,28,12,39
20859,16220,16226,40,6,20,10,4,6,31,19,12,24,16,34
20860,16220,16226,27,5,20,10,5,5,27,21,6,25,15,35
20861,16262,16268,43,2,25,17,4,4,53,24,29,38,12,55
20862,16262,16268,22,4,25,14,6,5,38,27,11,34,16,48
20863,16262,16268,40,8,25,10,6,9,33,24,9,26,24,36
20864,16262,16268,57,12,25,8,4,13,36,61,-25,20,30,28
20865,16262,16268,17,11,25,8,5,12,40,48,-8,21,29,29
20866,16262,16268,42,18,25,5,3,17,30,45,-15,13,37,18
20867,16262,16268,25,7,25,11,4,10,27,36,-9,26,24,37
20868,16262,16268,12,9,25,8,9,8,27,28,-1,25,25,33
20869,16262,16268,1,1,25,20,3,2,66,18,48,43,7,63
20870,16262,16268,33,14,25,6,6,13,32,37,-5,18,32,24
20871,16262,16268,28,15,25,6,6,13,28,41,-13,18,32,24
20872,16262,16268,27,6,25,12,7,6,30,25,5,31,19,43
20873,16262,16268,35,13,25,7,5,13,25,30,-5,19,31,26
20874,16262,16268,4,5,25,14,4,7,37,25,12,32,18,46
20875,16262,16268,9,17,25,4,7,14,24,48,-24,15,35,19
20876,16262,16268,49,3,25,15,5,5,42,21,21,35,15,50
20877,16262,16268,37,10,25,8,6,11,36,41,-5,22,28,30
20878,16262,16268,46,16,25,6,2,17,23,48,-25,14,36,20
20879,16318,16324,49,3,32,20,6,6,60,29,31,46,18,66
20880,16318,16324,37,14,32,8,7,17,41,55,-14,23,41,31
20881,16318,16324,46,15,32,9,3,20,30,57,-27,21,43,30
20882,16318,16324,43,2,32,22,6,4,71,31,40,50,14,72
20883,16318,16324,22,4,32,19,7,6,54,36,18,45,19,64
20884,16318,16324,57,8,32,12,5,15,43,69,-26,29,35,41
20885,16318,16324,40,9,32,11,8,13,41,36,5,30,34,41
20886,16318,16324,4,6,32,17,5,10,45,33,12,39,25,56
20887,16318,16324,9,18,32,6,8,18,30,59,-29,20,44,26
20888,16318,16324,35,11,32,10,6,16,30,43,-13,26,38,36
20889,16318,16324,27,5,32,18,7,7,45,31,14,43,21,61
20890,16318,16324,28,13,32,9,6,17,36,53,-17,24,40,33
20891,16318,16324,33,16,32,8,6,18,36,43,-7,22,42,30
20892,16318,16324,1,1,32,24,6,2,79,20,59,54,10,78
20893,16318,16324,12,7,32,11,11,10,35,34,1,33,31,44
20894,16318,16324,25,10,32,11,5,16,33,52,-19,27,37,38
20895,16318,16324,17,12,32,10,5,17,48,60,-12,25,39,35
20896,16318,16324,42,17,32,7,5,20,38,54,-16,19,45,26
20897,16325,16331,12,8,33,11,11,11,35,36,-1,33,33,44
20898,16325,16331,25,11,33,11,6,16,34,53,-19,28,38,39
20899,16325,16331,33,14,33,9,6,18,38,43,-5,24,42,33
20900,16325,16331,1,1,33,24,7,2,81,22,59,55,11,79
20901,16325,16331,35,10,33,11,6,16,33,44,-11,28,38,39
20902,16325,16331,4,6,33,17,5,11,45,36,9,39,27,56
20903,16325,16331,9,18,33,6,8,19,30,61,-31,20,46,26
20904,16325,16331,28,15,33,9,6,18,37,56,-19,24,42,33
20905,16325,16331,49,3,33,21,6,6,63,29,34,48,18,69
20906,16325,16331,46,13,33,10,3,20,32,58,-26,23,43,33
20907,16325,16331,37,16,33,8,8,17,42,56,-14,24,42,32
20908,16325,16331,27,5,33,18,7,8,45,33,12,43,23,61
20909,16325,16331,43,2,33,22,7,4,73,33,40,51,15,73
20910,16325,16331,22,4,33,20,7,6,56,36,20,47,19,67
20911,16325,16331,40,7,33,12,8,13,43,36,7,32,34,44
20912,16325,16331,57,9,33,12,5,16,44,71,-27,29,37,41
20913,16325,16331,17,12,33,11,5,17,50,60,-10,27,39,38
20914,16325,16331,42,17,33,7,5,21,38,56,-18,19,47,26
20915,16332,16408,17,10,34,12,5,17,57,60,-3,29,39,41
20916,16332,16408,42,18,34,7,5,22,39,58,-19,19,49,26
20917,16332,16408,43,2,34,23,7,4,75,34,41,53,15,76
20918,17760,17766,22,6,30,14,5,11,46,44,2,33,27,47
20919,17760,17766,57,9,30,12,5,13,42,47,-5,29,31,41
20920,17760,17766,24,11,30,10,10,10,39,44,-5,30,30,40
20921,17760,17766,51,16,30,8,6,16,30,50,-20,22,38,30
20922,17760,17766,32,17,30,6,3,21,30,73,-43,15,45,21
20923,17760,17766,49,2,30,21,4,5,59,25,34,46,14,67
20924,17760,17766,23,14,30,8,7,15,41,52,-11,23,37,31
20925,17760,17766,4,4,30,14,8,8,60,39,21,36,24,50
20926,17760,17766,1,3,30,17,5,8,53,42,11,39,21,56
20927,17760,17766,45,5,30,14,6,10,50,35,15,34,26,48
20928,17760,17766,27,13,30,9,7,14,36,45,-9,25,35,34
20929,17760,17766,42,18,30,3,8,19,30,51,-21,14,46,17
20930,18320,18326,12,7,13,6,4,3,18,18,0,16,10,22
20931,18320,18326,25,10,13,5,3,5,14,15,-1,13,13,18
20932,18320,18326,45,12,13,2,7,4,18,20,-2,11,15,13
20933,18320,18326,27,15,13,1,4,8,9,24,-15,6,20,7
20934,18320,18326,15,16,13,1,2,10,13,26,-13,4,22,5
20935,18320,18326,4,3,13,8,1,4,26,20,6,17,9,25
20936,18320,18326,49,4,13,7,3,3,26,17,9,17,9,24
20937,18320,18326,56,9,13,6,2,5,13,13,0,14,12,20
20938,18320,18326,35,11,13,3,4,6,10,19,-9,10,16,13
20939,18320,18326,1,8,13,6,2,5,28,19,9,14,12,20
20940,18320,18326,17,14,13,1,5,7,10,21,-11,7,19,8
20941,18320,18326,28,13,13,3,2,8,9,26,-17,8,18,11
20942,18320,18326,22,1,13,9,2,2,36,13,23,20,6,29
20943,18320,18326,43,2,13,8,3,2,27,9,18,19,7,27
20944,18320,18326,24,5,13,6,4,3,19,17,2,16,10,22
20945,18320,18326,57,6,13,6,4,3,18,17,1,16,10,22
20946,18411,18417,43,1,24,16,6,2,50,14,36,38,10,54
20947,18411,18417,22,2,24,15,6,3,58,24,34,36,12,51
20948,18411,18417,57,7,24,11,5,8,33,29,4,27,21,38
20949,18411,18417,24,8,24,10,7,7,26,26,0,27,21,37
20950,18411,18417,4,3,24,13,5,6,46,36,10,31,17,44
20951,18411,18417,56,9,24,10,4,10,28,27,1,24,24,34
20952,18411,18417,35,13,24,4,8,12,17,33,-16,16,32,20
20953,18411,18417,28,12,24,6,4,14,16,44,-28,16,32,22
20954,18411,18417,17,15,24,4,7,13,20,49,-29,15,33,19
20955,18411,18417,1,4,24,13,3,8,50,30,20,29,19,42
20956,18411,18417,49,6,24,12,3,9,43,30,13,27,21,39
20957,18411,18417,45,10,24,7,10,7,34,30,4,24,24,31
20958,18411,18417,15,14,24,5,4,15,25,44,-19,14,34,19
20959,18411,18417,27,16,24,2,5,17,14,46,-32,9,39,11
20960,18411,18417,12,5,24,11,8,5,35,30,5,30,18,41
20961,18411,18417,25,11,24,7,7,10,31,34,-3,21,27,28
20962,18453,18459,17,15,29,4,11,14,26,58,-32,19,39,23
20963,18453,18459,4,3,29,17,6,6,57,39,18,40,18,57
20964,18453,18459,1,4,29,16,4,9,60,35,25,36,22,52
20965,18453,18459,49,6,29,14,4,11,49,38,11,32,26,46
20966,18453,18459,56,10,29,11,4,14,34,37,-3,26,32,37
20967,18453,18459,35,13,29,5,11,13,24,39,-15,21,37,26
20968,18453,18459,28,12,29,8,5,16,20,49,-29,21,37,29
20969,18453,18459,12,5,29,12,11,6,41,36,5,35,23,47
20970,18453,18459,25,8,29,11,7,11,39,38,1,29,29,40
20971,18453,18459,45,11,29,7,11,11,37,39,-2,25,33,32
20972,18453,18459,15,14,29,5,8,16,28,48,-20,18,40,23
20973,18453,18459,27,16,29,4,6,19,18,52,-34,14,44,18
20974,18453,18459,43,1,29,18,8,3,55,18,37,44,14,62
20975,18453,18459,22,2,29,18,7,4,63,27,36,43,15,61
20976,18453,18459,24,7,29,12,9,8,32,30,2,33,25,45
20977,18453,18459,57,9,29,11,6,12,33,33,0,28,30,39
20978,18824,18830,28,16,29,3,10,16,31,58,-27,16,42,19
20979,18824,18830,43,1,29,19,7,3,59,25,34,45,13,64
20980,18824,18830,57,5,29,13,7,9,36,36,0,33,25,46
20981,18824,18830,22,6,29,12,7,10,57,43,14,31,27,43
20982,18824,18830,24,9,29,10,7,12,39,48,-9,27,31,37
20983,18824,18830,4,3,29,17,5,7,62,32,30,39,19,56
20984,18824,18830,45,13,29,6,12,11,31,36,-5,24,34,30
20985,18824,18830,12,8,29,10,11,8,47,40,7,31,27,41
20986,18824,18830,25,15,29,5,5,19,28,57,-29,15,43,20
20987,18824,18830,56,7,29,12,7,10,37,36,1,31,27,43
20988,18824,18830,35,10,29,9,9,11,45,49,-4,27,31,36
20989,18824,18830,49,4,29,13,9,7,41,32,9,35,23,48
20990,18824,18830,1,2,29,18,4,7,50,32,18,40,18,58
20991,18824,18830,42,11,29,8,9,12,48,54,-6,25,33,33
20992,18824,18830,17,12,29,6,13,10,24,35,-11,25,33,31
20993,18824,18830,16,14,29,6,8,15,35,57,-22,20,38,26
20994,19051,19054,1,4,13,6,4,3,30,22,8,16,10,22
20995,19051,19054,42,10,13,5,3,5,23,23,0,13,13,18
20996,11138,11151,28,15,26,4,10,12,19,35,-16,18,34,22
20997,11138,11151,52,18,26,4,8,14,20,40,-20,16,36,20
20998,11138,11151,35,5,26,13,6,7,47,32,15,32,20,45
20999,11138,11151,41,9,26,8,8,10,31,33,-2,24,28,32
21000,11138,11151,20,12,26,6,10,10,24,34,-10,22,30,28
21001,11138,11151,56,13,26,6,5,15,29,44,-15,17,35,23
21002,11138,11151,1,4,26,14,9,3,46,19,27,37,15,51
21003,11138,11151,17,16,26,4,9,13,14,35,-21,17,35,21
21004,11222,11305,17,12,34,9,11,14,26,41,-15,29,39,38
21005,11222,11305,1,4,34,18,11,5,61,27,34,47,21,65
21006,11222,11305,35,5,34,17,8,9,55,41,14,42,26,59
21007,11222,11305,41,9,34,11,10,13,42,45,-3,32,36,43
21008,11222,11305,20,13,34,8,12,14,33,45,-12,28,40,36
21009,11222,11305,56,14,34,10,5,19,41,57,-16,25,43,35
21010,11222,11305,52,11,34,10,8,16,40,45,-5,28,40,38
21011,11222,11305,28,17,34,6,10,18,30,51,-21,22,46,28
21012,11222,11305,27,10,34,9,15,10,36,36,0,33,35,42
21013,11222,11305,49,6,34,16,10,8,51,42,9,42,26,58
21014,11222,11305,12,8,34,12,8,14,41,45,-4,32,36,44
21015,11222,11305,53,18,34,5,5,24,33,72,-39,15,53,20
21016,11222,11305,4,3,34,20,7,7,67,37,30,47,21,67
21017,11222,11305,21,7,34,11,14,9,54,45,9,36,32,47
21018,11222,11305,43,1,34,23,7,4,74,22,52,53,15,76
21019,11222,11305,24,2,34,20,10,4,59,24,35,50,18,70
21020,11222,11305,22,15,34,9,8,17,31,66,-35,26,42,35
21021,11222,11305,57,16,34,9,7,18,40,73,-33,25,43,34
21022,11383,11389,43,1,12,8,3,1,22,6,16,19,5,27
21023,11383,11389,24,2,12,8,2,2,21,10,11,18,6,26
21024,11383,11389,57,7,12,5,4,3,23,24,-1,14,10,19
21025,11383,11389,22,14,12,3,2,7,9,15,-6,8,16,11
21026,11383,11389,20,6,12,6,1,5,19,16,3,13,11,19
21027,11383,11389,35,11,12,3,5,4,11,16,-5,11,13,14
21028,11383,11389,41,13,12,2,6,4,9,13,-4,10,14,12
21029,11383,11389,56,16,12,2,5,5,11,22,-11,9,15,11
21030,11383,11389,21,5,12,7,1,4,16,13,3,15,9,22
21031,11383,11389,4,10,12,4,4,4,20,21,-1,12,12,16
21032,11383,11389,17,8,12,5,3,4,18,19,-1,13,11,18
21033,11383,11389,1,3,12,7,3,2,29,12,17,17,7,24
21034,11383,11389,12,12,12,2,6,4,15,15,0,10,14,12
21035,11383,11389,49,4,12,6,5,1,20,9,11,17,7,23
21036,11383,11389,37,9,12,4,4,4,18,13,5,12,12,16
21037,11383,11389,34,18,12,1,3,8,4,21,-17,5,19,6
21038,11383,11389,52,15,12,3,2,7,12,21,-9,8,16,11
21039,11383,11389,27,17,12,1,3,8,6,17,-11,5,19,6
21040,11425,11452,27,18,17,1,7,9,10,23,-13,9,25,10
21041,11425,11452,41,10,17,4,8,5,17,18,-1,16,18,20
21042,11425,11452,35,11,17,4,8,5,14,20,-6,16,18,20
21043,11425,11452,56,16,17,3,6,8,17,34,-17,12,22,15
21044,11425,11452,52,15,17,4,4,9,15,26,-11,12,22,16
21045,11425,11452,1,3,17,9,6,2,34,15,19,24,10,33
21046,11425,11452,43,1,17,11,5,1,29,8,21,27,7,38
21047,11425,11452,24,2,17,11,3,3,28,11,17,25,9,36
21048,11425,11452,57,7,17,7,6,4,28,28,0,20,14,27
21049,11425,11452,22,14,17,4,4,9,13,21,-8,12,22,16
21050,11425,11452,34,17,17,2,4,11,7,27,-20,8,26,10
21051,11425,11452,12,12,17,4,7,6,24,22,2,15,19,19
21052,11425,11452,49,4,17,8,8,1,25,11,14,24,10,32
21053,11425,11452,37,13,17,4,6,7,21,22,-1,14,20,18
21054,11425,11452,17,9,17,6,5,6,23,26,-3,17,17,23
21055,11425,11452,21,5,17,9,1,7,23,19,4,19,15,28
21056,11425,11452,4,6,17,8,4,5,30,27,3,20,14,28
21057,11425,11452,20,8,17,7,2,8,24,24,0,16,18,23
21058,11782,11788,43,1,15,12,2,1,36,12,24,26,4,38
21059,11782,11788,24,3,15,9,0,6,26,21,5,18,12,27
21060,11782,11788,4,5,15,8,3,4,24,15,9,19,11,27
21061,11782,11788,21,8,15,7,1,7,26,28,-2,15,15,22
21062,11782,11788,49,2,15,10,2,3,31,19,12,22,8,32
21063,11782,11788,37,11,15,6,3,6,16,20,-4,15,15,21
21064,11782,11788,14,15,15,4,1,10,26,45,-19,9,21,13
21065,11782,11788,12,16,15,3,2,10,15,28,-13,8,22,11
21066,11782,11788,27,6,15,7,3,5,29,23,6,17,13,24
21067,11782,11788,57,10,15,6,3,6,37,34,3,15,15,21
21068,11782,11788,22,14,15,3,6,6,16,16,0,12,18,15
21069,11782,11788,20,4,15,8,3,4,42,22,20,19,11,27
21070,11782,11788,41,13,15,5,3,7,23,33,-10,13,17,18
21071,11782,11788,35,17,15,3,2,10,20,38,-18,8,22,11
21072,11782,11788,6,18,15,2,1,12,13,40,-27,5,25,7
21073,11782,11788,52,12,15,4,8,3,22,16,6,16,14,20
21074,16332,16408,22,4,34,21,7,6,59,37,22,49,19,70
21075,16332,16408,40,7,34,12,8,14,43,43,0,32,36,44
21076,16332,16408,57,11,34,12,5,17,45,74,-29,29,39,41
21077,16332,16408,27,5,34,19,7,8,47,34,13,45,23,64
21078,16332,16408,49,3,34,21,7,6,64,30,34,49,19,70
21079,16332,16408,46,15,34,10,3,21,32,60,-28,23,45,33
21080,16332,16408,37,16,34,8,8,18,43,59,-16,24,44,32
21081,16332,16408,33,13,34,10,6,18,40,43,-3,26,42,36
21082,16332,16408,28,14,34,10,6,18,40,58,-18,26,42,36
21083,16332,16408,4,6,34,18,5,11,46,36,10,41,27,59
21084,16332,16408,9,17,34,6,9,19,31,62,-31,21,47,27
21085,16332,16408,35,9,34,12,6,16,36,45,-9,30,38,42
21086,16332,16408,1,1,34,24,7,3,83,25,58,55,13,79
21087,16332,16408,12,8,34,11,11,12,36,38,-2,33,35,44
21088,16332,16408,25,12,34,11,6,17,34,54,-20,28,40,39
21089,16094,16100,12,8,7,3,2,2,9,7,2,8,6,11
21090,16094,16100,25,10,7,3,2,2,9,9,0,8,6,11
21091,16094,16100,1,1,7,6,1,0,21,3,18,13,1,19
21092,16094,16100,17,12,7,2,1,4,9,11,-2,5,9,7
21093,16094,16100,42,15,7,1,2,4,6,11,-5,4,10,5
21094,16094,16100,33,7,7,3,2,2,9,6,3,8,6,11
21095,16094,16100,28,16,7,1,2,4,3,9,-6,4,10,5
21096,16094,16100,27,5,7,4,0,3,8,9,-1,8,6,12
21097,16094,16100,4,3,7,5,0,2,13,10,3,10,4,15
21098,16094,16100,9,18,7,0,3,4,6,15,-9,3,11,3
21099,16094,16100,35,13,7,2,0,5,8,12,-4,4,10,6
21100,16094,16100,49,9,7,3,2,2,9,8,1,8,6,11
21101,16094,16100,37,14,7,1,3,3,6,8,-2,5,9,6
21102,16094,16100,46,17,7,1,1,5,5,13,-8,3,11,4
21103,16094,16100,43,2,7,5,0,2,14,7,7,10,4,15
21104,16094,16100,40,4,7,4,1,2,13,7,6,9,5,13
21105,16094,16100,22,6,7,3,3,1,6,5,1,9,5,12
21106,16094,16100,57,11,7,3,1,3,10,14,-4,7,7,10
21107,16101,16114,43,2,8,6,0,2,19,9,10,12,4,18
21108,16101,16114,40,4,8,5,1,2,15,7,8,11,5,16
21109,16101,16114,22,8,8,3,4,1,7,6,1,10,6,13
21110,16101,16114,57,11,8,3,1,4,12,19,-7,7,9,10
21111,16101,16114,49,5,8,4,2,2,11,8,3,10,6,14
21112,16101,16114,37,12,8,2,3,3,8,9,-1,7,9,9
21113,16101,16114,46,14,8,2,1,5,7,14,-7,5,11,7
21114,16101,16114,35,15,8,2,0,6,9,14,-5,4,12,6
21115,16101,16114,4,3,8,6,0,2,15,11,4,12,4,18
21116,16101,16114,9,18,8,0,3,5,7,17,-10,3,13,3
21117,16101,16114,27,7,8,4,1,3,10,11,-1,9,7,13
21118,16101,16114,33,9,8,3,2,3,9,8,1,8,8,11
21119,16101,16114,28,16,8,1,3,4,5,11,-6,5,11,6
21120,16101,16114,17,13,8,2,1,5,10,13,-3,5,11,7
21121,16101,16114,42,17,8,1,2,5,7,13,-6,4,12,5
21122,16101,16114,1,1,8,6,2,0,22,4,18,14,2,20
21123,16101,16114,12,5,8,4,2,2,11,8,3,10,6,14
21124,16101,16114,25,10,8,3,2,3,9,11,-2,8,8,11
21125,16416,16422,25,3,2,2,0,0,3,0,3,4,0,6
21126,16416,16422,12,4,2,1,1,0,3,1,2,3,1,4
21127,16416,16422,27,7,2,1,1,0,2,0,2,3,1,4
21128,16416,16422,45,8,2,1,0,1,4,3,1,2,2,3
21129,16416,16422,1,4,2,1,1,0,3,1,2,3,1,4
21130,16416,16422,35,15,2,0,0,2,0,3,-3,0,4,0
21131,16416,16422,4,13,2,0,1,1,2,4,-2,1,3,1
21132,16416,16422,49,2,2,2,0,0,5,2,3,4,0,6
21133,16416,16422,46,4,2,1,1,0,3,1,2,3,1,4
21134,16416,16422,37,15,2,0,0,2,0,3,-3,0,4,0
21135,16416,16422,28,9,2,1,0,1,1,1,0,2,2,3
21136,16416,16422,33,17,2,0,0,2,0,4,-4,0,4,0
21137,16416,16422,43,1,2,2,0,0,8,0,8,4,0,6
21138,16416,16422,51,9,2,1,0,1,1,1,0,2,2,3
21139,16416,16422,22,12,2,0,2,0,1,1,0,2,2,2
21140,16416,16422,40,14,2,0,1,1,1,7,-6,1,3,1
21141,16416,16422,57,17,2,0,0,2,0,4,-4,0,4,0
21142,16416,16422,17,11,2,1,0,1,2,3,-1,2,2,3
21143,16633,16639,43,1,27,16,7,4,58,25,33,39,15,55
21144,16633,16639,22,6,27,12,8,7,40,31,9,32,22,44
21145,16633,16639,51,11,27,8,9,10,39,36,3,25,29,33
21146,16633,16639,57,14,27,7,6,14,30,51,-21,20,34,27
21147,16633,16639,40,18,27,4,12,11,21,41,-20,20,34,24
21148,16633,16639,49,2,27,16,6,5,46,23,23,38,16,54
21149,16633,16639,46,10,27,9,10,8,26,25,1,28,26,37
21150,16633,16639,37,17,27,7,3,17,30,49,-19,17,37,24
21151,16633,16639,35,12,27,9,5,13,33,41,-8,23,31,32
21152,16633,16639,45,4,27,14,5,8,46,35,11,33,21,47
21153,16633,16639,27,9,27,10,7,10,31,32,-1,27,27,37
21154,16633,16639,4,5,27,13,5,9,36,30,6,31,23,44
21155,18971,18977,12,7,3,1,1,1,6,5,1,3,3,4
21156,18971,18977,42,4,3,1,2,0,8,5,3,4,2,5
21157,18971,18977,17,12,3,0,2,1,1,3,-2,2,4,2
21158,18971,18977,1,2,3,2,1,0,7,4,3,5,1,7
21159,19006,19012,42,10,7,2,2,3,16,15,1,6,8,8
21160,19006,19012,17,12,7,1,5,1,7,6,1,7,7,8
21161,19006,19012,56,5,7,3,2,2,7,7,0,8,6,11
21162,19006,19012,35,9,7,3,1,3,11,11,0,7,7,10
21163,19006,19012,16,14,7,1,4,2,10,13,-3,6,8,7
21164,19006,19012,49,7,7,3,1,3,16,13,3,7,7,10
21165,19006,19012,12,8,7,3,1,3,10,9,1,7,7,10
21166,19006,19012,43,3,7,3,4,0,11,6,5,10,4,13
21167,19006,19012,22,6,7,2,5,0,12,9,3,9,5,11
21168,19006,19012,24,11,7,2,2,3,12,12,0,6,8,8
21169,19006,19012,57,16,7,0,1,6,6,17,-11,1,13,1
21170,19006,19012,4,4,7,3,2,2,9,8,1,8,6,11
21171,19006,19012,1,1,7,5,2,0,18,9,9,12,2,17
21172,19006,19012,45,2,7,4,1,2,10,8,2,9,5,13
21173,19006,19012,27,13,7,2,1,4,9,16,-7,5,9,7
21174,19006,19012,10,15,7,1,2,4,6,11,-5,4,10,5
21175,19391,19404,1,2,10,8,2,0,20,6,14,18,2,26
21176,19391,19404,45,3,10,7,2,1,22,15,7,16,4,23
21177,19391,19404,27,9,10,3,3,4,11,14,-3,9,11,12
21178,19391,19404,10,13,10,1,5,4,7,11,-4,7,13,8
21179,19391,19404,22,4,10,6,2,2,18,10,8,14,6,20
21180,19391,19404,43,5,10,6,0,4,28,15,13,12,8,18
21181,19391,19404,57,11,10,2,3,5,7,19,-12,7,13,9
21182,19391,19404,24,12,10,2,2,6,9,17,-8,6,14,8
21183,19391,19404,4,8,10,3,4,3,11,15,-4,10,10,13
21184,19391,19404,9,15,10,1,3,6,7,17,-10,5,15,6
21185,19391,19404,12,6,10,5,1,4,20,17,3,11,9,16
21186,19391,19404,49,1,10,9,0,1,23,4,19,18,2,27
21187,19391,19404,16,14,10,1,4,5,8,15,-7,6,14,7
21188,19391,19404,56,7,10,5,1,4,13,12,1,11,9,16
21189,19391,19404,17,10,10,3,2,5,9,15,-6,8,12,11
21190,19391,19404,42,16,10,0,2,8,7,18,-11,2,18,2
21191,19496,19502,17,13,22,6,3,13,21,42,-21,15,29,21
21192,19496,19502,42,16,22,3,4,15,18,36,-18,10,34,13
21193,19496,19502,56,7,22,9,5,8,28,30,-2,23,21,32
21194,19496,19502,12,5,22,12,3,7,39,24,15,27,17,39
21195,19496,19502,45,4,22,12,8,2,42,27,15,32,12,44
21196,19496,19502,27,9,22,6,9,7,27,28,-1,21,23,27
21197,19496,19502,10,14,22,4,8,10,20,29,-9,16,28,20
21198,19496,19502,49,1,22,15,6,1,46,12,34,36,8,51
21199,19496,19502,16,15,22,4,7,11,24,36,-12,15,29,19
21200,19496,19502,4,8,22,7,6,9,25,30,-5,20,24,27
21201,19496,19502,9,12,22,6,4,12,21,35,-14,16,28,22
21202,19496,19502,43,2,22,14,2,6,48,24,24,30,14,44
21203,19496,19502,22,6,22,11,2,9,32,27,5,24,20,35
21204,19496,19502,57,10,22,7,5,10,21,37,-16,19,25,26
21205,19496,19502,24,11,22,6,5,11,28,40,-12,17,27,23
21206,19496,19502,1,3,22,13,5,4,37,20,17,31,13,44
21207,19503,19509,43,2,23,15,2,6,50,24,26,32,14,47
21208,19503,19509,22,6,23,11,2,10,33,29,4,24,22,35
21209,19503,19509,57,9,23,8,5,10,24,37,-13,21,25,29
21210,19503,19509,24,11,23,7,5,11,30,40,-10,19,27,26
21211,19503,19509,4,8,23,8,6,9,27,31,-4,22,24,30
21212,19503,19509,9,12,23,7,4,12,23,36,-13,18,28,25
21213,19503,19509,49,1,23,16,6,1,47,12,35,38,8,54
21214,19503,19509,16,14,23,5,7,11,25,36,-11,17,29,22
21215,19503,19509,45,4,23,12,8,3,42,28,14,32,14,44
21216,19503,19509,27,10,23,6,9,8,27,31,-4,21,25,27
21217,19503,19509,10,15,23,4,8,11,21,31,-10,16,30,20
21218,19503,19509,12,5,23,12,3,8,39,25,14,27,19,39
21219,19503,19509,56,7,23,9,5,9,31,34,-3,23,23,32
21220,19503,19509,17,13,23,7,3,13,25,45,-20,17,29,24
21221,19503,19509,42,16,23,3,4,16,18,38,-20,10,36,13
21222,19503,19509,1,3,23,13,5,5,37,22,15,31,15,44
21223,19510,19516,1,3,24,14,5,5,39,23,16,33,15,47
21224,19510,19516,17,11,24,8,3,13,27,45,-18,19,29,27
21225,19510,19516,42,16,24,3,4,17,19,40,-21,10,38,13
21226,19510,19516,56,8,24,9,6,9,32,35,-3,24,24,33
21227,19510,19516,12,5,24,12,4,8,40,26,14,28,20,40
21228,19510,19516,43,2,24,15,2,7,50,26,24,32,16,47
21229,19510,19516,22,6,24,12,2,10,35,29,6,26,22,38
21230,19510,19516,57,9,24,8,5,11,24,41,-17,21,27,29
21231,19510,19516,24,13,24,7,5,12,30,42,-12,19,29,26
21232,19510,19516,45,4,24,12,9,3,43,29,14,33,15,45
21233,19510,19516,27,12,24,6,9,9,27,32,-5,21,27,27
21234,8019,8022,52,5,1,1,0,0,2,1,1,2,0,3
21235,8019,8022,3,13,1,0,0,1,0,1,-1,0,2,0
21236,8019,8022,37,2,1,1,0,0,2,0,2,2,0,3
21237,8019,8022,21,2,1,1,0,0,2,0,2,2,0,3
21238,8019,8022,4,11,1,0,0,1,1,2,-1,0,2,0
21239,8019,8022,20,2,1,1,0,0,2,0,2,2,0,3
21240,8019,8022,41,9,1,0,1,0,0,0,0,1,1,1
21241,8019,8022,13,9,1,0,1,0,0,0,0,1,1,1
21242,8019,8022,56,16,1,0,0,1,0,2,-2,0,2,0
21243,8019,8022,53,7,1,1,0,0,1,0,1,2,0,3
21244,8019,8022,12,16,1,0,0,1,0,2,-2,0,2,0
21245,8019,8022,49,5,1,1,0,0,2,1,1,2,0,3
21246,8019,8022,17,7,1,1,0,0,1,0,1,2,0,3
21247,8019,8022,19,16,1,0,0,1,0,2,-2,0,2,0
21248,8107,8113,49,1,13,8,2,3,34,14,20,18,8,26
21249,8107,8113,37,3,13,6,5,2,32,10,22,17,9,23
21250,8107,8113,56,10,13,4,5,4,13,17,-4,13,13,17
21251,8107,8113,41,13,13,3,4,6,10,27,-17,10,16,13
21252,8107,8113,13,14,13,2,7,4,12,16,-4,11,15,13
21253,8107,8113,20,15,13,3,3,7,12,18,-6,9,17,12
21254,8107,8113,21,7,13,6,4,3,15,12,3,16,10,22
21255,8107,8113,4,8,13,5,6,2,19,14,5,16,10,21
21256,8107,8113,19,4,13,6,5,2,17,12,5,17,9,23
21257,8107,8113,17,11,13,4,3,6,13,20,-7,11,15,15
21258,8107,8113,43,2,13,7,3,3,26,15,11,17,9,24
21259,8107,8113,57,16,13,2,5,6,15,19,-4,9,17,11
21260,8107,8113,22,17,13,2,3,8,12,21,-9,7,19,9
21261,8107,8113,52,9,13,4,5,4,13,14,-1,13,13,17
21262,8107,8113,3,18,13,2,3,8,14,28,-14,7,19,9
21263,8107,8113,12,5,13,6,4,3,17,11,6,16,10,22
21264,8107,8113,53,12,13,4,3,6,19,29,-10,11,15,15
21265,8107,8113,1,6,13,6,4,3,17,13,4,16,10,22
21266,8170,8176,1,3,18,9,6,3,30,18,12,24,12,33
21267,8170,8176,43,2,18,10,5,3,37,21,16,25,11,35
21268,8170,8176,57,13,18,5,6,7,22,25,-3,16,20,21
21269,8170,8176,22,16,18,3,5,10,19,27,-8,11,25,14
21270,8170,8176,56,12,18,5,7,6,20,24,-4,17,19,22
21271,8170,8176,20,14,18,4,5,9,18,26,-8,13,23,17
21272,8170,8176,41,15,18,3,7,8,15,35,-20,13,23,16
21273,8170,8176,13,17,18,2,8,8,19,38,-19,12,24,14
21274,8170,8176,21,4,18,9,4,5,25,21,4,22,14,31
21275,8170,8176,4,9,18,6,8,4,27,24,3,20,16,26
21276,8170,8176,49,1,18,11,3,4,46,22,24,25,11,36
21277,8170,8176,37,8,18,6,8,4,38,20,18,20,16,26
21278,8170,8176,12,6,18,8,5,5,23,17,6,21,15,29
21279,8170,8176,53,11,18,6,5,7,26,34,-8,17,19,23
21280,8170,8176,52,7,18,7,6,5,21,17,4,20,16,27
21281,8170,8176,3,18,18,2,4,12,18,38,-20,8,28,10
21282,8170,8176,19,5,18,8,6,4,27,20,7,22,14,30
21283,8170,8176,17,10,18,7,4,7,21,25,-4,18,18,25
21284,8177,8183,19,5,19,8,6,5,28,23,5,22,16,30
21285,8177,8183,17,10,19,7,4,8,21,27,-6,18,20,25
21286,8177,8183,52,8,19,7,7,5,22,18,4,21,17,28
21287,8177,8183,3,18,19,3,4,12,21,40,-19,10,28,13
21288,8177,8183,12,6,19,8,5,6,24,19,5,21,17,29
21289,8177,8183,53,12,19,6,6,7,26,34,-8,18,20,24
21290,8177,8183,49,2,19,11,4,4,46,22,24,26,12,37
21291,8177,8183,37,9,19,6,8,5,39,22,17,20,18,26
21292,8177,8183,21,4,19,10,4,5,27,22,5,24,14,34
21293,8177,8183,4,7,19,7,8,4,29,25,4,22,16,29
21294,8177,8183,56,13,19,5,8,6,21,25,-4,18,20,23
21295,8177,8183,20,14,19,4,5,10,20,29,-9,13,25,17
21296,8177,8183,41,15,19,3,8,8,16,36,-20,14,24,17
21297,8177,8183,13,16,19,2,9,8,20,39,-19,13,25,15
21298,8177,8183,43,1,19,11,5,3,39,21,18,27,11,38
21299,8177,8183,57,11,19,6,6,7,25,26,-1,18,20,24
21300,8177,8183,22,17,19,3,5,11,20,30,-10,11,27,14
21301,8177,8183,1,3,19,10,6,3,33,19,14,26,12,36
21302,8219,8225,43,2,24,14,7,3,50,25,25,35,13,49
21303,8219,8225,57,13,24,6,7,11,27,36,-9,19,29,25
21304,8219,8225,22,17,24,3,6,15,22,44,-22,12,36,15
21305,8219,8225,52,9,24,8,9,7,26,23,3,25,23,33
21306,8219,8225,3,18,24,3,6,15,25,49,-24,12,36,15
21307,8219,8225,21,1,24,15,4,5,39,22,17,34,14,49
21308,8219,8225,4,7,24,9,10,5,37,30,7,28,20,37
21309,8219,8225,1,4,24,12,7,5,39,26,13,31,17,43
21310,8219,8225,56,10,24,8,9,7,31,29,2,25,23,33
21311,8219,8225,41,14,24,5,9,10,20,42,-22,19,29,24
21312,8219,8225,20,15,24,6,5,13,28,37,-9,17,31,23
21313,10224,10227,56,12,5,0,3,2,4,8,-4,3,7,3
21314,10224,10227,43,1,5,5,0,0,17,4,13,10,0,15
21315,10224,10227,24,3,5,4,1,0,12,4,8,9,1,13
21316,10224,10227,57,11,5,1,1,3,5,10,-5,3,7,4
21317,10224,10227,22,16,5,0,1,4,1,14,-13,1,9,1
21318,10224,10227,17,13,5,0,2,3,5,11,-6,2,8,2
21319,10224,10227,49,8,5,3,0,2,8,4,4,6,4,9
21320,10224,10227,37,10,5,1,2,2,7,7,0,4,6,5
21321,10242,10244,49,7,8,4,2,2,13,8,5,10,6,14
21322,10242,10244,37,9,8,2,2,4,10,10,0,6,10,8
21323,10242,10244,17,14,8,1,3,4,6,14,-8,5,11,6
21324,10242,10244,43,1,8,7,0,1,22,8,14,14,2,21
21325,10242,10244,24,3,8,6,2,0,19,7,12,14,2,20
21326,10242,10244,22,15,8,1,3,4,4,16,-12,5,11,6
21327,10242,10244,57,16,8,1,2,5,8,15,-7,4,12,5
21328,10242,10244,41,6,8,4,3,1,16,5,11,11,5,15
21329,10242,10244,20,8,8,4,2,2,11,10,1,10,6,14
21330,10242,10244,56,13,8,1,3,4,8,13,-5,5,11,6
21331,10242,10244,12,10,8,2,2,4,9,10,-1,6,10,8
21332,10242,10244,53,11,8,2,2,4,13,17,-4,6,10,8
21333,10242,10244,27,17,8,1,2,5,5,19,-14,4,12,5
21334,10242,10244,1,2,8,6,2,0,23,7,16,14,2,20
21335,10242,10244,21,4,8,6,1,1,20,10,10,13,3,19
21336,10242,10244,28,5,8,5,1,2,12,10,2,11,5,16
21337,10242,10244,52,12,8,2,1,5,5,13,-8,5,11,7
21338,10242,10244,54,18,8,0,1,7,9,21,-12,1,15,1
21339,10655,10661,12,6,11,4,4,3,13,14,-1,12,10,16
21340,10655,10661,53,15,11,2,5,4,8,16,-8,9,13,11
21341,10655,10661,27,12,11,4,1,6,14,14,0,9,13,13
21342,10655,10661,4,7,11,4,3,4,14,14,0,11,11,15
21343,10655,10661,37,8,11,4,3,4,13,16,-3,11,11,15
21344,10655,10661,49,11,11,3,5,3,13,12,1,11,11,14
21345,10655,10661,28,17,11,1,4,6,6,17,-11,6,16,7
21346,10655,10661,54,18,11,1,2,8,9,22,-13,4,18,5
21347,10655,10661,1,4,11,6,3,2,18,11,7,15,7,21
21348,10655,10661,17,9,11,4,3,4,14,19,-5,11,11,15
21349,10655,10661,43,1,11,8,3,0,27,3,24,19,3,27
21350,10655,10661,24,2,11,6,5,0,20,4,16,17,5,23
21351,10655,10661,57,3,11,7,1,3,18,12,6,15,7,22
21352,10655,10661,56,10,11,4,2,5,12,19,-7,10,12,14
21353,10655,10661,35,13,11,4,1,6,15,17,-2,9,13,13
21354,10655,10661,41,14,11,3,2,6,9,12,-3,8,14,11
21355,10655,10661,20,16,11,2,2,7,10,23,-13,6,16,8
21356,10655,10661,21,5,11,5,5,1,21,9,12,15,7,20
21357,10690,10696,21,4,16,7,7,2,34,18,16,21,11,28
21358,10690,10696,4,6,16,6,5,5,20,18,2,17,15,23
21359,10690,10696,56,10,16,5,6,5,16,21,-5,16,16,21
21360,10690,10696,35,11,16,6,2,8,21,22,-1,14,18,20
21361,10690,10696,41,14,16,4,5,7,13,15,-2,13,19,17
21362,10690,10696,20,16,16,3,4,9,17,31,-14,10,22,13
21363,10690,10696,49,9,16,5,7,4,19,17,2,17,15,22
21364,10690,10696,37,13,16,5,3,8,16,25,-9,13,19,18
21365,10690,10696,43,1,16,10,4,2,33,7,26,24,8,34
21366,10690,10696,24,3,16,8,8,0,28,4,24,24,8,32
21367,10690,10696,57,5,16,7,4,5,22,18,4,18,14,25
21368,10690,10696,17,8,16,6,4,6,20,29,-9,16,16,22
21369,10690,10696,12,7,16,6,5,5,20,22,-2,17,15,23
21370,10690,10696,53,15,16,3,6,7,10,24,-14,12,20,15
21371,10690,10696,1,2,16,10,4,2,29,15,14,24,8,34
21372,10690,10696,27,12,16,5,4,7,20,21,-1,14,18,19
21373,10690,10696,54,17,16,2,5,9,11,24,-13,9,23,11
21374,10690,10696,28,18,16,2,5,9,10,28,-18,9,23,11
21375,10697,10731,28,17,17,3,5,9,13,29,-16,11,23,14
21376,10697,10731,54,18,17,2,5,10,11,25,-14,9,25,11
21377,10697,10731,27,12,17,5,5,7,21,22,-1,15,19,20
21378,10697,10731,1,2,17,11,4,2,32,15,17,26,8,37
21379,10697,10731,12,8,17,6,6,5,21,23,-2,18,16,24
21380,10697,10731,53,15,17,3,6,8,10,27,-17,12,22,15
21381,10697,10731,17,9,17,6,4,7,21,32,-11,16,18,22
21382,10697,10731,43,1,17,11,4,2,34,7,27,26,8,37
21383,10697,10731,24,3,17,8,9,0,29,5,24,25,9,33
21384,10697,10731,57,5,17,8,4,5,26,19,7,20,14,28
21385,10697,10731,49,6,17,6,7,4,23,18,5,19,15,25
21386,10697,10731,37,13,17,5,3,9,17,29,-12,13,21,18
21387,10697,10731,56,10,17,5,7,5,16,21,-5,17,17,22
21388,10697,10731,35,11,17,6,2,9,22,26,-4,14,20,20
21389,10697,10731,41,14,17,4,5,8,13,16,-3,13,21,17
21390,10697,10731,20,16,17,3,5,9,18,32,-14,11,23,14
21391,10697,10731,21,4,17,8,7,2,35,18,17,23,11,31
21392,10697,10731,4,7,17,6,6,5,20,18,2,18,16,24
21393,16633,16639,25,7,27,11,6,10,35,34,1,28,26,39
21394,16633,16639,12,8,27,10,9,8,38,37,1,29,25,39
21395,16633,16639,1,3,27,14,9,4,41,25,16,37,17,51
21396,16633,16639,17,16,27,6,7,14,18,44,-26,19,35,25
21397,16633,16639,33,13,27,8,4,15,37,37,0,20,34,28
21398,16633,16639,28,15,27,6,8,13,29,38,-9,20,34,26
21399,16682,16765,17,17,34,8,8,18,22,52,-30,24,44,32
21400,16682,16765,1,3,34,18,10,6,51,33,18,46,22,64
21401,16682,16765,12,8,34,12,11,11,48,49,-1,35,33,47
21402,16682,16765,25,9,34,13,7,14,42,48,-6,33,35,46
21403,16682,16765,33,14,34,11,4,19,43,43,0,26,42,37
21404,16682,16765,28,15,34,8,10,16,36,49,-13,26,42,34
21405,16682,16765,35,7,34,13,8,13,45,45,0,34,34,47
21406,16682,16765,4,4,34,18,7,9,48,34,14,43,25,61
21407,16682,16765,49,2,34,19,8,7,51,28,23,46,22,65
21408,16682,16765,46,10,34,12,10,12,30,30,0,34,34,46
21409,16682,16765,37,16,34,9,6,19,35,55,-20,24,44,33
21410,16682,16765,43,1,34,20,10,4,72,27,45,50,18,70
21411,16682,16765,22,5,34,16,9,9,48,38,10,41,27,57
21412,16682,16765,51,12,34,10,11,13,44,42,2,31,37,41
21413,16682,16765,57,13,34,10,8,16,38,56,-18,28,40,38
21414,16682,16765,40,18,34,4,14,16,26,52,-26,22,46,26
21415,16682,16765,45,6,34,14,7,13,51,49,2,35,33,49
21416,16682,16765,27,11,34,11,12,11,39,39,0,34,34,45
21417,16857,16863,22,1,10,8,2,0,26,9,17,18,2,26
21418,16857,16863,43,2,10,7,2,1,21,11,10,16,4,23
21419,16857,16863,51,10,10,3,3,4,18,19,-1,9,11,12
21420,16857,16863,57,13,10,3,1,6,7,10,-3,7,13,10
21421,16857,16863,49,5,10,5,2,3,16,11,5,12,8,17
21422,16857,16863,46,11,10,3,3,4,11,12,-1,9,11,12
21423,16857,16863,37,14,10,3,1,6,7,15,-8,7,13,10
21424,16857,16863,4,8,10,4,3,3,16,19,-3,11,9,15
21425,16857,16863,33,9,10,4,2,4,17,20,-3,10,10,14
21426,16857,16863,28,17,10,2,1,7,11,17,-6,5,15,7
21427,16857,16863,27,4,10,5,4,1,15,11,4,14,6,19
21428,16857,16863,45,16,10,2,3,5,10,16,-6,7,13,9
21429,16857,16863,25,6,10,5,2,3,16,13,3,12,8,17
21430,16857,16863,12,15,10,2,4,4,8,13,-5,8,12,10
21431,16857,16863,35,7,10,4,3,3,12,9,3,11,9,15
21432,16857,16863,1,3,10,6,2,2,21,9,12,14,6,20
21433,16857,16863,42,12,10,3,3,4,9,11,-2,9,11,12
21434,16857,16863,17,18,10,0,1,9,4,20,-16,1,19,1
21435,16843,16856,42,11,9,3,2,4,9,11,-2,8,10,11
21436,16843,16856,17,18,9,0,1,8,4,18,-14,1,17,1
21437,16843,16856,1,4,9,5,2,2,16,8,8,12,6,17
21438,16843,16856,25,8,9,4,2,3,12,12,0,10,8,14
21439,16843,16856,12,14,9,2,4,3,7,9,-2,8,10,10
21440,16843,16856,33,7,9,4,2,3,16,15,1,10,8,14
21441,16843,16856,28,17,9,2,1,6,10,15,-5,5,13,7
21442,16843,16856,27,3,9,5,3,1,14,10,4,13,5,18
21443,16843,16856,45,16,9,2,2,5,10,16,-6,6,12,8
21444,16843,16856,4,9,9,4,2,3,13,16,-3,10,8,14
21445,16843,16856,35,5,9,4,2,3,11,8,3,10,8,14
21446,16843,16856,49,6,9,4,2,3,13,11,2,10,8,14
21447,16843,16856,46,10,9,3,2,4,8,9,-1,8,10,11
21448,16843,16856,37,13,9,3,1,5,7,12,-5,7,11,10
21449,16843,16856,22,1,9,7,2,0,24,8,16,16,2,23
21450,16843,16856,43,2,9,6,2,1,19,11,8,14,4,20
21451,16843,16856,57,12,9,3,1,5,7,9,-2,7,11,10
21452,16843,16856,51,15,9,2,3,4,17,19,-2,7,11,9
21453,17228,17234,49,2,12,7,5,0,27,10,17,19,5,26
21454,17228,17234,46,17,12,2,1,9,7,24,-17,5,19,7
21455,17228,17234,23,18,12,1,3,8,7,22,-15,5,19,6
21456,17228,17234,57,3,12,7,3,2,26,11,15,17,7,24
21457,17228,17234,43,4,12,6,5,1,19,11,8,17,7,23
21458,17228,17234,22,7,12,5,5,2,15,15,0,15,9,20
21459,17228,17234,51,12,12,3,5,4,12,21,-9,11,13,14
21460,17228,17234,24,15,12,1,5,6,14,21,-7,7,17,8
21461,17228,17234,35,9,12,5,3,4,16,13,3,13,11,18
21462,17228,17234,27,6,12,6,2,4,14,11,3,14,10,20
21463,17228,17234,45,11,12,4,3,5,15,18,-3,11,13,15
21464,17228,17234,4,10,12,4,5,3,22,15,7,13,11,17
21465,17228,17234,12,8,12,5,4,3,11,9,2,14,10,19
21466,17228,17234,25,13,12,3,3,6,13,13,0,9,15,12
21467,17228,17234,1,1,12,8,3,1,19,10,9,19,5,27
21468,17228,17234,42,14,12,2,3,7,12,19,-7,7,17,9
21469,17228,17234,33,5,12,6,3,3,20,12,8,15,9,21
21470,17228,17234,28,16,12,2,1,9,10,24,-14,5,19,7
21471,17186,17192,33,5,7,4,1,2,13,9,4,9,5,13
21472,19510,19516,10,15,24,4,9,11,22,32,-10,17,31,21
21473,19510,19516,49,1,24,17,6,1,51,12,39,40,8,57
21474,19510,19516,16,14,24,5,7,12,25,38,-13,17,31,22
21475,19510,19516,4,7,24,9,6,9,29,31,-2,24,24,33
21476,19510,19516,9,10,24,8,4,12,24,36,-12,20,28,28
21477,19342,19348,4,7,4,2,1,1,6,7,-1,5,3,7
21478,19342,19348,9,16,4,0,1,3,2,8,-6,1,7,1
21479,19342,19348,43,5,4,3,0,1,13,4,9,6,2,9
21480,19342,19348,22,8,4,2,0,2,8,6,2,4,4,6
21481,19342,19348,57,9,4,1,2,1,4,6,-2,4,4,5
21482,19342,19348,24,13,4,0,1,3,2,6,-4,1,7,1
21483,19342,19348,1,3,4,3,1,0,7,3,4,7,1,10
21484,19342,19348,49,1,4,4,0,0,8,0,8,8,0,12
21485,19342,19348,16,15,4,0,1,3,2,7,-5,1,7,1
21486,19342,19348,45,4,4,3,1,0,6,2,4,7,1,10
21487,19342,19348,27,10,4,1,1,2,4,6,-2,3,5,4
21488,19342,19348,10,11,4,0,3,1,2,5,-3,3,5,3
21489,19342,19348,56,6,4,2,1,1,6,5,1,5,3,7
21490,19342,19348,12,2,4,3,1,0,11,7,4,7,1,10
21491,19342,19348,42,12,4,0,1,3,3,7,-4,1,7,1
21492,19342,19348,17,14,4,0,1,3,3,8,-5,1,7,1
21493,19384,19390,56,7,9,4,1,4,12,12,0,9,9,13
21494,19384,19390,12,6,9,5,1,3,19,15,4,11,7,16
21495,19384,19390,49,1,9,9,0,0,23,3,20,18,0,27
21496,19384,19390,16,12,9,1,4,4,8,14,-6,6,12,7
21497,19384,19390,1,2,9,7,2,0,19,6,13,16,2,23
21498,19384,19390,43,4,9,6,0,3,28,14,14,12,6,18
21499,19384,19390,22,5,9,5,2,2,16,9,7,12,6,17
21500,19384,19390,24,10,9,2,2,5,8,15,-7,6,12,8
21501,19384,19390,57,14,9,1,3,5,5,18,-13,5,13,6
21502,19384,19390,4,8,9,3,4,2,10,13,-3,10,8,13
21503,19384,19390,9,13,9,1,3,5,7,15,-8,5,13,6
21504,19384,19390,45,3,9,6,2,1,21,15,6,14,4,20
21505,19384,19390,27,9,9,2,3,4,9,13,-4,7,11,9
21506,19384,19390,10,15,9,0,5,4,5,11,-6,5,13,5
21507,19384,19390,17,11,9,2,2,5,7,14,-7,6,12,8
21508,19384,19390,42,16,9,0,2,7,6,16,-10,2,16,2
21509,20203,20223,4,1,21,12,7,2,40,19,21,31,11,43
21510,20203,20223,28,11,21,7,4,10,22,30,-8,18,24,25
21511,20203,20223,38,14,21,5,6,10,28,34,-6,16,26,21
21512,20203,20223,49,8,21,8,4,9,28,36,-8,20,22,28
21513,20203,20223,16,15,21,5,4,12,28,38,-10,14,28,19
21514,20203,20223,45,5,21,9,6,6,37,34,3,24,18,33
21515,20203,20223,27,6,21,8,6,7,24,23,1,22,20,30
21516,20203,20223,10,13,21,7,3,11,28,39,-11,17,25,24
21517,20203,20223,43,2,21,11,8,2,35,17,18,30,12,41
21518,20203,20223,22,7,21,8,4,9,23,22,1,20,22,28
21519,20203,20223,24,10,21,7,4,10,31,37,-6,18,24,25
21520,20203,20223,9,4,21,11,5,5,38,23,15,27,15,38
21521,20203,20223,12,9,21,7,6,8,26,26,0,20,22,27
21522,20203,20223,25,16,21,3,7,11,22,43,-21,13,29,16
21523,20203,20223,56,12,21,6,7,8,21,27,-6,19,23,25
21524,20203,20223,1,3,21,13,1,7,42,25,17,27,15,40
21525,20539,20545,1,3,16,9,3,4,27,12,15,21,11,30
21526,20539,20545,9,2,16,9,4,3,34,18,16,22,10,31
21527,20539,20545,4,4,16,9,3,4,27,14,13,21,11,30
21528,20539,20545,56,9,16,6,6,4,26,25,1,18,14,24
21529,20539,20545,38,14,16,3,2,11,16,34,-18,8,24,11
21530,20539,20545,28,15,16,2,4,10,16,26,-10,8,24,10
21531,20539,20545,49,7,16,7,4,5,28,17,11,18,14,25
21532,20539,20545,12,12,16,4,3,9,13,21,-8,11,21,15
21533,20539,20545,25,16,16,2,4,10,18,39,-21,8,24,10
21534,20539,20545,43,6,16,8,4,4,33,18,15,20,12,28
21535,20539,20545,22,8,16,7,3,6,20,25,-5,17,15,24
21536,20539,20545,24,10,16,6,4,6,20,22,-2,16,16,22
21537,20539,20545,45,1,16,10,3,3,28,17,11,23,9,33
21538,20539,20545,27,5,16,8,6,2,20,14,6,22,10,30
21539,20539,20545,15,11,16,4,4,8,26,38,-12,12,20,16
21540,20539,20545,10,13,16,3,5,8,15,27,-12,11,21,14
21541,20616,20622,45,3,26,13,8,5,40,29,11,34,18,47
21542,20616,20622,27,5,26,12,7,7,31,27,4,31,21,43
21543,20616,20622,15,13,26,6,6,14,35,58,-23,18,34,24
21544,20616,20622,10,14,26,5,9,12,22,35,-13,19,33,24
21545,20616,20622,12,11,26,7,8,11,23,29,-6,22,30,29
21546,20616,20622,25,15,26,5,7,14,30,53,-23,17,35,22
21547,20616,20622,43,2,26,15,7,4,56,26,30,37,15,52
21548,20616,20622,24,6,26,12,5,9,33,29,4,29,23,41
21549,20616,20622,22,7,26,12,5,9,33,31,2,29,23,41
21550,20616,20622,49,9,26,10,9,7,42,32,10,29,23,39
21551,20616,20622,28,12,26,7,5,14,30,40,-10,19,33,26
21552,19051,19054,17,14,13,2,7,4,14,19,-5,11,15,13
21553,19051,19054,56,7,13,6,3,4,14,12,2,15,11,21
21554,19051,19054,35,12,13,4,2,7,17,24,-7,10,16,14
21555,19051,19054,12,6,13,6,3,4,22,18,4,15,11,21
21556,19051,19054,45,1,13,8,1,4,25,17,8,17,9,25
21557,19051,19054,27,13,13,4,1,8,14,27,-13,9,17,13
21558,19051,19054,10,16,13,1,4,8,11,25,-14,6,20,7
21559,19051,19054,43,2,13,7,4,2,25,12,13,18,8,25
21560,19051,19054,22,5,13,5,7,1,21,15,6,17,9,22
21561,19051,19054,24,11,13,5,2,6,22,20,2,12,14,17
21562,19051,19054,57,15,13,2,1,10,13,29,-16,5,21,7
21563,19051,19054,4,9,13,5,4,4,17,19,-2,14,12,19
21564,19051,19054,16,3,13,6,5,2,31,20,11,17,9,23
21565,19051,19054,49,8,13,6,1,6,25,22,3,13,13,19
21566,19090,19096,1,6,19,9,5,5,46,33,13,23,15,32
21567,19090,19096,43,1,19,13,4,2,47,16,31,30,8,43
21568,19090,19096,22,3,19,9,8,2,38,25,13,26,12,35
21569,19090,19096,24,10,19,6,5,8,28,29,-1,17,21,23
21570,19090,19096,57,16,19,3,3,13,23,41,-18,9,29,12
21571,19090,19096,45,2,19,11,4,4,30,19,11,26,12,37
21572,19090,19096,27,13,19,5,3,11,18,37,-19,13,25,18
21573,19090,19096,10,14,19,4,5,10,18,34,-16,13,25,17
21574,19090,19096,4,11,19,5,6,8,21,29,-8,16,22,21
21575,19090,19096,12,4,19,10,3,6,33,26,7,23,15,33
21576,19090,19096,56,7,19,8,4,7,22,19,3,20,18,28
21577,19090,19096,35,12,19,5,3,11,23,39,-16,13,25,18
21578,19090,19096,49,5,19,10,2,7,39,25,14,22,16,32
21579,19090,19096,16,9,19,6,9,4,35,28,7,21,17,27
21580,19090,19096,42,8,19,8,3,8,34,38,-4,19,19,27
21581,19090,19096,17,15,19,3,7,9,19,36,-17,13,25,16
21582,19181,19187,42,7,29,13,5,11,47,48,-1,31,27,44
21583,19181,19187,17,14,29,5,11,13,28,50,-22,21,37,26
21584,19181,19187,1,4,29,14,9,6,63,43,20,37,21,51
21585,19181,19187,16,10,29,8,11,10,46,51,-5,27,31,35
21586,19181,19187,56,9,29,11,5,13,31,30,1,27,31,38
21587,19181,19187,35,15,29,5,5,19,28,60,-32,15,43,20
21588,19181,19187,49,5,29,15,5,9,54,31,23,35,23,50
21589,19181,19187,12,6,29,13,9,7,51,38,13,35,23,48
21590,19181,19187,45,2,29,18,6,5,46,27,19,42,16,60
21591,19181,19187,27,12,29,9,4,16,27,49,-22,22,36,31
21592,19181,19187,10,13,29,7,9,13,28,46,-18,23,35,30
21593,19181,19187,4,11,29,8,9,12,32,39,-7,25,33,33
21594,19181,19187,43,1,29,20,6,3,68,26,42,46,12,66
21595,19181,19187,22,3,29,14,10,5,58,39,19,38,20,52
21596,19181,19187,24,8,29,12,5,12,42,39,3,29,29,41
21597,19181,19187,57,16,29,3,5,21,29,62,-33,11,47,14
21598,19020,19026,43,2,9,5,4,0,17,8,9,14,4,19
21599,19020,19026,22,3,9,4,5,0,16,11,5,13,5,17
21600,19020,19026,24,8,9,3,2,4,16,14,2,8,10,11
21601,19020,19026,57,16,9,1,1,7,7,21,-14,3,15,4
21602,19020,19026,4,5,9,4,3,2,13,11,2,11,7,15
21603,19020,19026,12,10,9,3,2,4,12,14,-2,8,10,11
21604,19020,19026,56,6,9,4,2,3,10,10,0,10,8,14
21605,19020,19026,35,7,9,4,1,4,13,13,0,9,9,13
21606,19020,19026,16,11,9,2,5,2,17,17,0,9,9,11
21607,19020,19026,49,12,9,3,1,5,18,17,1,7,11,10
21608,19020,19026,42,9,9,3,2,4,17,18,-1,8,10,11
21609,19020,19026,17,13,9,1,6,2,9,11,-2,8,10,9
21610,19020,19026,1,1,9,6,3,0,24,11,13,15,3,21
21611,19020,19026,45,4,9,5,1,3,16,12,4,11,7,16
21612,19020,19026,27,14,9,2,1,6,10,19,-9,5,13,7
21613,19020,19026,10,15,9,1,3,5,9,17,-8,5,13,6
21614,19321,19327,42,7,1,0,1,0,1,1,0,1,1,1
21615,19321,19327,17,12,1,0,0,1,1,2,-1,0,2,0
21616,19321,19327,1,2,1,1,0,0,2,0,2,2,0,3
21617,19321,19327,49,2,1,1,0,0,2,0,2,2,0,3
21618,19321,19327,16,13,1,0,0,1,0,1,-1,0,2,0
21619,19321,19327,12,4,1,1,0,0,3,2,1,2,0,3
21620,19321,19327,56,6,1,1,0,0,1,0,1,2,0,3
21621,19321,19327,45,5,1,1,0,0,2,1,1,2,0,3
21622,19321,19327,10,7,1,0,1,0,1,1,0,1,1,1
21623,19321,19327,27,14,1,0,0,1,0,2,-2,0,2,0
21624,19321,19327,4,7,1,0,1,0,1,1,0,1,1,1
21625,19321,19327,9,16,1,0,0,1,0,3,-3,0,2,0
21626,19321,19327,22,1,1,1,0,0,3,0,3,2,0,3
21627,19321,19327,57,7,1,0,1,0,1,1,0,1,1,1
21628,19321,19327,43,11,1,0,0,1,2,3,-1,0,2,0
21629,19321,19327,24,14,1,0,0,1,0,2,-2,0,2,0
21630,19412,19415,24,9,12,4,2,6,16,19,-3,10,14,14
21631,19412,19415,57,12,12,2,5,5,9,21,-12,9,15,11
21632,10767,10773,35,11,23,8,2,13,28,39,-11,18,28,26
21633,10767,10773,41,12,23,6,7,10,20,28,-8,19,27,25
21634,10767,10773,56,13,23,6,7,10,22,34,-12,19,27,25
21635,10767,10773,20,17,23,4,6,13,22,47,-25,14,32,18
21636,10767,10773,43,2,23,16,4,3,56,9,47,36,10,52
21637,10767,10773,24,3,23,12,10,1,44,9,35,34,12,46
21638,10767,10773,57,6,23,10,6,7,36,26,10,26,20,36
21639,10767,10773,49,5,23,10,8,5,32,22,10,28,18,38
21640,10767,10773,37,16,23,5,4,14,19,43,-24,14,32,19
21641,10767,10773,17,9,23,8,4,11,28,43,-15,20,26,28
21642,10767,10773,1,1,23,16,5,2,47,18,29,37,9,53
21643,10767,10773,27,10,23,7,6,10,29,33,-4,20,26,27
21644,10767,10773,21,4,23,11,8,4,47,22,25,30,16,41
21645,10767,10773,4,7,23,9,8,6,27,22,5,26,20,35
21646,10767,10773,12,8,23,9,7,7,27,37,-10,25,21,34
21647,10767,10773,53,14,23,6,6,11,21,39,-18,18,28,24
21648,10767,10773,28,15,23,5,7,11,18,34,-16,17,29,22
21649,10767,10773,54,18,23,3,7,13,17,35,-18,13,33,16
21650,10774,10780,28,15,24,5,7,12,18,37,-19,17,31,22
21651,10774,10780,54,17,24,4,7,13,18,35,-17,15,33,19
21652,10774,10780,12,8,24,9,7,8,27,39,-12,25,23,34
21653,10774,10780,53,12,24,7,6,11,23,39,-16,20,28,27
21654,10774,10780,21,4,24,12,8,4,49,22,27,32,16,44
21655,10774,10780,4,7,24,9,9,6,29,24,5,27,21,36
21656,10774,10780,27,11,24,7,7,10,32,36,-4,21,27,28
21657,10774,10780,1,1,24,17,5,2,52,19,33,39,9,56
21658,10774,10780,17,10,24,8,4,12,29,48,-19,20,28,28
21659,10774,10780,49,5,24,10,8,6,32,23,9,28,20,38
21660,10774,10780,37,16,24,5,4,15,19,46,-27,14,34,19
21661,10774,10780,43,2,24,17,4,3,59,9,50,38,10,55
21662,10774,10780,24,3,24,13,10,1,46,9,37,36,12,49
21663,10774,10780,57,6,24,10,7,7,39,29,10,27,21,37
21664,10774,10780,35,9,24,9,2,13,31,39,-8,20,28,29
21665,10774,10780,41,13,24,6,8,10,22,30,-8,20,28,26
21666,10774,10780,56,14,24,6,7,11,22,36,-14,19,29,25
21667,10774,10780,20,18,24,4,6,14,22,49,-27,14,34,18
21668,10823,10829,57,7,31,11,7,13,43,43,0,29,33,40
21669,10823,10829,56,8,31,11,7,13,35,43,-8,29,33,40
21670,10823,10829,35,10,31,10,6,15,38,49,-11,26,36,36
21671,10823,10829,41,14,31,7,11,13,28,40,-12,25,37,32
21672,10823,10829,20,16,31,7,8,16,32,58,-26,22,40,29
21673,10823,10829,17,9,31,11,6,14,40,59,-19,28,34,39
21674,10823,10829,49,4,31,14,10,7,49,28,21,38,24,52
21675,10823,10829,37,17,31,6,7,18,26,56,-30,19,43,25
21676,10823,10829,43,2,31,22,4,5,69,17,52,48,14,70
21677,10823,10829,24,3,31,17,12,2,61,12,49,46,16,63
21678,10823,10829,53,12,31,9,9,13,31,47,-16,27,35,36
21679,10823,10829,12,13,31,9,9,13,33,58,-25,27,35,36
21680,10823,10829,1,1,31,23,6,2,71,19,52,52,10,75
21681,10823,10829,27,11,31,9,9,13,39,47,-8,27,35,36
21682,10823,10829,21,5,31,13,12,6,56,32,24,38,24,51
21683,10823,10829,4,6,31,11,12,8,41,34,7,34,28,45
21684,10823,10829,28,15,31,7,10,14,23,42,-19,24,38,31
21685,10823,10829,54,18,31,5,9,17,27,58,-31,19,43,24
21686,10620,10626,12,9,7,3,1,3,12,14,-2,7,7,10
21687,10620,10626,53,11,7,2,3,2,7,9,-2,7,7,9
21688,10620,10626,43,1,7,5,2,0,20,3,17,12,2,17
21689,10620,10626,24,2,7,5,2,0,14,2,12,12,2,17
21690,10620,10626,57,4,7,4,0,3,10,10,0,8,6,12
21691,10620,10626,27,7,7,3,1,3,9,7,2,7,7,10
21692,10620,10626,21,5,7,3,3,1,13,6,7,9,5,12
21693,10620,10626,4,8,7,3,1,3,10,11,-1,7,7,10
21694,10620,10626,49,10,7,2,4,1,10,6,4,8,6,10
21695,10620,10626,37,12,7,2,3,2,7,10,-3,7,7,9
21696,10620,10626,28,17,7,0,3,4,2,12,-10,3,11,3
21697,10620,10626,54,18,7,0,1,6,6,15,-9,1,13,1
21698,10620,10626,1,6,7,3,3,1,12,8,4,9,5,12
21699,10620,10626,56,3,7,4,1,2,12,12,0,9,5,13
21700,10620,10626,20,13,7,2,2,3,8,12,-4,6,8,8
21701,10620,10626,35,14,7,2,1,4,9,10,-1,5,9,7
21702,10620,10626,41,16,7,1,2,4,2,6,-4,4,10,5
21703,10620,10626,17,15,7,1,3,3,4,14,-10,5,9,6
21704,11040,11046,17,17,15,2,6,7,8,20,-12,10,20,12
21705,11040,11046,35,8,15,5,5,5,23,23,0,15,15,20
21706,11040,11046,41,10,15,4,5,6,18,19,-1,13,17,17
21707,11040,11046,20,11,15,4,4,7,15,24,-9,12,18,16
21708,11040,11046,56,14,15,4,2,9,18,29,-11,10,20,14
21709,11040,11046,12,6,15,6,4,5,21,16,5,16,14,22
21710,17186,17192,28,18,7,0,0,7,5,15,-10,0,14,0
21711,17186,17192,42,12,7,2,1,4,9,11,-2,5,9,7
21712,17186,17192,1,7,7,3,3,1,10,8,2,9,5,12
21713,17186,17192,12,9,7,3,2,2,7,6,1,8,6,11
21714,17186,17192,25,13,7,2,1,4,3,6,-3,5,9,7
21715,17186,17192,4,6,7,3,3,1,15,8,7,9,5,12
21716,17186,17192,27,8,7,3,2,2,9,6,3,8,6,11
21717,17186,17192,45,10,7,3,2,2,9,10,-1,8,6,11
21718,17186,17192,35,11,7,2,2,3,6,7,-1,6,8,8
21719,17186,17192,43,2,7,4,3,0,12,6,6,11,3,15
21720,17186,17192,22,3,7,4,2,1,9,9,0,10,4,14
21721,17186,17192,57,4,7,4,1,2,14,9,5,9,5,13
21722,17186,17192,51,14,7,1,4,2,5,9,-4,6,8,7
21723,17186,17192,24,17,7,0,3,4,5,11,-6,3,11,3
21724,17186,17192,49,1,7,6,1,0,21,6,15,13,1,19
21725,17186,17192,23,15,7,1,2,4,5,13,-8,4,10,5
21726,17186,17192,46,16,7,1,1,5,4,12,-8,3,11,4
21727,17606,17612,43,4,12,7,2,3,29,16,13,16,8,23
21728,17606,17612,22,6,12,6,3,3,18,13,5,15,9,21
21729,17606,17612,57,9,12,5,1,6,16,19,-3,11,13,16
21730,17606,17612,32,15,12,3,1,8,12,22,-10,7,17,10
21731,17606,17612,24,16,12,2,4,6,12,22,-10,8,16,10
21732,17606,17612,51,18,12,1,3,8,7,20,-13,5,19,6
21733,17606,17612,56,13,12,3,4,5,10,19,-9,10,14,13
21734,17606,17612,35,17,12,1,6,5,12,16,-4,8,16,9
21735,17606,17612,49,2,12,7,3,2,20,12,8,17,7,24
21736,17606,17612,23,12,12,3,4,5,16,21,-5,10,14,13
21737,17606,17612,33,5,12,6,3,3,19,13,6,15,9,21
21738,17606,17612,4,7,12,5,4,3,24,15,9,14,10,19
21739,17606,17612,27,10,12,4,3,5,14,17,-3,11,13,15
21740,17606,17612,45,11,12,4,2,6,15,16,-1,10,14,14
21741,17606,17612,25,3,12,7,3,2,19,14,5,17,7,24
21742,17606,17612,12,8,12,4,7,1,15,9,6,15,9,19
21743,17606,17612,1,1,12,7,4,1,22,11,11,18,6,25
21744,17606,17612,42,14,12,2,5,5,9,14,-5,9,15,11
21745,17746,17752,42,18,28,3,8,17,28,47,-19,14,42,17
21746,17746,17752,33,9,28,11,8,9,38,35,3,30,26,41
21747,17746,17752,1,3,28,16,5,7,50,39,11,37,19,53
21748,17746,17752,25,6,28,13,7,8,37,30,7,33,23,46
21749,17746,17752,12,8,28,10,12,6,33,24,9,32,24,42
21750,17746,17752,45,7,28,12,6,10,43,33,10,30,26,42
21751,17746,17752,27,13,28,8,7,13,34,42,-8,23,33,31
21752,17746,17752,4,5,28,13,7,8,56,37,19,33,23,46
21753,17746,17752,32,17,28,5,3,20,26,68,-42,13,43,18
21754,17746,17752,49,2,28,19,4,5,55,25,30,42,14,61
21755,17746,17752,23,16,28,6,7,15,36,50,-14,19,37,25
21756,17746,17752,35,11,28,9,9,10,37,34,3,27,29,36
21757,17746,17752,56,14,28,7,10,11,29,43,-14,24,32,31
21758,17746,17752,43,1,28,19,4,5,63,28,35,42,14,61
21759,17746,17752,22,4,28,14,4,10,44,41,3,32,24,46
21760,17746,17752,24,10,28,9,10,9,38,43,-5,28,28,37
21761,17746,17752,57,12,28,10,5,13,37,46,-9,25,31,35
21762,17746,17752,51,15,28,7,6,15,28,47,-19,20,36,27
21763,17781,17787,35,12,33,11,9,13,44,41,3,31,35,42
21764,17781,17787,56,15,33,8,11,14,34,54,-20,27,39,35
21765,17781,17787,23,14,33,9,8,16,43,56,-13,26,40,35
21766,17781,17787,49,2,33,23,5,5,65,26,39,51,15,74
21767,17781,17787,43,1,33,23,5,5,73,30,43,51,15,74
21768,17781,17787,22,8,33,15,5,13,48,49,-1,35,31,50
21769,17781,17787,57,9,33,13,5,15,46,52,-6,31,35,44
21770,17781,17787,24,11,33,11,10,12,43,52,-9,32,34,43
21771,17781,17787,51,16,33,8,6,19,32,57,-25,22,44,30
21772,17781,17787,32,17,33,6,6,21,34,77,-43,18,48,24
21773,17781,17787,4,3,33,17,8,8,67,41,26,42,24,59
21774,17781,17787,45,5,33,15,7,11,52,36,16,37,29,52
21775,17781,17787,27,13,33,11,7,15,41,47,-6,29,37,40
21776,17781,17787,25,6,33,15,7,11,41,35,6,37,29,52
21777,17781,17787,12,7,33,13,12,8,40,29,11,38,28,51
21778,17781,17787,1,4,33,17,5,11,55,49,6,39,27,56
21779,17781,17787,33,10,33,12,8,13,41,45,-4,32,34,44
21780,17781,17787,42,18,33,3,10,20,31,54,-23,16,50,19
21781,17564,17577,25,6,7,3,2,2,6,8,-2,8,6,11
21782,17564,17577,12,9,7,2,4,1,8,5,3,8,6,10
21783,17564,17577,27,13,7,2,1,4,6,10,-4,5,9,7
21784,17564,17577,45,13,7,2,1,4,6,10,-4,5,9,7
21785,17564,17577,1,1,7,5,2,0,12,3,9,12,2,17
21786,17564,17577,33,4,7,4,1,2,13,9,4,9,5,13
21787,17564,17577,49,3,7,5,1,1,13,7,6,11,3,16
21788,17564,17577,23,16,7,1,2,4,8,13,-5,4,10,5
21789,7148,7154,59,18,28,2,4,22,17,74,-57,8,48,10
21790,6966,6972,52,3,7,5,1,1,8,4,4,11,3,16
21791,6966,6972,48,13,7,1,4,2,8,10,-2,6,8,7
21792,6966,6972,59,11,7,2,2,3,7,10,-3,6,8,8
21793,6966,6972,27,12,7,2,1,4,4,13,-9,5,9,7
21794,6966,6972,12,1,7,6,1,0,13,2,11,13,1,19
21795,6966,6972,53,6,7,3,4,0,9,6,3,10,4,13
21796,6966,6972,57,2,7,5,1,1,15,7,8,11,3,16
21797,6966,6972,43,7,7,4,0,3,17,11,6,8,6,12
21798,6966,6972,22,10,7,2,3,2,5,9,-4,7,7,9
21799,6966,6972,20,14,7,1,4,2,6,9,-3,6,8,7
21800,6966,6972,41,17,7,0,2,5,4,15,-11,2,12,2
21801,6966,6972,49,4,7,4,3,0,16,9,7,11,3,15
21802,6966,6972,37,9,7,2,3,2,9,9,0,7,7,9
21803,6966,6972,21,16,7,0,3,4,2,7,-5,3,11,3
21804,6966,6972,1,5,7,4,1,2,12,4,8,9,5,13
21805,6966,6972,17,8,7,3,0,4,15,11,4,6,8,9
21806,6966,6972,8,15,7,1,1,5,9,10,-1,3,11,4
21807,6966,6972,19,18,7,0,2,5,4,17,-13,2,12,2
21808,7407,7434,17,8,16,6,5,5,30,24,6,17,15,23
21809,7407,7434,52,6,16,8,2,6,22,23,-1,18,14,26
21810,7407,7434,48,15,16,4,5,7,17,29,-12,13,19,17
21811,7407,7434,21,9,16,6,5,5,24,29,-5,17,15,23
21812,7407,7434,4,12,16,5,4,7,23,23,0,14,18,19
21813,7407,7434,43,1,16,13,1,2,35,12,23,27,5,40
21814,7407,7434,22,10,16,7,1,8,21,23,-2,15,17,22
21815,7407,7434,57,13,16,5,4,7,23,31,-8,14,18,19
21816,7407,7434,37,2,16,11,3,2,31,11,20,25,7,36
21817,7407,7434,49,3,16,9,4,3,34,20,14,22,10,31
21818,7407,7434,56,7,16,7,2,7,23,25,-2,16,16,23
21819,7407,7434,20,11,16,6,3,7,22,24,-2,15,17,21
21820,7407,7434,41,17,16,3,2,11,20,28,-8,8,24,11
21821,7407,7434,12,4,16,9,2,5,27,17,10,20,12,29
21822,7407,7434,53,18,16,3,2,11,14,28,-14,8,24,11
21823,7407,7434,19,14,16,5,2,9,29,39,-10,12,20,17
21824,7407,7434,8,16,16,3,3,10,19,37,-18,9,23,12
21825,7407,7434,1,5,16,8,2,6,35,26,9,18,14,26
21826,7449,7455,1,6,19,9,2,8,39,29,10,20,18,29
21827,7449,7455,12,4,19,10,3,6,38,20,18,23,15,33
21828,7449,7455,53,18,19,3,3,13,16,32,-16,9,29,12
21829,7449,7455,52,5,19,10,2,7,29,28,1,22,16,32
21830,7449,7455,48,16,19,4,6,9,19,44,-25,14,24,18
21831,7449,7455,20,10,19,7,5,7,23,24,-1,19,19,26
21832,7449,7455,56,12,19,7,3,9,24,31,-7,17,21,24
21833,7449,7455,41,14,19,5,3,11,29,31,-2,13,25,18
21834,7449,7455,43,1,19,15,2,2,38,12,26,32,6,47
21835,7449,7455,22,9,19,8,2,9,23,29,-6,18,20,26
21836,7449,7455,57,13,19,6,4,9,30,38,-8,16,22,22
21837,7449,7455,37,2,19,12,4,3,33,15,18,28,10,40
21838,7449,7455,49,3,19,11,5,3,39,23,16,27,11,38
21839,7449,7455,21,8,19,7,6,6,27,31,-4,20,18,27
21840,7449,7455,4,11,19,7,4,8,33,28,5,18,20,25
21841,7449,7455,17,7,19,7,7,5,33,25,8,21,17,28
21842,7449,7455,8,15,19,5,3,11,25,42,-17,13,25,18
21843,7449,7455,19,17,19,5,2,12,33,49,-16,12,26,17
21844,7305,7308,17,11,2,0,2,0,2,2,0,2,2,2
21845,7305,7308,8,12,2,0,1,1,3,4,-1,1,3,1
21846,7305,7308,19,18,2,0,0,2,2,6,-4,0,4,0
21847,7305,7308,4,13,2,0,1,1,0,1,-1,1,3,1
21848,7305,7308,21,14,2,0,1,1,1,5,-4,1,3,1
21849,7305,7308,37,4,2,2,0,0,3,1,2,4,0,6
21850,7305,7308,49,6,2,1,1,0,4,3,1,3,1,4
21851,7305,7308,12,8,2,1,0,1,2,2,0,2,2,3
21852,7305,7308,53,16,2,0,0,2,2,5,-3,0,4,0
21853,7305,7308,48,3,2,2,0,0,5,1,4,4,0,6
21854,7305,7308,52,7,2,1,1,0,3,2,1,3,1,4
21855,7305,7308,43,1,2,2,0,0,9,3,6,4,0,6
21856,7305,7308,57,2,2,2,0,0,7,3,4,4,0,6
21857,7305,7308,22,15,2,0,0,2,2,4,-2,0,4,0
21858,7305,7308,20,8,2,1,0,1,2,2,0,2,2,3
21859,7305,7308,56,10,2,1,0,1,4,6,-2,2,2,3
21860,7305,7308,41,17,2,0,0,2,1,4,-3,0,4,0
21861,7305,7308,1,5,2,1,1,0,2,0,2,3,1,4
21862,7463,7469,1,5,21,10,3,8,48,31,17,23,19,33
21863,7463,7469,52,6,21,10,3,8,30,30,0,23,19,33
21864,7463,7469,48,16,21,4,7,10,20,49,-29,15,27,19
21865,7463,7469,12,4,21,11,4,6,43,22,21,26,16,37
21866,7463,7469,53,18,21,4,4,13,19,33,-14,12,30,16
21867,7463,7469,19,15,21,6,2,13,37,51,-14,14,28,20
21868,7463,7469,8,17,21,5,3,13,26,47,-21,13,29,18
21869,20616,20622,38,16,26,5,3,18,24,48,-24,13,39,18
21870,20616,20622,56,10,26,8,6,12,36,49,-13,22,30,30
21871,20616,20622,1,1,26,16,4,6,46,19,27,36,16,52
21872,20616,20622,9,4,26,13,6,7,45,31,14,32,20,45
21873,20616,20622,4,8,26,11,7,8,35,25,10,29,23,40
21874,20637,20643,9,4,29,14,7,8,50,35,15,35,23,49
21875,20637,20643,4,7,29,13,8,8,42,29,13,34,24,47
21876,20637,20643,1,1,29,18,4,7,54,22,32,40,18,58
21877,20637,20643,56,10,29,8,7,14,38,53,-15,23,35,31
21878,20637,20643,28,14,29,8,5,16,33,46,-13,21,37,29
21879,20637,20643,38,16,29,6,3,20,27,53,-26,15,43,21
21880,20637,20643,49,9,29,10,11,8,45,36,9,31,27,41
21881,20637,20643,43,2,29,17,7,5,64,30,34,41,17,58
21882,20637,20643,24,5,29,14,6,9,41,33,8,34,24,48
21883,20637,20643,22,8,29,13,6,10,36,35,1,32,26,45
21884,20637,20643,12,12,29,7,9,13,24,34,-10,23,35,30
21885,20637,20643,25,15,29,5,8,16,33,61,-28,18,40,23
21886,20637,20643,45,3,29,14,9,6,46,37,9,37,21,51
21887,20637,20643,27,6,29,13,9,7,34,29,5,35,23,48
21888,20637,20643,15,11,29,8,6,15,39,61,-22,22,36,30
21889,20637,20643,10,13,29,7,9,13,28,40,-12,23,35,30
21890,20434,20440,45,1,3,3,0,0,6,0,6,6,0,9
21891,20434,20440,27,3,3,2,1,0,3,1,2,5,1,7
21892,20434,20440,15,12,3,1,0,2,2,6,-4,2,4,3
21893,20434,20440,10,14,3,0,1,2,2,5,-3,1,5,1
21894,20434,20440,43,2,3,2,1,0,7,2,5,5,1,7
21895,20434,20440,22,8,3,1,1,1,4,4,0,3,3,4
21896,20434,20440,24,9,3,1,1,1,2,2,0,3,3,4
21897,20434,20440,49,7,3,1,1,1,4,3,1,3,3,4
21898,20434,20440,56,13,3,0,2,1,2,6,-4,2,4,2
21899,20434,20440,9,5,3,2,0,1,4,3,1,4,2,6
21900,20434,20440,4,6,3,1,2,0,3,2,1,4,2,5
21901,20434,20440,12,11,3,1,0,2,3,2,1,2,4,3
21902,20434,20440,25,15,3,0,1,2,3,7,-4,1,5,1
21903,20434,20440,1,4,3,2,0,1,3,1,2,4,2,6
21904,20434,20440,28,10,3,1,1,1,1,2,-1,3,3,4
21905,20434,20440,38,16,3,0,0,3,2,5,-3,0,6,0
21906,20483,20496,1,3,9,5,1,3,13,8,5,11,7,16
21907,20483,20496,12,11,9,3,1,5,8,12,-4,7,11,10
21908,20483,20496,25,14,9,2,1,6,11,21,-10,5,13,7
21909,20483,20496,38,12,9,3,0,6,13,18,-5,6,12,9
21910,20483,20496,28,13,9,2,2,5,10,13,-3,6,12,8
21911,20483,20496,56,7,9,4,2,3,16,14,2,10,8,14
21912,20483,20496,4,6,9,4,3,2,14,9,5,11,7,15
21913,20483,20496,9,8,9,4,2,3,12,11,1,10,8,14
21914,20483,20496,49,5,9,4,3,2,12,6,6,11,7,15
21915,20483,20496,43,2,9,5,3,1,18,10,8,13,5,18
21916,20483,20496,22,9,9,4,1,4,11,13,-2,9,9,13
21917,20483,20496,24,10,9,3,3,3,11,10,1,9,9,12
21918,20483,20496,45,1,9,6,2,1,18,7,11,14,4,20
21919,20483,20496,27,4,9,4,4,1,11,8,3,12,6,16
21920,20483,20496,15,15,9,2,1,6,11,22,-11,5,13,7
21921,20483,20496,10,16,9,1,3,5,8,15,-7,5,13,6
21922,20784,20790,15,16,1,0,0,1,0,5,-5,0,2,0
21923,20784,20790,12,15,1,0,0,1,0,4,-4,0,2,0
21924,20784,20790,22,6,1,0,1,0,3,3,0,1,1,1
21925,20784,20790,24,8,1,0,1,0,1,1,0,1,1,1
21926,20784,20790,49,8,1,0,1,0,1,1,0,1,1,1
21927,20784,20790,56,13,1,0,0,1,0,1,-1,0,2,0
21928,20784,20790,28,3,1,1,0,0,3,2,1,2,0,3
21929,20784,20790,38,4,1,1,0,0,1,0,1,2,0,3
21930,20784,20790,45,1,1,1,0,0,5,0,5,2,0,3
21931,20784,20790,27,4,1,1,0,0,1,0,1,2,0,3
21932,20784,20790,10,6,1,0,1,0,3,3,0,1,1,1
21933,20784,20790,1,2,1,1,0,0,4,0,4,2,0,3
21934,20784,20790,21,10,1,0,1,0,0,0,0,1,1,1
21935,20784,20790,4,12,1,0,0,1,2,3,-1,0,2,0
21936,20784,20790,9,13,1,0,0,1,0,1,-1,0,2,0
21937,20784,20790,43,10,1,0,1,0,0,0,0,1,1,1
21938,20872,20874,43,4,12,6,3,3,17,14,3,15,9,21
21939,20872,20874,22,8,12,4,5,3,20,17,3,13,11,17
21940,20872,20874,24,16,12,1,5,6,14,22,-8,7,17,8
21941,20872,20874,21,5,12,5,4,3,18,15,3,14,10,19
21942,20872,20874,1,1,12,10,0,2,26,11,15,20,4,30
21943,20872,20874,28,2,12,7,2,3,14,12,2,16,8,23
21944,20872,20874,38,7,12,5,3,4,19,20,-1,13,11,18
21945,20872,20874,12,11,12,4,3,5,17,18,-1,11,13,15
21946,20872,20874,4,12,12,3,4,5,15,13,2,10,14,13
21947,20872,20874,9,15,12,2,2,8,13,20,-7,6,18,8
21948,20872,20874,56,13,12,2,4,6,13,20,-7,8,16,10
21949,20872,20874,27,3,12,6,4,2,19,14,5,16,8,22
21950,19412,19415,22,2,12,8,2,2,24,10,14,18,6,26
21951,19412,19415,43,5,12,7,1,4,31,16,15,15,9,22
21952,19412,19415,45,4,12,7,4,1,24,17,7,18,6,25
21953,19412,19415,27,10,12,3,5,4,14,17,-3,11,13,14
21954,19412,19415,10,15,12,1,5,6,9,17,-8,7,17,8
21955,19412,19415,12,7,12,6,2,4,24,19,5,14,10,20
21956,19412,19415,56,6,12,7,1,4,18,13,5,15,9,22
21957,19412,19415,49,1,12,9,2,1,26,7,19,20,4,29
21958,19412,19415,16,13,12,2,4,6,14,21,-7,8,16,10
21959,19412,19415,1,3,12,8,2,2,21,12,9,18,6,26
21960,19412,19415,42,16,12,0,2,10,7,21,-14,2,22,2
21961,19412,19415,17,11,12,3,2,7,9,21,-12,8,16,11
21962,19412,19415,4,8,12,3,6,3,14,18,-4,12,12,15
21963,19412,19415,9,14,12,2,3,7,9,20,-11,7,17,9
21964,19685,19691,17,4,1,1,0,0,2,0,2,2,0,3
21965,19685,19691,1,4,1,1,0,0,2,0,2,2,0,3
21966,19685,19691,49,1,1,1,0,0,3,0,3,2,0,3
21967,19685,19691,56,13,1,0,0,1,0,2,-2,0,2,0
21968,19685,19691,25,7,1,1,0,0,1,0,1,2,0,3
21969,19685,19691,12,10,1,0,0,1,0,1,-1,0,2,0
21970,19685,19691,24,2,1,1,0,0,3,1,2,2,0,3
21971,19685,19691,43,2,1,1,0,0,3,1,2,2,0,3
21972,19685,19691,57,8,1,0,1,0,0,0,0,1,1,1
21973,19685,19691,22,11,1,0,0,1,1,3,-2,0,2,0
21974,19685,19691,45,4,1,1,0,0,2,0,2,2,0,3
21975,19685,19691,10,13,1,0,0,1,0,2,-2,0,2,0
21976,19685,19691,27,16,1,0,0,1,0,3,-3,0,2,0
21977,19685,19691,4,8,1,0,1,0,0,0,0,1,1,1
21978,19685,19691,9,13,1,0,0,1,0,2,-2,0,2,0
21979,19685,19691,38,11,1,0,0,1,1,3,-2,0,2,0
21980,19916,20048,43,3,30,16,9,5,51,30,21,41,19,57
21981,19916,20048,22,7,30,13,10,7,38,28,10,36,24,49
21982,19916,20048,24,9,30,10,11,9,37,39,-2,31,29,41
21983,19916,20048,57,15,30,6,6,18,21,45,-24,18,42,24
21984,19916,20048,4,2,30,16,9,5,52,29,23,41,19,57
21985,19916,20048,9,10,30,11,5,14,40,52,-12,27,33,38
21986,19916,20048,27,6,30,14,7,9,44,31,13,35,25,49
21987,19916,20048,45,12,30,8,7,15,41,54,-13,23,37,31
21988,19916,20048,10,14,30,7,5,18,30,49,-19,19,41,26
21989,19916,20048,12,8,30,10,12,8,38,32,6,32,28,42
21990,19916,20048,25,11,30,8,9,13,42,63,-21,25,35,33
21991,19916,20048,38,13,30,7,5,18,32,51,-19,19,41,26
21992,19916,20048,56,5,30,16,3,11,54,35,19,35,25,51
21993,19916,20048,49,4,30,16,5,9,49,39,10,37,23,53
21994,19916,20048,1,1,30,17,10,3,69,28,41,44,16,61
21995,19916,20048,17,16,30,5,7,18,30,63,-33,17,43,22
21996,20182,20188,1,1,18,12,1,5,37,18,19,25,11,37
21997,20182,20188,49,11,18,6,4,8,22,32,-10,16,20,22
21998,20182,20188,16,15,18,4,3,11,22,33,-11,11,25,15
21999,20182,20188,56,6,18,6,7,5,19,17,2,19,17,25
22000,20182,20188,12,10,18,6,4,8,21,22,-1,16,20,22
22001,20182,20188,25,16,18,2,6,10,19,40,-21,10,26,12
22002,20182,20188,43,4,18,9,7,2,28,14,14,25,11,34
22003,20182,20188,22,7,18,7,3,8,20,21,-1,17,19,24
22004,20182,20188,24,12,18,6,3,9,27,33,-6,15,21,21
22005,20182,20188,45,5,18,7,5,6,33,32,1,19,17,26
22006,20182,20188,27,9,18,6,6,6,20,20,0,18,18,24
22007,20182,20188,10,13,18,6,3,9,24,34,-10,15,21,21
22008,20182,20188,28,8,18,7,3,8,20,23,-3,17,19,24
22009,20182,20188,38,14,18,4,6,8,25,29,-4,14,22,18
22010,20182,20188,4,2,18,10,7,1,35,17,18,27,9,37
22011,20182,20188,9,3,18,10,4,4,33,20,13,24,12,34
22012,20084,20097,43,1,6,4,1,1,11,6,5,9,3,13
22013,20084,20097,22,6,6,3,1,2,8,6,2,7,5,10
22014,20084,20097,24,10,6,2,1,3,8,12,-4,5,7,7
22015,20084,20097,45,4,6,3,1,2,9,5,4,7,5,10
22016,20084,20097,10,7,6,3,1,2,11,10,1,7,5,10
22017,20084,20097,27,13,6,1,3,2,4,7,-3,5,7,6
22018,20084,20097,9,2,6,4,1,1,11,7,4,9,3,13
22019,20084,20097,4,8,6,2,4,0,6,4,2,8,4,10
22020,20084,20097,12,14,6,1,2,3,6,8,-2,4,8,5
22021,20084,20097,25,15,6,1,2,3,6,10,-4,4,8,5
22022,20084,20097,56,9,6,2,2,2,5,5,0,6,6,8
22023,20084,20097,28,5,6,3,1,2,8,5,3,7,5,10
22024,20084,20097,38,16,6,0,2,4,6,12,-6,2,10,2
22025,20084,20097,49,11,6,2,1,3,7,13,-6,5,7,7
22026,20084,20097,16,12,6,2,0,4,7,10,-3,4,8,6
22027,20084,20097,1,3,6,3,1,2,13,6,7,7,5,10
22028,20518,20531,1,4,14,7,3,4,20,11,9,17,11,24
22029,20518,20531,56,7,14,6,5,3,25,21,4,17,11,23
22030,17564,17577,56,7,7,3,2,2,7,10,-3,8,6,11
22031,17564,17577,35,15,7,1,4,2,7,6,1,6,8,7
22032,17564,17577,4,10,7,2,3,2,15,11,4,7,7,9
22033,17564,17577,42,12,7,2,1,4,8,12,-4,5,9,7
22034,17564,17577,43,2,7,5,1,1,16,6,10,11,3,16
22035,17564,17577,22,5,7,4,1,2,10,8,2,9,5,13
22036,17564,17577,57,8,7,3,1,3,11,11,0,7,7,10
22037,17564,17577,24,11,7,2,2,3,9,10,-1,6,8,8
22038,17564,17577,32,17,7,1,1,5,5,13,-8,3,11,4
22039,17564,17577,51,18,7,0,2,5,3,11,-8,2,12,2
22040,17865,17871,35,7,1,0,1,0,1,1,0,1,1,1
22041,17865,17871,56,14,1,0,0,1,0,2,-2,0,2,0
22042,17865,17871,49,5,1,0,1,0,2,2,0,1,1,1
22043,17865,17871,24,1,1,1,0,0,4,1,3,2,0,3
22044,17865,17871,43,3,1,1,0,0,2,0,2,2,0,3
22045,17865,17871,51,7,1,0,1,0,1,1,0,1,1,1
22046,17865,17871,22,11,0,0,0,0,0,0,0,0,0,0
22047,17865,17871,57,13,1,0,0,1,1,3,-2,0,2,0
22048,17865,17871,45,7,1,0,1,0,1,1,0,1,1,1
22049,17865,17871,27,12,1,0,0,1,1,2,-1,0,2,0
22050,17865,17871,4,2,1,1,0,0,3,1,2,2,0,3
22051,17865,17871,12,7,1,0,1,0,1,1,0,1,1,1
22052,17865,17871,25,15,1,0,0,1,1,4,-3,0,2,0
22053,17865,17871,1,4,1,1,0,0,2,1,1,2,0,3
22054,17865,17871,28,5,1,0,1,0,2,2,0,1,1,1
22055,18341,18347,28,12,16,4,2,10,11,33,-22,10,22,14
22056,18341,18347,56,9,16,7,3,6,19,17,2,17,15,24
22057,18341,18347,35,13,16,3,4,9,10,25,-15,10,22,13
22058,18341,18347,49,6,16,8,3,5,28,22,6,19,13,27
22059,18341,18347,1,8,16,7,3,6,32,22,10,17,15,24
22060,18341,18347,12,4,16,8,5,3,26,21,5,21,11,29
22061,18341,18347,25,10,16,6,5,5,20,20,0,17,15,23
22062,18341,18347,45,11,16,4,8,4,24,21,3,16,16,20
22063,18341,18347,15,14,16,3,2,11,19,29,-10,8,24,11
22064,18341,18347,27,16,16,1,4,11,10,30,-20,6,26,7
22065,18341,18347,22,1,16,11,3,2,43,15,28,25,7,36
22066,18341,18347,43,2,16,10,4,2,32,12,20,24,8,34
22067,18341,18347,24,5,16,8,4,4,23,20,3,20,12,28
22068,18341,18347,57,7,16,7,4,5,19,21,-2,18,14,25
22069,18341,18347,4,3,16,9,2,5,32,26,6,20,12,29
22070,18341,18347,17,15,16,1,6,9,13,27,-14,8,24,9
22071,18236,18242,17,15,2,0,0,2,1,5,-4,0,4,0
22072,18236,18242,4,9,2,1,0,1,1,4,-3,2,2,3
22073,18236,18242,56,5,2,1,1,0,2,1,1,3,1,4
22074,18236,18242,35,13,2,0,1,1,1,2,-1,1,3,1
22075,18236,18242,22,1,2,2,0,0,6,1,5,4,0,6
22076,18236,18242,24,2,2,2,0,0,4,1,3,4,0,6
22077,18236,18242,43,4,2,1,1,0,4,1,3,3,1,4
22078,18236,18242,57,10,2,0,2,0,1,1,0,2,2,2
22079,18236,18242,28,8,2,1,0,1,2,4,-2,2,2,3
22080,18236,18242,49,3,2,1,1,0,5,2,3,3,1,4
22081,18236,18242,27,10,2,0,2,0,1,1,0,2,2,2
22082,18236,18242,45,12,2,0,1,1,2,3,-1,1,3,1
22083,18236,18242,15,15,2,0,0,2,1,5,-4,0,4,0
22084,18236,18242,1,6,2,1,0,1,4,2,2,2,2,3
22085,18236,18242,25,7,2,1,0,1,1,1,0,2,2,3
22086,18236,18242,12,14,2,0,1,1,1,3,-2,1,3,1
22087,18397,18403,12,3,22,11,8,3,34,26,8,30,14,41
22088,18397,18403,25,11,22,6,7,9,27,32,-5,19,25,25
22089,18397,18403,1,5,22,11,3,8,45,29,16,25,19,36
22090,18397,18403,17,15,22,3,7,12,19,46,-27,13,31,16
22091,18397,18403,28,12,22,6,3,13,15,40,-25,15,29,21
22092,18397,18403,45,10,22,7,10,5,34,26,8,24,20,31
22093,18397,18403,15,14,22,4,4,14,22,40,-18,12,32,16
22094,18397,18403,27,16,22,2,4,16,14,45,-31,8,36,10
22095,18397,18403,49,6,22,11,3,8,41,27,14,25,19,36
22096,18397,18403,43,1,22,15,5,2,48,14,34,35,9,50
22097,18397,18403,22,2,22,13,6,3,54,22,32,32,12,45
22098,18397,18403,57,7,22,10,5,7,29,27,2,25,19,35
22099,18397,18403,24,8,22,10,5,7,26,26,0,25,19,35
22100,18397,18403,56,9,22,9,4,9,24,23,1,22,22,31
22101,18397,18403,35,13,22,3,8,11,14,32,-18,14,30,17
22102,18397,18403,4,4,22,12,4,6,43,34,9,28,16,40
22103,18271,18277,4,5,6,4,1,1,9,8,1,9,3,13
22104,18271,18277,56,3,6,4,1,1,7,3,4,9,3,13
22105,18271,18277,35,13,6,1,2,3,2,7,-5,4,8,5
22106,18271,18277,28,8,6,2,1,3,3,8,-5,5,7,7
22107,18271,18277,22,1,6,5,1,0,21,5,16,11,1,16
22108,18271,18277,43,2,6,4,2,0,13,1,12,10,2,14
22109,18271,18277,24,3,6,4,1,1,7,3,4,9,3,13
22110,18271,18277,57,11,6,1,3,2,5,9,-4,5,7,6
22111,18271,18277,49,6,6,3,2,1,11,6,5,8,4,11
22112,11782,11788,1,7,15,7,3,5,17,12,5,17,13,24
22113,11782,11788,17,9,15,6,4,5,23,20,3,16,14,22
22114,12139,12145,1,2,15,8,6,1,25,11,14,22,8,30
22115,12139,12145,27,3,15,8,2,5,24,18,6,18,12,26
22116,12139,12145,52,13,15,4,2,9,17,26,-9,10,20,14
22117,12139,12145,13,4,15,7,5,3,23,11,12,19,11,26
22118,12139,12145,6,6,15,6,5,4,21,19,2,17,13,23
22119,12139,12145,35,7,15,5,6,4,20,19,1,16,14,21
22120,12139,12145,41,14,15,2,8,5,12,23,-11,12,18,14
22121,12139,12145,20,16,15,3,3,9,15,29,-14,9,21,12
22122,12139,12145,43,1,15,12,2,1,42,17,25,26,4,38
22123,12139,12145,24,8,15,4,8,3,20,15,5,16,14,20
22124,12139,12145,57,15,15,3,4,8,22,34,-12,10,20,13
22125,12139,12145,22,18,15,1,5,9,20,37,-17,7,23,8
22126,12139,12145,49,11,15,5,4,6,15,11,4,14,16,19
22127,12139,12145,37,12,15,4,7,4,17,17,0,15,15,19
22128,12139,12145,21,5,15,6,6,3,19,16,3,18,12,24
22129,12139,12145,9,9,15,4,8,3,21,19,2,16,14,20
22130,12139,12145,4,10,15,4,8,3,20,21,-1,16,14,20
22131,12139,12145,17,17,15,1,7,7,13,23,-10,9,21,10
22132,12237,12250,17,15,26,5,11,10,24,33,-9,21,31,26
22133,12237,12250,21,5,26,12,9,5,39,30,9,33,19,45
22134,12237,12250,9,7,26,7,13,6,35,33,2,27,25,34
22135,12237,12250,4,13,26,6,10,10,37,44,-7,22,30,28
22136,12237,12250,49,6,26,10,9,7,30,17,13,29,23,39
22137,12237,12250,37,11,26,7,9,10,32,34,-2,23,29,30
22138,12237,12250,43,1,26,17,6,3,58,26,32,40,12,57
22139,12237,12250,24,9,26,7,12,7,29,31,-2,26,26,33
22140,12237,12250,57,12,26,7,9,10,41,49,-8,23,29,30
22141,12237,12250,22,18,26,3,7,16,31,62,-31,13,39,16
22142,12237,12250,52,16,26,6,7,13,24,35,-11,19,33,25
22143,12237,12250,13,4,26,13,9,4,44,22,22,35,17,48
22144,12237,12250,6,8,26,8,9,9,33,34,-1,25,27,33
22145,12237,12250,35,10,26,8,8,10,36,36,0,24,28,32
22146,12237,12250,41,14,26,6,9,11,27,44,-17,21,31,27
22147,12237,12250,20,17,26,4,6,16,24,49,-25,14,38,18
22148,12237,12250,27,3,26,15,4,7,48,33,15,34,18,49
22149,12237,12250,1,2,26,14,11,1,35,15,20,39,13,53
22150,12258,12271,1,2,28,16,11,1,41,15,26,43,13,59
22151,12258,12271,27,4,28,15,4,9,49,40,9,34,22,49
22152,12258,12271,13,3,28,13,11,4,44,22,22,37,19,50
22153,12258,12271,6,8,28,9,9,10,35,41,-6,27,29,36
22154,12258,12271,35,9,28,9,8,11,40,41,-1,26,30,35
22155,12258,12271,41,13,28,7,10,11,33,46,-13,24,32,31
22156,12258,12271,20,17,28,4,7,17,26,52,-26,15,41,19
22157,12258,12271,52,14,28,7,8,13,28,38,-10,22,34,29
22158,12258,12271,43,1,28,19,6,3,68,29,39,44,12,63
22159,12258,12271,24,10,28,7,14,7,30,32,-2,28,28,35
22160,12258,12271,57,11,28,8,9,11,42,51,-9,25,31,33
22161,12258,12271,22,18,28,3,8,17,31,66,-35,14,42,17
22162,12258,12271,49,6,28,11,9,8,37,18,19,31,25,42
22163,12258,12271,37,12,28,7,10,11,32,35,-3,24,32,31
22164,12258,12271,21,5,28,12,11,5,39,30,9,35,21,47
22165,12258,12271,9,7,28,8,14,6,36,33,3,30,26,38
22166,12258,12271,4,16,28,6,10,12,37,50,-13,22,34,28
22167,12258,12271,17,15,28,6,11,11,25,34,-9,23,33,29
22168,12272,12278,17,15,29,6,12,11,25,34,-9,24,34,30
22169,12272,12278,21,5,29,12,11,6,39,31,8,35,23,47
22170,12272,12278,9,7,29,9,14,6,40,33,7,32,26,41
22171,12272,12278,4,16,29,6,11,12,37,50,-13,23,35,29
22172,12272,12278,49,6,29,11,10,8,37,18,19,32,26,43
22173,12272,12278,37,11,29,8,10,11,34,35,-1,26,32,34
22174,12272,12278,43,1,29,19,7,3,68,29,39,45,13,64
22175,12272,12278,24,10,29,7,14,8,32,35,-3,28,30,35
22176,12272,12278,57,12,29,8,10,11,43,52,-9,26,32,34
22177,12272,12278,22,18,29,3,8,18,31,70,-39,14,44,17
22178,12272,12278,52,14,29,7,9,13,28,38,-10,23,35,30
22179,12272,12278,13,3,29,13,12,4,44,22,22,38,20,51
22180,12272,12278,6,8,29,9,10,10,35,41,-6,28,30,37
22181,12272,12278,35,9,29,9,9,11,41,42,-1,27,31,36
22182,12272,12278,41,13,29,8,10,11,36,48,-12,26,32,34
22183,12272,12278,20,17,29,4,7,18,26,54,-28,15,43,19
22184,12272,12278,27,4,29,15,5,9,49,40,9,35,23,50
22185,12272,12278,1,2,29,17,11,1,42,15,27,45,13,62
22186,12044,12047,27,2,4,3,1,0,8,4,4,7,1,10
22187,12044,12047,6,3,4,2,1,1,7,5,2,5,3,7
22188,12044,12047,13,5,4,2,0,2,6,3,3,4,4,6
22189,12044,12047,35,9,4,1,2,1,5,4,1,4,4,5
22190,11040,11046,53,13,15,4,3,8,22,33,-11,11,19,15
22191,11040,11046,1,3,15,8,5,2,22,13,9,21,9,29
22192,11040,11046,27,12,15,3,7,5,16,18,-2,13,17,16
22193,11040,11046,49,5,15,7,7,1,25,15,10,21,9,28
22194,11040,11046,52,16,15,3,3,9,16,28,-12,9,21,12
22195,11040,11046,28,18,15,2,5,8,12,26,-14,9,21,11
22196,11040,11046,4,1,15,11,4,0,36,14,22,26,4,37
22197,11040,11046,21,7,15,5,7,3,28,20,8,17,13,22
22198,11040,11046,43,2,15,10,3,2,41,11,30,23,7,33
22199,11040,11046,24,4,15,8,4,3,30,17,13,20,10,28
22200,11040,11046,57,9,15,5,4,6,19,22,-3,14,16,19
22201,11040,11046,22,15,15,3,4,8,13,35,-22,10,20,13
22202,11096,11102,24,5,20,10,7,3,35,19,16,27,13,37
22203,11096,11102,57,11,20,6,5,9,23,34,-11,17,23,23
22204,11096,11102,22,12,20,5,4,11,19,46,-27,14,26,19
22205,11096,11102,4,1,20,14,5,1,47,19,28,33,7,47
22206,11096,11102,49,4,20,11,7,2,32,19,13,29,11,40
22207,11096,11102,27,10,20,5,10,5,20,18,2,20,20,25
22208,11096,11102,21,8,20,6,9,5,35,28,7,21,19,27
22209,11096,11102,43,2,20,14,4,2,50,13,37,32,8,46
22210,11096,11102,12,7,20,8,4,8,26,23,3,20,20,28
22211,11096,11102,53,15,20,4,4,12,24,43,-19,12,28,16
22212,11096,11102,28,16,20,3,7,10,15,30,-15,13,27,16
22213,11096,11102,52,18,20,3,5,12,16,32,-16,11,29,14
22214,11096,11102,1,3,20,11,7,2,30,16,14,29,11,40
22215,11096,11102,35,6,20,9,5,6,38,28,10,23,17,32
22216,11096,11102,41,9,20,6,7,7,24,23,1,19,21,25
22217,11096,11102,20,13,20,4,7,9,18,30,-12,15,25,19
22218,11096,11102,56,17,20,4,3,13,20,37,-17,11,29,15
22219,11096,11102,17,14,20,3,8,9,10,24,-14,14,26,17
22220,10998,11004,17,15,9,2,2,5,6,14,-8,6,12,8
22221,10998,11004,12,8,9,3,2,4,10,10,0,8,10,11
22222,10998,11004,53,14,9,2,3,4,14,23,-9,7,11,9
22223,10998,11004,1,3,9,6,3,0,14,4,10,15,3,21
22224,10998,11004,27,7,9,3,4,2,12,9,3,10,8,13
22225,10998,11004,57,9,9,3,2,4,13,15,-2,8,10,11
22226,10998,11004,22,16,9,2,2,5,5,20,-15,6,12,8
22227,10998,11004,4,2,9,6,3,0,19,8,11,15,3,21
22228,10998,11004,21,6,9,4,2,3,16,12,4,10,8,14
22229,10998,11004,49,1,9,6,3,0,20,7,13,15,3,21
22230,10998,11004,52,10,9,3,1,5,11,14,-3,7,11,10
22231,10998,11004,28,18,9,1,3,5,5,15,-10,5,13,6
22232,10998,11004,43,4,9,5,2,2,22,7,15,12,6,17
22233,10998,11004,24,5,9,4,3,2,17,11,6,11,7,15
22234,10998,11004,35,11,9,2,4,3,16,16,0,8,10,10
22235,10998,11004,41,12,9,2,3,4,11,13,-2,7,11,9
22236,10998,11004,20,13,9,2,3,4,10,13,-3,7,11,9
22237,10998,11004,56,17,9,2,1,6,11,21,-10,5,13,7
22238,11481,11487,35,9,22,6,10,6,22,27,-5,22,22,28
22239,11481,11487,20,10,22,7,5,10,28,31,-3,19,25,26
22240,11481,11487,41,15,22,4,10,8,20,26,-6,18,26,22
22241,11481,11487,56,17,22,4,7,11,21,47,-26,15,29,19
22242,11481,11487,49,4,22,10,11,1,32,14,18,31,13,41
22243,11481,11487,37,11,22,5,9,8,28,28,0,19,25,24
22244,11481,11487,21,5,22,12,2,8,30,22,8,26,18,38
22245,11481,11487,4,7,22,9,6,7,33,32,1,24,20,33
22246,11481,11487,52,13,22,6,5,11,22,31,-9,17,27,23
22247,11481,11487,43,1,22,13,6,3,39,12,27,32,12,45
22248,11481,11487,24,2,22,13,5,4,36,16,20,31,13,44
22249,11481,11487,57,8,22,8,9,5,39,35,4,25,19,33
22250,11481,11487,22,16,22,5,6,11,17,30,-13,16,28,21
22251,11481,11487,34,18,22,2,5,15,8,42,-34,9,35,11
22252,11481,11487,27,14,22,5,8,9,19,25,-6,18,26,23
22253,11481,11487,1,3,22,11,9,2,40,16,24,31,13,42
22254,11481,11487,12,12,22,5,9,8,28,32,-4,19,25,24
22255,11481,11487,17,6,22,9,6,7,33,29,4,24,20,33
22256,11502,11515,17,7,24,10,6,8,36,34,2,26,22,36
22257,11502,11515,12,12,24,6,9,9,29,33,-4,21,27,27
22258,11502,11515,35,8,24,8,10,6,33,29,4,26,22,34
22259,11502,11515,20,10,24,8,5,11,33,38,-5,21,27,29
22260,11502,11515,41,15,24,5,10,9,25,32,-7,20,28,25
22261,11502,11515,56,17,24,4,7,13,21,51,-30,15,33,19
22262,11502,11515,1,3,24,13,9,2,45,17,28,35,13,48
22263,11502,11515,27,13,24,6,8,10,20,27,-7,20,28,26
22264,11502,11515,43,1,24,15,6,3,45,13,32,36,12,51
22265,11502,11515,24,2,24,14,6,4,38,16,22,34,14,48
22266,11502,11515,57,9,24,8,10,6,41,38,3,26,22,34
22267,11502,11515,22,16,24,5,7,12,18,32,-14,17,31,22
22268,11502,11515,34,18,24,2,5,17,9,47,-38,9,39,11
22269,18271,18277,45,9,6,1,4,1,7,4,3,6,6,7
22270,18271,18277,27,14,6,1,2,3,4,10,-6,4,8,5
22271,18271,18277,15,16,6,0,1,5,3,13,-10,1,11,1
22272,18271,18277,1,7,6,2,1,3,10,10,0,5,7,7
22273,18271,18277,25,12,6,1,2,3,4,7,-3,4,8,5
22274,18271,18277,12,10,6,1,3,2,8,11,-3,5,7,6
22275,18271,18277,17,15,6,0,1,5,5,14,-9,1,11,1
22276,18768,18770,42,9,21,7,7,7,38,38,0,21,21,28
22277,18768,18770,17,13,21,4,8,9,16,28,-12,16,26,20
22278,18768,18770,1,3,21,11,4,6,32,25,7,26,16,37
22279,18768,18770,12,11,21,5,9,7,28,29,-1,19,23,24
22280,18768,18770,25,15,21,3,5,13,18,37,-19,11,31,14
22281,18768,18770,56,5,21,10,4,7,26,22,4,24,18,34
22282,18768,18770,35,8,21,7,7,7,34,32,2,21,21,28
22283,18768,18770,45,14,21,2,11,8,20,29,-9,15,27,17
22284,18768,18770,28,16,21,2,7,12,25,42,-17,11,31,13
22285,18768,18770,49,4,21,9,8,4,29,24,5,26,16,35
22286,18768,18770,16,12,21,5,7,9,27,37,-10,17,25,22
22287,18768,18770,43,1,21,14,4,3,41,18,23,32,10,46
22288,18768,18770,22,6,21,9,7,5,39,28,11,25,17,34
22289,18768,18770,57,7,21,9,6,6,27,25,2,24,18,33
22290,18768,18770,24,10,21,7,6,8,29,36,-7,20,22,27
22291,18768,18770,4,2,21,12,4,5,43,22,21,28,14,40
22292,18771,18774,4,2,22,12,4,6,44,25,19,28,16,40
22293,18771,18774,43,1,22,15,4,3,44,19,25,34,10,49
22294,18771,18774,22,6,22,9,7,6,41,31,10,25,19,34
22295,18771,18774,57,7,22,9,7,6,29,27,2,25,19,34
22296,18771,18774,24,8,22,8,6,8,32,38,-6,22,22,30
22297,18771,18774,49,4,22,10,8,4,31,25,6,28,16,38
22298,18771,18774,16,12,22,5,7,10,27,39,-12,17,27,22
22299,18771,18774,28,16,22,2,7,13,25,45,-20,11,33,13
22300,18771,18774,45,14,22,3,11,8,21,29,-8,17,27,20
22301,18771,18774,56,5,22,11,4,7,28,22,6,26,18,37
22302,18771,18774,35,9,22,7,7,8,34,33,1,21,23,28
22303,18771,18774,12,11,22,5,9,8,28,32,-4,19,25,24
22304,18771,18774,25,15,22,4,5,13,21,37,-16,13,31,17
22305,18771,18774,1,3,22,12,4,6,35,25,10,28,16,40
22306,18771,18774,42,10,22,7,7,8,39,40,-1,21,23,28
22307,18771,18774,17,13,22,4,9,9,18,30,-12,17,27,21
22308,18649,18655,1,1,8,5,3,0,17,8,9,13,3,18
22309,18649,18655,12,13,8,2,2,4,7,8,-1,6,10,8
22310,18649,18655,25,15,8,1,2,5,6,15,-9,4,12,5
22311,18649,18655,28,16,8,0,1,7,12,25,-13,1,15,1
22312,18649,18655,56,8,8,3,2,3,10,7,3,8,8,11
22313,18649,18655,35,11,8,2,3,3,13,13,0,7,9,9
22314,18649,18655,42,6,8,3,3,2,18,13,5,9,7,12
22315,18649,18655,17,14,8,0,6,2,4,6,-2,6,10,6
22316,18649,18655,45,12,8,2,3,3,8,12,-4,7,9,9
22317,18649,18655,4,3,8,5,1,2,16,11,5,11,5,16
22318,18649,18655,49,7,8,3,3,2,10,10,0,9,7,12
22319,18649,18655,16,9,8,3,1,4,9,10,-1,7,9,10
22320,18649,18655,43,2,8,5,2,1,14,8,6,12,4,17
22321,18649,18655,57,4,8,4,3,1,10,7,3,11,5,15
22322,18649,18655,22,5,8,3,4,1,15,10,5,10,6,13
22323,18649,18655,24,10,8,3,1,4,9,15,-6,7,9,10
22324,19076,19082,43,1,17,11,4,2,40,15,25,26,8,37
22325,19076,19082,22,4,17,7,8,2,30,21,9,22,12,29
22326,19076,19082,24,11,17,5,4,8,25,27,-2,14,20,19
22327,19076,19082,57,16,17,3,2,12,21,38,-17,8,26,11
22328,19076,19082,4,10,17,5,5,7,20,26,-6,15,19,20
22329,19076,19082,45,2,17,10,3,4,28,18,10,23,11,33
22330,19076,19082,27,14,17,4,3,10,15,31,-16,11,23,15
22331,19076,19082,10,15,17,3,5,9,16,32,-16,11,23,14
22332,19076,19082,49,7,17,8,2,7,31,24,7,18,16,26
22333,19076,19082,16,8,17,6,7,4,33,26,7,19,15,25
22334,19076,19082,56,6,17,8,4,5,21,15,6,20,14,28
22335,19076,19082,35,12,17,5,2,10,22,32,-10,12,22,17
22336,19076,19082,12,3,17,10,3,4,29,20,9,23,11,33
22337,19076,19082,1,5,17,8,4,5,38,31,7,20,14,28
22338,19076,19082,42,9,17,7,3,7,31,33,-2,17,17,24
22339,19076,19082,17,13,17,3,7,7,18,29,-11,13,21,16
22340,18964,18970,42,3,2,1,1,0,7,4,3,3,1,4
22341,18964,18970,17,13,2,0,1,1,0,2,-2,1,3,1
22342,18964,18970,1,1,2,2,0,0,4,1,3,4,0,6
22343,18964,18970,56,6,2,1,1,0,3,2,1,3,1,4
22344,18964,18970,35,15,2,0,0,2,2,5,-3,0,4,0
22345,18964,18970,12,4,2,1,1,0,6,4,2,3,1,4
22346,18964,18970,49,11,2,0,1,1,0,1,-1,1,3,1
22347,18964,18970,16,14,2,0,1,1,4,7,-3,1,3,1
22348,18964,18970,45,1,2,2,0,0,4,1,3,4,0,6
22349,20872,20874,10,6,12,5,3,4,28,19,9,13,11,18
22350,20872,20874,45,9,12,5,1,6,22,21,1,11,13,16
22351,20872,20874,15,14,12,2,3,7,17,32,-15,7,17,9
22352,20872,20874,49,10,12,4,4,4,12,16,-4,12,12,16
22353,20959,20962,49,6,22,7,8,7,24,27,-3,22,22,29
22354,20959,20962,27,2,22,13,6,3,39,20,19,32,12,45
22355,20959,20962,10,8,22,8,4,10,40,38,2,20,24,28
22356,20959,20962,45,14,22,7,2,13,33,40,-7,16,28,23
22357,20959,20962,15,16,22,3,7,12,29,48,-19,13,31,16
22358,20959,20962,43,3,22,13,4,5,32,26,6,30,14,43
22359,20959,20962,22,9,22,6,9,7,29,29,0,21,23,27
22360,20959,20962,24,15,22,4,6,12,21,37,-16,14,30,18
22361,20959,20962,4,4,22,10,5,7,30,18,12,25,19,35
22362,20959,20962,21,5,22,9,8,5,32,26,6,26,18,35
22363,20959,20962,9,12,22,7,4,11,28,29,-1,18,26,25
22364,20959,20962,12,13,22,6,6,10,24,34,-10,18,26,24
22365,20959,20962,56,10,22,7,5,10,29,36,-7,19,25,26
22366,20959,20962,1,1,22,17,3,2,55,21,34,37,7,54
22367,20959,20962,28,7,22,7,8,7,25,32,-7,22,22,29
22368,20959,20962,38,11,22,7,5,10,29,38,-9,19,25,26
22369,20833,20839,43,9,7,2,3,2,8,9,-1,7,7,9
22370,20833,20839,22,10,7,2,2,3,12,12,0,6,8,8
22371,20833,20839,24,15,7,0,4,3,6,10,-4,4,10,4
22372,20833,20839,1,1,7,6,0,1,18,5,13,12,2,18
22373,20833,20839,49,13,7,1,3,3,4,12,-8,5,9,6
22374,20833,20839,56,8,7,2,3,2,9,9,0,7,7,9
22375,20833,20839,27,2,7,5,2,0,14,6,8,12,2,17
22376,20833,20839,45,4,7,4,1,2,18,8,10,9,5,13
22377,20833,20839,10,7,7,2,3,2,17,12,5,7,7,9
22378,20833,20839,15,14,7,1,1,5,6,20,-14,3,11,4
22379,20833,20839,28,3,7,5,1,1,11,8,3,11,3,16
22380,20833,20839,38,5,7,4,1,2,12,11,1,9,5,13
22381,20833,20839,21,6,7,3,3,1,12,11,1,9,5,12
22382,20833,20839,4,12,7,1,3,3,8,9,-1,5,9,6
22383,20833,20839,9,16,7,0,1,6,5,14,-9,1,13,1
22384,20833,20839,12,11,7,2,1,4,9,13,-4,5,9,7
22385,21239,21242,22,1,12,9,3,0,34,12,22,21,3,30
22386,21239,21242,43,4,12,7,2,3,24,14,10,16,8,23
22387,21239,21242,57,12,12,3,4,5,14,23,-9,10,14,13
22388,21239,21242,27,10,12,4,2,6,17,18,-1,10,14,14
22389,21239,21242,15,11,12,4,1,7,16,25,-9,9,15,13
22390,21239,21242,10,13,12,1,7,4,13,16,-3,9,15,10
22391,21239,21242,45,16,12,1,3,8,17,32,-15,5,19,6
22392,21239,21242,21,3,12,7,4,1,17,9,8,18,6,25
22393,21239,21242,4,5,12,6,2,4,25,22,3,14,10,20
22394,21239,21242,9,9,12,4,3,5,14,21,-7,11,13,15
22395,21239,21242,49,6,12,5,5,2,18,11,7,15,9,20
22396,21239,21242,12,15,12,1,3,8,9,22,-13,5,19,6
22397,21239,21242,28,7,12,4,6,2,17,14,3,14,10,18
22398,21239,21242,38,14,12,1,3,8,6,18,-12,5,19,6
22399,21239,21242,56,8,12,4,3,5,17,19,-2,11,13,15
22400,21239,21242,1,2,12,8,3,1,31,13,18,19,5,27
22401,21337,21343,1,2,24,13,6,5,51,25,26,32,16,45
22402,21337,21343,56,9,24,8,7,9,32,35,-3,23,25,31
22403,21337,21343,28,5,24,10,9,5,40,29,11,29,19,39
22404,21337,21343,38,11,24,7,5,12,23,29,-6,19,29,26
22405,21337,21343,27,8,24,10,4,10,35,34,1,24,24,34
22406,21337,21343,15,10,24,9,1,14,28,45,-17,19,29,28
22407,21337,21343,45,12,24,7,5,12,40,50,-10,19,29,26
22408,21337,21343,10,15,24,4,10,10,27,35,-8,18,30,22
22409,21337,21343,49,4,24,12,7,5,38,25,13,31,17,43
22410,21337,21343,21,3,24,13,6,5,35,26,9,32,16,45
22411,21337,21343,4,6,24,11,5,8,42,38,4,27,21,38
22412,21337,21343,9,14,24,6,5,13,23,43,-20,17,31,23
22413,21337,21343,12,16,24,3,5,16,21,44,-23,11,37,14
22414,21337,21343,22,1,24,16,6,2,55,24,31,38,10,54
22415,21337,21343,43,7,24,11,4,9,40,31,9,26,22,37
22416,21337,21343,57,13,24,7,5,12,28,45,-17,19,29,26
22417,21610,21616,57,16,14,1,1,12,11,35,-24,3,25,4
22418,21610,21616,56,13,14,4,2,8,22,25,-3,10,18,14
22419,21610,21616,27,6,14,6,5,3,20,15,5,17,11,23
22420,21610,21616,45,7,14,6,4,4,22,17,5,16,12,22
22421,21610,21616,15,12,14,4,4,6,13,25,-12,12,16,16
22422,21610,21616,10,15,14,1,4,9,10,29,-19,6,22,7
22423,21610,21616,49,2,14,8,3,3,28,13,15,19,9,27
22424,21610,21616,4,3,14,7,4,3,30,19,11,18,10,25
22425,21610,21616,21,4,14,7,3,4,29,22,7,17,11,24
22426,21610,21616,9,14,14,3,2,9,15,27,-12,8,20,11
22427,21610,21616,38,9,14,5,5,4,19,17,2,15,13,20
22428,12044,12047,41,10,4,1,2,1,2,7,-5,4,4,5
22429,12044,12047,20,17,4,0,1,3,6,12,-6,1,7,1
22430,12044,12047,1,8,4,1,3,0,5,4,1,5,3,6
22431,12044,12047,52,15,4,1,1,2,4,8,-4,3,5,4
22432,12044,12047,43,1,4,4,0,0,14,3,11,8,0,12
22433,12044,12047,24,11,4,1,1,2,5,5,0,3,5,4
22434,12044,12047,57,13,4,1,1,2,5,8,-3,3,5,4
22435,12044,12047,22,18,4,0,0,4,3,10,-7,0,8,0
22436,12044,12047,49,4,4,2,1,1,4,2,2,5,3,7
22437,12044,12047,37,16,4,0,4,0,3,3,0,4,4,4
22438,12044,12047,9,6,4,1,3,0,7,3,4,5,3,6
22439,12044,12047,4,7,4,1,3,0,5,3,2,5,3,6
22440,12044,12047,21,14,4,1,1,2,5,9,-4,3,5,4
22441,12044,12047,17,12,4,1,1,2,3,4,-1,3,5,4
22442,12076,12082,21,4,9,5,2,2,12,10,2,12,6,17
22443,12076,12082,9,5,9,4,5,0,14,6,8,13,5,17
22444,12076,12082,4,12,9,1,6,2,12,14,-2,8,10,9
22445,12076,12082,49,10,9,3,2,4,7,6,1,8,10,11
22446,12076,12082,37,13,9,1,6,2,7,10,-3,8,10,9
22447,12076,12082,43,1,9,7,1,1,27,12,15,15,3,22
22448,12076,12082,24,7,9,3,4,2,12,8,4,10,8,13
22449,12076,12082,57,11,9,2,4,3,13,15,-2,8,10,10
22450,12076,12082,22,18,9,0,2,7,10,24,-14,2,16,2
22451,12076,12082,52,17,9,1,2,6,10,20,-10,4,14,5
22452,12076,12082,6,3,9,5,2,2,17,12,5,12,6,17
22453,12076,12082,13,8,9,3,3,3,13,8,5,9,9,12
22454,12076,12082,35,9,9,3,3,3,11,12,-1,9,9,12
22455,12076,12082,20,14,9,2,2,5,12,21,-9,6,12,8
22456,12076,12082,41,16,9,1,5,3,7,14,-7,7,11,8
22457,12076,12082,27,6,9,4,2,3,11,9,2,10,8,14
22458,12076,12082,1,2,9,5,4,0,15,6,9,14,4,19
22459,12076,12082,17,15,9,1,5,3,7,10,-3,7,11,8
22460,12489,12495,17,3,11,6,2,3,24,16,8,14,8,20
22461,12489,12495,1,5,11,5,3,3,23,12,11,13,9,18
22462,12489,12495,13,6,11,5,3,3,18,12,6,13,9,18
22463,12489,12495,35,14,11,3,3,5,20,16,4,9,13,12
22464,12489,12495,6,16,11,3,1,7,11,18,-7,7,15,10
22465,12489,12495,41,18,11,1,4,6,16,25,-9,6,16,7
22466,12489,12495,52,10,11,3,6,2,13,13,0,12,10,15
22467,12489,12495,28,13,11,3,4,4,12,16,-4,10,12,13
22468,12489,12495,43,1,11,7,2,2,25,15,10,16,6,23
22469,12489,12495,24,4,11,6,2,3,15,11,4,14,8,20
22470,12489,12495,34,8,11,4,3,4,21,24,-3,11,11,15
22471,12489,12495,57,12,11,4,2,5,12,15,-3,10,12,14
22472,12489,12495,27,15,11,3,3,5,9,15,-6,9,13,12
22473,12489,12495,49,2,11,7,2,2,18,9,9,16,6,23
22474,12489,12495,37,7,11,5,0,6,16,22,-6,10,12,15
22475,12489,12495,4,9,11,4,3,4,16,19,-3,11,11,15
22476,12489,12495,21,11,11,4,2,5,19,19,0,10,12,14
22477,12489,12495,9,17,11,3,1,7,13,24,-11,7,15,10
22478,12566,12572,21,11,20,7,4,9,31,31,0,18,22,25
22479,12566,12572,4,16,20,6,3,11,26,40,-14,15,25,21
22480,12566,12572,9,17,20,3,4,13,20,50,-30,10,30,13
22481,12566,12572,49,3,20,12,5,3,32,17,15,29,11,41
22482,12566,12572,37,14,20,6,6,8,24,30,-6,18,22,24
22483,12566,12572,43,1,20,14,4,2,47,21,26,32,8,46
22484,12566,12572,34,5,20,8,5,7,41,40,1,21,19,29
22485,12566,12572,24,7,20,8,3,9,23,27,-4,19,21,27
22486,12566,12572,57,15,20,6,5,9,26,32,-6,17,23,23
22487,12566,12572,28,10,20,6,8,6,21,24,-3,20,20,26
22488,12566,12572,52,12,20,6,7,7,22,25,-3,19,21,25
22489,12566,12572,1,2,20,13,4,3,49,21,28,30,10,43
22490,12566,12572,27,13,20,6,7,7,20,27,-7,19,21,25
22491,12566,12572,13,6,20,7,7,6,32,24,8,21,19,28
22492,12566,12572,6,8,20,7,5,8,25,26,-1,19,21,26
22493,12566,12572,35,9,20,6,8,6,35,25,10,20,20,26
22494,12566,12572,41,18,20,2,6,12,22,41,-19,10,30,12
22495,12566,12572,17,4,20,9,5,6,33,28,5,23,17,32
22496,12419,12425,17,1,3,3,0,0,11,3,8,6,0,9
22497,12419,12425,1,7,3,1,1,1,5,5,0,3,3,4
22498,12419,12425,52,9,3,1,1,1,4,4,0,3,3,4
22499,12419,12425,28,16,3,0,2,1,1,3,-2,2,4,2
22500,12419,12425,13,3,3,2,0,1,6,3,3,4,2,6
22501,12419,12425,35,6,3,1,1,1,7,5,2,3,3,4
22502,12419,12425,41,17,3,0,2,1,3,8,-5,2,4,2
22503,12419,12425,6,18,3,0,1,2,4,6,-2,1,5,1
22504,12419,12425,57,5,3,2,0,1,4,3,1,4,2,6
22505,12419,12425,43,7,3,1,1,1,5,5,0,3,3,4
22506,12419,12425,34,10,3,1,1,1,5,6,-1,3,3,4
22507,12419,12425,24,13,3,1,0,2,2,5,-3,2,4,3
22508,12419,12425,49,2,3,3,0,0,7,1,6,6,0,9
22509,18964,18970,10,12,2,0,1,1,1,3,-2,1,3,1
22510,18964,18970,27,15,2,0,0,2,2,5,-3,0,4,0
22511,18964,18970,24,5,2,1,1,0,4,2,2,3,1,4
22512,18964,18970,43,7,2,1,1,0,2,1,1,3,1,4
22513,18964,18970,22,9,2,0,2,0,5,5,0,2,2,2
22514,18964,18970,57,10,2,0,1,1,4,5,-1,1,3,1
22515,18964,18970,4,8,2,1,0,1,3,3,0,2,2,3
22516,19188,19320,35,15,30,6,5,19,31,61,-30,17,43,23
22517,19188,19320,43,1,30,20,7,3,69,27,42,47,13,67
22518,19188,19320,22,3,30,15,10,5,63,40,23,40,20,55
22519,19188,19320,24,8,30,12,5,13,44,42,2,29,31,41
22520,19188,19320,10,13,30,7,9,14,28,49,-21,23,37,30
22521,19188,19320,57,16,30,3,5,22,30,65,-35,11,49,14
22522,19188,19320,4,12,30,8,10,12,33,40,-7,26,34,34
22523,19188,19320,45,2,30,19,6,5,49,29,20,44,16,63
22524,19188,19320,27,11,30,10,4,16,30,49,-19,24,36,34
22525,19188,19320,49,6,30,15,5,10,54,33,21,35,25,50
22526,19188,19320,16,10,30,8,12,10,46,51,-5,28,32,36
22527,19188,19320,42,7,30,13,5,12,48,53,-5,31,29,44
22528,19188,19320,56,9,30,11,6,13,31,30,1,28,32,39
22529,19188,19320,1,4,30,15,9,6,66,43,23,39,21,54
22530,19188,19320,12,5,30,14,9,7,53,38,15,37,23,51
22531,19188,19320,17,14,30,5,11,14,28,53,-25,21,39,26
22532,19405,19411,27,9,11,3,4,4,13,16,-3,10,12,13
22533,19405,19411,10,14,11,1,5,5,9,15,-6,7,15,8
22534,19405,19411,1,2,11,8,2,1,21,10,11,18,4,26
22535,19405,19411,57,13,11,2,4,5,8,20,-12,8,14,10
22536,19405,19411,12,7,11,5,2,4,22,19,3,12,10,17
22537,19405,19411,56,6,11,6,1,4,17,13,4,13,9,19
22538,19405,19411,17,11,11,3,2,6,9,19,-10,8,14,11
22539,19405,19411,42,16,11,0,2,9,7,20,-13,2,20,2
22540,19405,19411,4,8,11,3,5,3,13,17,-4,11,11,14
22541,19405,19411,9,15,11,1,3,7,7,20,-13,5,17,6
22542,19405,19411,45,3,11,7,3,1,23,16,7,17,5,24
22543,19405,19411,49,1,11,9,1,1,25,6,19,19,3,28
22544,19405,19411,16,12,11,2,4,5,12,17,-5,8,14,10
22545,19405,19411,22,4,11,7,2,2,22,10,12,16,6,23
22546,19405,19411,43,5,11,7,0,4,30,15,15,14,8,21
22547,19405,19411,24,10,11,3,2,6,12,17,-5,8,14,11
22548,19545,19551,4,7,29,12,8,9,39,36,3,32,26,44
22549,19545,19551,9,9,29,9,7,13,28,42,-14,25,33,34
22550,19545,19551,45,4,29,13,11,5,50,38,12,37,21,50
22551,19545,19551,27,13,29,7,10,12,33,41,-8,24,34,31
22552,19545,19551,10,14,29,6,12,11,27,34,-7,24,34,30
22553,19545,19551,49,1,29,20,6,3,58,16,42,46,12,66
22554,19545,19551,16,15,29,6,9,14,28,44,-16,21,37,27
22555,19545,19551,56,8,29,10,8,11,40,42,-2,28,30,38
22556,19545,19551,12,5,29,14,6,9,46,30,16,34,24,48
22557,19545,19551,43,3,29,17,3,9,57,31,26,37,21,54
22558,19545,19551,22,6,29,14,2,13,40,37,3,30,28,44
22559,19545,19551,57,10,29,9,6,14,29,53,-24,24,34,33
22560,19545,19551,24,12,29,8,7,14,34,48,-14,23,35,31
22561,19545,19551,1,2,29,18,6,5,52,28,24,42,16,60
22562,19545,19551,17,11,29,9,5,15,35,51,-16,23,35,32
22563,19545,19551,42,16,29,5,4,20,26,51,-25,14,44,19
22564,19874,19880,17,16,24,3,6,15,23,54,-31,12,36,15
22565,19874,19880,1,1,24,14,9,1,60,22,38,37,11,51
22566,19874,19880,43,2,24,12,8,4,42,26,16,32,16,44
22567,19874,19880,22,7,24,9,10,5,30,23,7,28,20,37
22568,19874,19880,24,12,24,6,9,9,27,33,-6,21,27,27
22569,19874,19880,57,14,24,6,5,13,16,34,-18,17,31,23
22570,19874,19880,12,8,24,8,10,6,34,28,6,26,22,34
22571,19874,19880,25,9,24,7,9,8,37,47,-10,23,25,30
22572,19874,19880,38,13,24,6,5,13,31,41,-10,17,31,23
22573,19874,19880,56,3,24,13,2,9,45,32,13,28,20,41
22574,19874,19880,49,5,24,12,4,8,40,35,5,28,20,40
22575,19874,19880,27,6,24,11,5,8,38,29,9,27,21,38
22576,19874,19880,45,10,24,8,5,11,31,38,-7,21,27,29
22577,19874,19880,10,15,24,6,4,14,24,40,-16,16,32,22
22578,19874,19880,4,4,24,11,8,5,41,26,15,30,18,41
22579,19874,19880,9,11,24,8,5,11,30,41,-11,21,27,29
22580,19888,19894,4,3,26,12,9,5,45,26,19,33,19,45
22581,19888,19894,9,9,26,9,5,12,31,42,-11,23,29,32
22582,19888,19894,27,7,26,11,7,8,38,29,9,29,23,40
22583,19888,19894,45,10,26,8,6,12,34,42,-8,22,30,30
22584,19888,19894,10,13,26,7,4,15,25,41,-16,18,34,25
22585,19888,19894,49,5,26,13,5,8,44,36,8,31,21,44
22586,19888,19894,56,4,26,14,2,10,47,33,14,30,22,44
22587,20518,20531,49,8,14,6,4,4,23,14,9,16,12,22
22588,20518,20531,12,13,14,3,3,8,11,19,-8,9,19,12
22589,20518,20531,25,16,14,2,3,9,15,31,-16,7,21,9
22590,20518,20531,43,2,14,7,4,3,24,15,9,18,10,25
22591,20518,20531,22,9,14,6,3,5,18,19,-1,15,13,21
22592,20518,20531,24,10,14,5,4,5,17,15,2,14,14,19
22593,20518,20531,45,1,14,9,3,2,24,11,13,21,7,30
22594,20518,20531,27,6,14,6,6,2,17,13,4,18,10,24
22595,20518,20531,15,11,14,4,3,7,23,33,-10,11,17,15
22596,20518,20531,10,12,14,3,4,7,14,25,-11,10,18,13
22597,20518,20531,9,3,14,7,4,3,23,18,5,18,10,25
22598,20518,20531,4,5,14,7,3,4,22,14,8,17,11,24
22599,20518,20531,38,14,14,3,2,9,16,25,-9,8,20,11
22600,20518,20531,28,15,14,2,4,8,16,24,-8,8,20,10
22601,20602,20608,28,11,24,7,5,12,30,36,-6,19,29,26
22602,20602,20608,45,3,24,13,7,4,37,24,13,33,15,46
22603,20602,20608,27,4,24,11,7,6,29,25,4,29,19,40
22604,20602,20608,9,5,24,11,6,7,41,30,11,28,20,39
22605,20602,20608,4,6,24,11,6,7,34,23,11,28,20,39
22606,20602,20608,43,2,24,14,6,4,52,24,28,34,14,48
22607,20602,20608,24,7,24,11,5,8,31,27,4,27,21,38
22608,20602,20608,22,9,24,10,5,9,29,31,-2,25,23,35
22609,20602,20608,12,12,24,6,7,11,22,29,-7,19,29,25
22610,20602,20608,25,15,24,4,7,13,28,51,-23,15,33,19
22611,20602,20608,15,13,24,5,6,13,34,56,-22,16,32,21
22612,20602,20608,10,14,24,4,9,11,20,34,-14,17,31,21
22613,20602,20608,38,16,24,5,3,16,23,45,-22,13,35,18
22614,20602,20608,49,8,24,9,9,6,41,29,12,27,21,36
22615,20602,20608,56,10,24,7,6,11,33,47,-14,20,28,27
22616,20602,20608,1,1,24,15,4,5,45,18,27,34,14,49
22617,20875,20881,1,1,13,11,0,2,30,12,18,22,4,33
22618,20875,20881,49,8,13,5,4,4,15,17,-2,14,12,19
22619,20875,20881,28,4,13,7,2,4,15,16,-1,16,10,23
22620,20875,20881,38,7,13,5,4,4,21,22,-1,14,12,19
22621,20875,20881,56,14,13,2,5,6,13,20,-7,9,17,11
22622,20875,20881,12,11,13,4,3,6,17,21,-4,11,15,15
22623,20875,20881,21,5,13,5,5,3,20,17,3,15,11,20
22624,20875,20881,4,12,13,3,4,6,16,15,1,10,16,13
22625,20875,20881,9,13,13,3,2,8,16,20,-4,8,18,11
22626,20875,20881,27,2,13,7,4,2,21,15,6,18,8,25
22627,20875,20881,45,6,13,6,1,6,24,22,2,13,13,19
22628,20875,20881,10,9,13,5,3,5,29,22,7,13,13,18
22629,20875,20881,15,15,13,2,3,8,19,35,-16,7,19,9
22630,20875,20881,43,3,13,7,3,3,20,16,4,17,9,24
22631,20875,20881,22,10,13,4,6,3,20,17,3,14,12,18
22632,20875,20881,24,16,13,1,5,7,15,24,-9,7,19,8
22633,20917,20923,27,2,18,11,5,2,32,18,14,27,9,38
22634,20917,20923,10,7,18,7,3,8,35,32,3,17,19,24
22635,20917,20923,45,10,18,6,2,10,29,32,-3,14,22,20
22636,20917,20923,15,16,18,2,6,10,26,44,-18,10,26,12
22637,20917,20923,43,3,18,10,4,4,29,21,8,24,12,34
22638,20917,20923,22,9,18,5,8,5,24,23,1,18,18,23
22639,20917,20923,24,13,18,4,6,8,21,28,-7,14,22,18
22640,20917,20923,4,4,18,8,4,6,26,17,9,20,16,28
22641,20917,20923,21,5,18,7,7,4,24,21,3,21,15,28
22642,20917,20923,9,12,18,5,4,9,22,24,-2,14,22,19
22643,20917,20923,12,15,18,4,5,9,19,29,-10,13,23,17
22644,20917,20923,28,6,18,7,6,5,23,25,-2,20,16,27
22645,20917,20923,38,11,18,5,5,8,24,31,-7,15,21,20
22646,20917,20923,56,14,18,4,5,9,21,31,-10,13,23,17
22647,20917,20923,49,8,18,6,6,6,19,22,-3,18,18,24
22648,20917,20923,1,1,18,14,2,2,41,17,24,30,6,44
22649,20931,20937,1,1,20,16,2,2,49,17,32,34,6,50
22650,20931,20937,49,8,20,6,8,6,20,23,-3,20,20,26
22651,20931,20937,56,11,20,6,5,9,26,33,-7,17,23,23
22652,20931,20937,28,6,20,7,8,5,24,26,-2,22,18,29
22653,20931,20937,38,7,20,7,5,8,27,32,-5,19,21,26
22654,20931,20937,12,13,20,5,6,9,22,31,-9,16,24,21
22655,20931,20937,4,4,20,9,5,6,27,17,10,23,17,32
22656,20931,20937,21,5,20,8,7,5,27,24,3,23,17,31
22657,20931,20937,9,12,20,6,4,10,25,26,-1,16,24,22
22658,20931,20937,43,3,20,11,4,5,30,26,4,26,14,37
22659,20931,20937,22,10,20,5,9,6,27,27,0,19,21,24
22660,20931,20937,24,15,20,4,6,10,21,33,-12,14,26,18
22661,20931,20937,27,2,20,11,6,3,33,20,13,28,12,39
22662,20931,20937,10,9,20,7,4,9,37,36,1,18,22,25
22663,20931,20937,45,14,20,6,2,12,31,36,-5,14,26,20
22664,20931,20937,15,16,20,2,7,11,26,45,-19,11,29,13
22665,7463,7469,43,1,21,17,2,2,41,12,29,36,6,53
22666,7463,7469,22,8,21,9,2,10,26,34,-8,20,22,29
22667,7463,7469,57,13,21,6,5,10,32,47,-15,17,25,23
22668,7463,7469,20,11,21,7,6,8,26,28,-2,20,22,27
22669,7463,7469,56,12,21,7,4,10,24,33,-9,18,24,25
22670,7463,7469,41,14,21,6,4,11,31,32,-1,16,26,22
22671,7463,7469,37,2,21,13,4,4,35,17,18,30,12,43
22672,7463,7469,49,3,21,12,5,4,42,26,16,29,13,41
22673,7463,7469,21,9,21,7,8,6,29,33,-4,22,20,29
22674,7463,7469,4,10,21,7,6,8,36,31,5,20,22,27
22675,7463,7469,17,7,21,8,8,5,37,26,11,24,18,32
22676,7309,7315,19,11,3,1,0,2,4,6,-2,2,4,3
22677,7309,7315,17,13,3,0,2,1,3,5,-2,2,4,2
22678,7309,7315,8,14,3,0,1,2,3,5,-2,1,5,1
22679,7309,7315,4,16,3,0,1,2,0,3,-3,1,5,1
22680,7309,7315,21,17,3,0,1,2,1,7,-6,1,5,1
22681,7309,7315,49,3,3,2,1,0,11,4,7,5,1,7
22682,7309,7315,37,8,3,2,0,1,3,3,0,4,2,6
22683,7309,7315,12,6,3,2,0,1,4,2,2,4,2,6
22684,7309,7315,53,18,3,0,0,3,3,7,-4,0,6,0
22685,7309,7315,48,2,3,3,0,0,6,1,5,6,0,9
22686,7309,7315,52,5,3,2,1,0,5,2,3,5,1,7
22687,7309,7315,57,4,3,2,1,0,9,5,4,5,1,7
22688,7309,7315,22,10,3,1,0,2,4,5,-1,2,4,3
22689,7309,7315,56,7,3,2,0,1,7,7,0,4,2,6
22690,7309,7315,20,12,3,1,0,2,2,6,-4,2,4,3
22691,7309,7315,41,15,3,0,1,2,3,6,-3,1,5,1
22692,7309,7315,43,1,3,3,0,0,13,3,10,6,0,9
22693,7309,7315,1,9,3,1,1,1,3,7,-4,3,3,4
22694,7554,7560,1,6,33,15,5,13,72,56,16,35,31,50
22695,7554,7560,8,17,33,8,7,18,35,62,-27,23,43,31
22696,7554,7560,12,2,33,19,6,8,72,36,36,44,22,63
22697,7554,7560,53,15,33,10,6,17,40,52,-12,26,40,36
22698,7554,7560,20,11,33,11,10,12,39,44,-5,32,34,43
22699,7554,7560,56,12,33,11,8,14,42,54,-12,30,36,41
22700,7554,7560,57,14,33,10,7,16,48,66,-18,27,39,37
22701,7554,7560,52,8,33,13,7,13,47,49,-2,33,33,46
22702,7554,7560,48,18,33,5,9,19,29,84,-55,19,47,24
22703,7554,7560,43,1,33,25,5,3,80,24,56,55,11,80
22704,7554,7560,22,5,33,15,6,12,45,43,2,36,30,51
22705,7554,7560,41,13,33,10,9,14,47,44,3,29,37,39
22706,7554,7560,49,3,33,18,6,9,65,43,22,42,24,60
22707,7554,7560,37,4,33,16,8,9,48,31,17,40,26,56
22708,7554,7560,4,9,33,12,8,13,49,47,2,32,34,44
22709,7554,7560,21,10,33,11,11,11,42,50,-8,33,33,44
22710,7554,7560,17,7,33,12,11,10,57,47,10,35,31,47
22711,7554,7560,19,16,33,9,5,19,51,76,-25,23,43,32
22712,7323,7329,17,9,5,2,2,1,9,8,1,6,4,8
22713,7323,7329,19,12,5,2,0,3,7,9,-2,4,6,6
22714,7323,7329,8,14,5,1,1,3,8,10,-2,3,7,4
22715,7323,7329,21,15,5,1,1,3,2,11,-9,3,7,4
22716,7323,7329,4,18,5,0,1,4,0,7,-7,1,9,1
22717,7323,7329,37,8,5,3,0,2,6,6,0,6,4,9
22718,7323,7329,49,2,5,3,2,0,15,7,8,8,2,11
22719,7323,7329,12,3,5,3,1,1,10,3,7,7,3,10
22720,7323,7329,53,16,5,1,0,4,7,11,-4,2,8,3
22721,7323,7329,52,4,5,3,1,1,6,3,3,7,3,10
22722,7323,7329,48,6,5,3,1,1,7,6,1,7,3,10
22723,7323,7329,43,1,5,4,1,0,15,4,11,9,1,13
22724,7323,7329,57,5,5,3,1,1,12,11,1,7,3,10
22725,7323,7329,22,11,5,2,0,3,9,10,-1,4,6,6
22726,7323,7329,20,7,5,3,0,2,9,6,3,6,4,9
22727,7323,7329,56,12,5,2,0,3,7,9,-2,4,6,6
22728,7323,7329,41,17,5,0,1,4,4,11,-7,1,9,1
22729,7323,7329,1,10,5,2,1,2,9,10,-1,5,5,7
22730,7330,7336,1,9,6,3,1,2,11,11,0,7,5,10
22731,7330,7336,53,15,6,1,1,4,7,11,-4,3,9,4
22732,7330,7336,20,10,6,3,0,3,10,8,2,6,6,9
22733,7330,7336,56,13,6,2,1,3,7,9,-2,5,7,7
22734,7330,7336,41,18,6,0,1,5,5,13,-8,1,11,1
22735,7330,7336,43,2,6,4,1,1,16,8,8,9,3,13
22736,7330,7336,57,8,6,3,1,2,13,13,0,7,5,10
22737,7330,7336,22,11,6,3,0,3,11,10,1,6,6,9
22738,7330,7336,52,3,6,4,1,1,8,4,4,9,3,13
22739,7330,7336,48,6,6,3,2,1,9,8,1,8,4,11
22740,7330,7336,12,7,6,3,1,2,10,5,5,7,5,10
22741,7330,7336,49,1,6,4,2,0,17,8,9,10,2,14
22742,7330,7336,37,4,6,4,0,2,10,7,3,8,4,12
22743,7330,7336,21,14,6,1,2,3,3,12,-9,4,8,5
22744,7330,7336,4,17,6,0,2,4,1,8,-7,2,10,2
22745,7330,7336,8,16,6,1,1,4,8,15,-7,3,9,4
22746,19888,19894,38,14,26,6,5,15,31,45,-14,17,35,23
22747,19888,19894,12,8,26,9,11,6,36,29,7,29,23,38
22748,19888,19894,25,11,26,7,9,10,38,53,-15,23,29,30
22749,19888,19894,43,2,26,13,9,4,45,27,18,35,17,48
22750,19888,19894,22,6,26,11,10,5,33,24,9,32,20,43
22751,19888,19894,24,12,26,6,11,9,28,34,-6,23,29,29
22752,19888,19894,57,15,26,6,5,15,17,38,-21,17,35,23
22753,19888,19894,1,1,26,14,10,2,61,25,36,38,14,52
22754,19888,19894,17,16,26,5,6,15,28,57,-29,16,36,21
22755,19902,19908,1,1,28,15,10,3,65,27,38,40,16,55
22756,19902,19908,12,8,28,10,11,7,37,30,7,31,25,41
22757,19902,19908,25,10,28,8,9,11,41,59,-18,25,31,33
22758,19902,19908,43,2,28,15,9,4,48,27,21,39,17,54
22759,19902,19908,38,15,28,6,5,17,31,49,-18,17,39,23
22760,19902,19908,56,5,28,15,2,11,53,35,18,32,24,47
22761,19902,19908,49,4,28,15,5,8,48,38,10,35,21,50
22762,19902,19908,17,16,28,5,6,17,29,61,-32,16,40,21
22763,19902,19908,27,6,28,13,7,8,42,30,12,33,23,46
22764,19902,19908,45,12,28,8,7,13,38,47,-9,23,33,31
22765,19902,19908,10,13,28,7,4,17,27,45,-18,18,38,25
22766,19902,19908,4,3,28,14,9,5,48,27,21,37,19,51
22767,19902,19908,9,11,28,9,5,14,32,48,-16,23,33,32
22768,19902,19908,22,7,28,12,10,6,35,25,10,34,22,46
22769,19902,19908,24,9,28,8,11,9,33,37,-4,27,29,35
22770,19902,19908,57,14,28,6,6,16,19,41,-22,18,38,24
22771,19713,19719,43,1,5,4,1,0,9,3,6,9,1,13
22772,19713,19719,24,9,5,2,0,3,8,9,-1,4,6,6
22773,19713,19719,4,2,5,3,1,1,9,5,4,7,3,10
22774,19713,19719,9,3,5,3,0,2,5,4,1,6,4,9
22775,19713,19719,38,5,5,2,2,1,10,8,2,6,4,8
22776,19713,19719,45,12,5,1,2,2,6,7,-1,4,6,5
22777,19713,19719,49,8,5,2,1,2,10,10,0,5,5,7
22778,19713,19719,25,4,5,2,3,0,9,7,2,7,3,9
22779,19713,19719,12,7,5,2,1,2,4,3,1,5,5,7
22780,19713,19719,57,10,5,1,3,1,3,3,0,5,5,6
22781,19713,19719,22,11,5,1,3,1,6,7,-1,5,5,6
22782,19713,19719,56,15,5,1,1,3,5,9,-4,3,7,4
22783,19713,19719,27,13,5,1,1,3,6,9,-3,3,7,4
22784,19713,19719,10,16,5,0,2,3,3,7,-4,2,8,2
22785,19713,19719,1,6,5,2,2,1,6,5,1,6,4,8
22786,19713,19719,17,14,5,1,1,3,4,7,-3,3,7,4
22787,19741,19747,17,16,8,1,2,5,7,17,-10,4,12,5
22788,19741,19747,1,5,8,3,4,1,14,8,6,10,6,13
22789,19741,19747,27,10,8,3,1,4,10,11,-1,7,9,10
22790,19741,19747,10,13,8,2,2,4,9,10,-1,6,10,8
22791,19741,19747,45,15,8,1,3,4,10,15,-5,5,11,6
22792,19741,19747,56,14,8,2,1,5,8,17,-9,5,11,7
22793,19741,19747,43,1,8,5,3,0,16,9,7,13,3,18
22794,19741,19747,22,9,8,2,5,1,10,10,0,9,7,11
22795,19741,19747,24,11,8,3,0,5,15,16,-1,6,10,9
22796,19741,19747,57,12,8,2,3,3,6,10,-4,7,9,9
22797,19741,19747,12,3,8,4,2,2,11,8,3,10,6,14
22798,19741,19747,25,6,8,3,4,1,19,15,4,10,6,13
22799,19741,19747,49,8,8,3,2,3,16,16,0,8,8,11
22800,19741,19747,38,7,8,3,2,3,15,11,4,8,8,11
22801,19741,19747,4,2,8,5,1,2,13,7,6,11,5,16
22802,19741,19747,9,4,8,4,1,3,12,11,1,9,7,13
22803,20189,20195,49,8,19,7,4,8,24,32,-8,18,20,25
22804,20189,20195,16,15,19,4,3,12,23,35,-12,11,27,15
22805,20189,20195,28,10,19,7,3,9,20,25,-5,17,21,24
22806,20189,20195,38,14,19,5,6,8,28,30,-2,16,22,21
22807,20189,20195,4,1,19,11,7,1,37,17,20,29,9,40
22808,20189,20195,9,3,19,10,5,4,34,21,13,25,13,35
22809,20189,20195,12,11,19,6,5,8,22,23,-1,17,21,23
22810,20189,20195,25,16,19,2,7,10,19,40,-21,11,27,13
22811,20189,20195,1,2,19,12,1,6,37,20,17,25,13,37
22812,20189,20195,56,9,19,6,7,6,20,20,0,19,19,25
22813,20189,20195,43,4,19,9,8,2,29,15,14,26,12,35
22814,20189,20195,22,7,19,7,4,8,20,21,-1,18,20,25
22815,20189,20195,24,12,19,6,4,9,28,34,-6,16,22,22
22816,20189,20195,45,5,19,8,5,6,35,33,2,21,17,29
22817,20189,20195,27,6,19,7,6,6,22,21,1,20,18,27
22818,20189,20195,10,13,19,6,3,10,25,36,-11,15,23,21
22819,20273,20279,45,7,29,11,7,11,48,50,-2,29,29,40
22820,20273,20279,27,9,29,10,8,11,35,38,-3,28,30,38
22821,20273,20279,10,11,29,9,6,14,40,56,-16,24,34,33
22822,20273,20279,43,3,29,14,10,5,48,29,19,38,20,52
22823,20273,20279,22,5,29,13,6,10,38,29,9,32,26,45
22824,20273,20279,24,10,29,9,7,13,44,50,-6,25,33,34
22825,20273,20279,56,8,29,10,9,10,31,32,-1,29,29,39
22826,13168,13174,52,14,7,1,4,2,5,8,-3,6,8,7
22827,13168,13174,28,17,7,1,2,4,10,18,-8,4,10,5
22828,13693,13699,4,9,24,7,10,7,35,34,1,24,24,31
22829,13693,13699,21,18,24,3,5,16,25,48,-23,11,37,14
22830,13693,13699,49,12,24,7,8,9,34,34,0,22,26,29
22831,13693,13699,37,16,24,4,8,12,22,39,-17,16,32,20
22832,13693,13699,22,2,24,15,4,5,52,29,23,34,14,49
22833,13693,13699,43,5,24,11,6,7,37,28,9,28,20,39
22834,13693,13699,34,14,24,7,6,11,35,42,-7,20,28,27
22835,13693,13699,27,11,24,8,5,11,35,46,-11,21,27,29
22836,13693,13699,17,7,24,9,6,9,36,33,3,24,24,33
22837,13693,13699,12,6,24,11,1,12,46,51,-5,23,25,34
22838,13693,13699,25,10,24,7,9,8,37,38,-1,23,25,30
22839,13693,13699,1,1,24,21,3,0,60,18,42,45,3,66
22840,13693,13699,35,3,24,13,5,6,46,32,14,31,17,44
22841,13693,13699,6,8,24,9,6,9,37,36,1,24,24,33
22842,13693,13699,47,4,24,11,9,4,42,23,19,31,17,42
22843,13693,13699,28,13,24,7,8,9,23,27,-4,22,26,29
22844,13693,13699,33,15,24,6,7,11,27,37,-10,19,29,25
22845,13693,13699,52,17,24,5,4,15,27,61,-34,14,34,19
22846,13700,13706,28,13,25,7,8,10,23,29,-6,22,28,29
22847,13700,13706,33,15,25,7,7,11,29,38,-9,21,29,28
22848,13700,13706,52,17,25,5,4,16,27,62,-35,14,36,19
22849,13700,13706,47,4,25,12,9,4,43,23,20,33,17,45
22850,13700,13706,35,3,25,14,5,6,48,32,16,33,17,47
22851,13700,13706,6,8,25,9,6,10,38,38,0,24,26,33
22852,13700,13706,49,9,25,8,8,9,36,34,2,24,26,32
22853,13700,13706,37,16,25,4,8,13,22,40,-18,16,34,20
22854,13700,13706,1,1,25,21,3,1,60,21,39,45,5,66
22855,13700,13706,12,6,25,12,1,12,48,52,-4,25,25,37
22856,13700,13706,25,12,25,7,9,9,38,41,-3,23,27,30
22857,13700,13706,17,7,25,10,6,9,39,34,5,26,24,36
22858,13700,13706,27,11,25,8,6,11,36,47,-11,22,28,30
22859,13700,13706,22,2,25,16,4,5,55,29,26,36,14,52
22860,13700,13706,43,5,25,11,6,8,38,30,8,28,22,39
22861,13700,13706,34,14,25,7,7,11,36,43,-7,21,29,28
22862,13700,13706,4,10,25,7,10,8,35,36,-1,24,26,31
22863,13700,13706,21,18,25,4,5,16,26,48,-22,13,37,17
22864,13945,13951,4,11,13,4,5,4,21,27,-6,13,13,17
22865,13945,13951,9,17,13,1,4,8,9,33,-24,6,20,7
22866,13945,13951,49,4,13,8,1,4,21,10,11,17,9,25
22867,13945,13951,37,13,13,4,2,7,17,23,-6,10,16,14
22868,13945,13951,22,2,13,9,2,2,25,14,11,20,6,29
22869,13945,13951,43,7,13,5,5,3,21,19,2,15,11,20
22870,13945,13951,34,10,13,5,4,4,23,21,2,14,12,19
22871,13945,13951,17,9,13,6,1,6,22,22,0,13,13,19
22872,13945,13951,27,14,13,3,5,5,18,18,0,11,15,14
22873,13945,13951,25,3,13,8,1,4,33,22,11,17,9,25
22874,13945,13951,12,5,13,7,3,3,30,18,12,17,9,24
22875,13945,13951,28,6,13,6,3,4,18,12,6,15,11,21
22876,13945,13951,33,8,13,5,5,3,24,23,1,15,11,20
22877,13945,13951,35,12,13,4,2,7,21,23,-2,10,16,14
22878,13945,13951,6,15,13,3,2,8,14,19,-5,8,18,11
22879,13945,13951,56,18,13,1,3,9,19,37,-18,5,21,6
22880,13945,13951,47,16,13,2,4,7,14,24,-10,8,18,10
22881,13945,13951,1,1,13,9,2,2,27,12,15,20,6,29
22882,14022,14028,47,13,21,5,8,8,26,34,-8,18,24,23
22883,14022,14028,33,5,21,10,7,4,45,33,12,27,15,37
22884,14022,14028,28,7,21,9,6,6,29,24,5,24,18,33
22885,14022,14028,35,9,21,9,4,8,35,32,3,22,20,31
22886,14022,14028,6,15,21,5,4,12,23,34,-11,14,28,19
22887,14022,14028,56,17,21,3,5,13,30,53,-23,11,31,14
22888,14022,14028,1,2,21,13,4,4,38,22,16,30,12,43
22889,14022,14028,12,4,21,11,4,6,45,30,15,26,16,37
22890,14022,14028,25,10,21,9,3,9,43,37,6,21,21,30
22891,14022,14028,27,14,21,4,8,9,26,33,-7,16,26,20
22892,14022,14028,49,8,21,10,2,9,32,26,6,22,20,32
22893,14022,14028,37,16,21,4,4,13,22,37,-15,12,30,16
22894,14022,14028,17,11,21,9,3,9,39,34,5,21,21,30
22895,14022,14028,22,1,21,13,5,3,48,25,23,31,11,44
22896,14022,14028,43,3,21,11,5,5,41,30,11,27,15,38
22897,14022,14028,34,12,21,7,5,9,30,37,-7,19,23,26
22898,14022,14028,4,6,21,10,7,4,37,36,1,27,15,37
22899,14022,14028,9,18,21,2,6,13,19,51,-32,10,32,12
22900,14295,14301,49,12,10,4,1,5,14,16,-2,9,11,13
22901,14295,14301,43,1,10,8,2,0,30,14,16,18,2,26
22902,14295,14301,22,4,10,5,4,1,24,14,10,14,6,19
22903,14295,14301,24,5,10,6,0,4,15,19,-4,12,8,18
22904,21610,21616,28,10,14,5,4,5,15,23,-8,14,14,19
22905,21610,21616,1,1,14,10,4,0,32,4,28,24,4,34
22906,21610,21616,24,5,14,7,3,4,25,22,3,17,11,24
22907,21610,21616,22,8,14,6,3,5,21,19,2,15,13,21
22908,21610,21616,43,11,14,4,5,5,17,17,0,13,15,17
22909,21729,21735,1,1,28,20,7,1,56,13,43,47,9,67
22910,21729,21735,38,11,28,8,9,11,37,40,-3,25,31,33
22911,21729,21735,28,12,28,9,5,14,33,50,-17,23,33,32
22912,21729,21735,56,10,28,9,6,13,40,43,-3,24,32,33
22913,21729,21735,27,3,28,14,9,5,45,22,23,37,19,51
22914,21729,21735,45,9,28,10,6,12,41,42,-1,26,30,36
22915,21729,21735,15,13,28,8,5,15,27,50,-23,21,35,29
22916,21729,21735,10,16,28,5,5,18,21,59,-38,15,41,20
22917,21729,21735,4,2,28,16,7,5,58,30,28,39,17,55
22918,21729,21735,21,4,28,14,8,6,48,32,16,36,20,50
22919,21729,21735,9,15,28,6,4,18,27,54,-27,16,40,22
22920,21729,21735,49,5,28,14,6,8,47,32,15,34,22,48
22921,21729,21735,24,6,28,13,4,11,45,42,3,30,26,43
22922,21729,21735,22,7,28,12,5,11,41,40,1,29,27,41
22923,21729,21735,43,8,28,10,10,8,38,29,9,30,26,40
22924,21729,21735,57,14,28,7,2,19,26,52,-26,16,40,23
22925,22023,22025,24,16,17,4,5,8,26,32,-6,13,21,17
22926,22023,22025,21,5,17,8,4,5,31,25,6,20,14,28
22927,22023,22025,9,9,17,6,5,6,22,20,2,17,17,23
22928,22023,22025,4,10,17,7,1,9,25,26,-1,15,19,22
22929,22023,22025,16,6,17,8,4,5,31,27,4,20,14,28
22930,22023,22025,49,8,17,6,7,4,20,17,3,19,15,25
22931,22023,22025,10,15,17,5,3,9,24,35,-11,13,21,18
22932,22023,22025,56,12,17,5,5,7,21,26,-5,15,19,20
22933,22023,22025,27,3,17,9,3,5,25,17,8,21,13,30
22934,22023,22025,15,11,17,4,9,4,21,25,-4,17,17,21
22935,22023,22025,45,14,17,5,3,9,24,34,-10,13,21,18
22936,22023,22025,38,17,17,4,4,9,13,26,-13,12,22,16
22937,22023,22025,28,18,17,3,5,9,20,30,-10,11,23,14
22938,22023,22025,53,4,17,9,2,6,40,38,2,20,14,29
22939,22023,22025,1,2,17,10,3,4,32,12,20,23,11,33
22940,22023,22025,22,1,17,10,4,3,37,21,16,24,10,34
22941,22023,22025,43,7,17,6,8,3,26,21,5,20,14,26
22942,22023,22025,57,13,17,6,1,10,23,29,-6,13,21,19
22943,22030,22050,21,5,19,9,4,6,33,27,6,22,16,31
22944,22030,22050,9,8,19,7,5,7,25,23,2,19,19,26
22945,22030,22050,4,10,19,8,1,10,28,27,1,17,21,25
22946,22030,22050,1,1,19,12,3,4,38,12,26,27,11,39
22947,22030,22050,28,15,19,5,5,9,23,31,-8,15,23,20
22948,22030,22050,38,18,19,4,5,10,16,30,-14,13,25,17
22949,22030,22050,56,9,19,7,5,7,24,27,-3,19,19,26
22950,22030,22050,27,3,19,10,3,6,30,22,8,23,15,33
22951,22030,22050,45,12,19,7,3,9,26,34,-8,17,21,24
22952,22030,22050,15,13,19,4,9,6,22,32,-10,17,21,21
22953,22030,22050,10,17,19,5,4,10,25,39,-14,14,24,19
22954,22030,22050,16,7,19,8,5,6,34,31,3,21,17,29
22955,22030,22050,49,11,19,6,7,6,22,21,1,19,19,25
22956,22030,22050,22,2,19,11,5,3,42,23,19,27,11,38
22957,22030,22050,43,4,19,8,8,3,30,22,8,24,14,32
22958,22030,22050,24,14,19,5,5,9,28,36,-8,15,23,20
22959,22030,22050,57,16,19,6,1,12,26,34,-8,13,25,19
22960,22030,22050,53,6,19,9,2,8,40,41,-1,20,18,29
22961,21925,21931,53,2,5,4,0,1,11,7,4,8,2,12
22962,21925,21931,43,6,5,2,3,0,10,6,4,7,3,9
22963,21925,21931,57,10,5,2,0,3,5,7,-2,4,6,6
22964,21925,21931,22,14,5,1,2,2,6,9,-3,4,6,5
22965,21925,21931,24,15,5,1,1,3,5,7,-2,3,7,4
22966,21925,21931,27,1,5,5,0,0,9,1,8,10,0,15
22967,21925,21931,45,9,5,2,0,3,7,8,-1,4,6,6
22968,21925,21931,15,11,5,1,3,1,4,7,-3,5,5,6
22969,21925,21931,10,17,5,1,0,4,7,14,-7,2,8,3
22970,21925,21931,49,3,5,3,1,1,6,2,4,7,3,10
22971,21925,21931,16,7,5,2,2,1,7,6,1,6,4,8
22972,21925,21931,21,8,5,2,1,2,6,7,-1,5,5,7
22973,21925,21931,9,12,5,1,2,2,4,5,-1,4,6,5
22974,21925,21931,4,16,5,1,0,4,4,7,-3,2,8,3
22975,21925,21931,56,4,5,3,1,1,7,4,3,7,3,10
22976,21925,21931,28,13,5,1,2,2,6,8,-2,4,6,5
22977,21925,21931,38,18,5,0,2,3,2,7,-5,2,8,2
22978,21925,21931,1,5,5,3,0,2,10,4,6,6,4,9
22979,21946,21959,1,2,8,6,0,2,21,5,16,12,4,18
22980,21946,21959,57,8,8,4,0,4,11,10,1,8,8,12
22981,21946,21959,22,11,8,2,4,2,12,13,-1,8,8,10
22982,21946,21959,24,14,8,2,1,5,9,14,-5,5,11,7
22983,21946,21959,53,4,8,5,0,3,16,17,-1,10,6,15
22984,20273,20279,12,12,29,8,9,12,34,39,-5,25,33,33
22985,20273,20279,1,1,29,20,1,8,63,30,33,41,17,61
22986,20273,20279,25,16,29,6,9,14,34,59,-25,21,37,27
22987,20273,20279,16,15,29,7,8,14,42,52,-10,22,36,29
22988,20273,20279,38,13,29,7,9,13,39,48,-9,23,35,30
22989,20273,20279,28,14,29,8,5,16,27,46,-19,21,37,29
22990,20273,20279,49,6,29,12,5,12,41,47,-6,29,29,41
22991,20273,20279,4,2,29,17,8,4,55,28,27,42,16,59
22992,20273,20279,9,4,29,14,7,8,54,40,14,35,23,49
22993,20070,20076,9,1,4,3,1,0,9,4,5,7,1,10
22994,20070,20076,4,2,4,2,2,0,4,2,2,6,2,8
22995,20070,20076,56,13,4,1,1,2,4,5,-1,3,5,4
22996,20070,20076,16,14,4,1,0,3,5,8,-3,2,6,3
22997,20070,20076,22,4,4,2,1,1,5,3,2,5,3,7
22998,20070,20076,43,6,4,2,1,1,7,6,1,5,3,7
22999,20070,20076,10,8,4,2,0,2,6,6,0,4,4,6
23000,20070,20076,27,10,4,1,2,1,4,5,-1,4,4,5
23001,20070,20076,45,11,4,1,1,2,5,5,0,3,5,4
23002,20070,20076,49,7,4,2,1,1,5,4,1,5,3,7
23003,20070,20076,25,12,4,1,1,2,6,7,-1,3,5,4
23004,20070,20076,28,4,4,2,1,1,5,3,2,5,3,7
23005,20070,20076,38,16,4,0,1,3,3,8,-5,1,7,1
23006,20070,20076,24,15,4,1,0,3,4,9,-5,2,6,3
23007,20070,20076,12,9,4,1,2,1,5,5,0,4,4,5
23008,20070,20076,1,3,4,2,1,1,6,3,3,5,3,7
23009,20504,20507,1,4,11,6,1,4,15,10,5,13,9,19
23010,20504,20507,45,1,11,7,2,2,20,10,10,16,6,23
23011,20504,20507,27,3,11,5,5,1,12,8,4,15,7,20
23012,20504,20507,15,13,11,3,1,7,16,28,-12,7,15,10
23013,20504,20507,10,16,11,2,3,6,12,22,-10,7,15,9
23014,20504,20507,56,9,11,4,4,3,21,19,2,12,10,16
23015,20504,20507,43,2,11,6,3,2,20,12,8,15,7,21
23016,20504,20507,22,8,11,5,2,4,14,15,-1,12,10,17
23017,20504,20507,24,10,11,4,3,4,15,13,2,11,11,15
23018,20504,20507,12,12,11,3,1,7,8,15,-7,7,15,10
23019,20504,20507,25,15,11,2,3,6,13,23,-10,7,15,9
23020,20504,20507,4,6,11,5,3,3,19,12,7,13,9,18
23021,20504,20507,9,7,11,5,3,3,17,15,2,13,9,18
23022,20504,20507,49,5,11,5,4,2,20,9,11,14,8,19
23023,20504,20507,38,11,11,3,1,7,15,22,-7,7,15,10
23024,20504,20507,28,14,11,2,3,6,12,16,-4,7,15,9
23025,20560,20566,27,4,19,9,7,3,25,19,6,25,13,34
23026,20560,20566,15,13,19,4,5,10,28,45,-17,13,25,17
23027,20560,20566,10,14,19,3,7,9,16,30,-14,13,25,16
23028,20560,20566,28,12,19,5,4,10,21,27,-6,14,24,19
23029,20560,20566,38,15,19,3,2,14,17,41,-24,8,30,11
23030,20560,20566,9,5,19,9,6,4,36,22,14,24,14,33
23031,20560,20566,4,7,19,9,5,5,29,18,11,23,15,32
23032,20560,20566,49,6,19,9,5,5,36,21,15,23,15,32
23033,20560,20566,56,10,19,6,6,7,28,34,-6,18,20,24
23034,20560,20566,24,8,19,9,4,6,27,23,4,22,16,31
23035,20560,20566,22,9,19,7,5,7,23,29,-6,19,19,26
23036,20560,20566,43,3,19,10,5,4,40,19,21,25,13,35
23037,20560,20566,12,11,19,6,4,9,19,24,-5,16,22,22
23038,20560,20566,25,16,19,2,5,12,20,45,-25,9,29,11
23039,20560,20566,45,2,19,10,6,3,31,20,11,26,12,36
23040,20560,20566,1,1,19,11,4,4,34,13,21,26,12,37
23041,20441,20447,45,1,4,3,1,0,7,1,6,7,1,10
23042,20441,20447,27,4,4,2,2,0,3,1,2,6,2,8
23043,20441,20447,15,12,4,1,1,2,4,8,-4,3,5,4
23044,20441,20447,10,15,4,0,2,2,4,7,-3,2,6,2
23045,20441,20447,43,2,4,2,2,0,9,4,5,6,2,8
23046,20441,20447,22,5,4,2,1,1,7,4,3,5,3,7
23047,20441,20447,24,9,4,1,2,1,4,4,0,4,4,5
23048,20441,20447,56,10,4,1,2,1,4,7,-3,4,4,5
23049,20441,20447,12,14,4,1,0,3,3,5,-2,2,6,3
23050,20441,20447,25,16,4,0,1,3,5,11,-6,1,7,1
23051,20441,20447,49,8,4,1,2,1,4,3,1,4,4,5
23052,20441,20447,4,3,4,2,2,0,7,4,3,6,2,8
23053,20441,20447,9,6,4,2,1,1,5,4,1,5,3,7
23054,20441,20447,28,11,4,1,1,2,2,4,-2,3,5,4
23055,20441,20447,38,13,4,1,0,3,4,6,-2,2,6,3
23056,20441,20447,1,7,4,2,0,2,4,3,1,4,4,6
23057,20994,21000,4,4,28,13,8,7,41,23,18,34,22,47
23058,20994,21000,21,8,28,9,11,8,35,38,-3,29,27,38
23059,20994,21000,9,12,28,9,6,13,37,36,1,24,32,33
23060,20994,21000,49,7,28,9,11,8,37,37,0,29,27,38
23061,20994,21000,1,1,28,18,7,3,65,32,33,43,13,61
23062,20994,21000,12,14,28,7,7,14,31,46,-15,21,35,28
23063,20994,21000,28,9,28,9,9,10,29,40,-11,27,29,36
23064,20994,21000,38,13,28,8,6,14,39,53,-14,22,34,30
23065,9276,9282,24,12,23,5,11,7,22,30,-8,21,25,26
23066,9276,9282,27,13,23,7,3,13,28,38,-10,17,29,24
23067,9276,9282,37,7,23,10,5,8,34,31,3,25,21,35
23068,9276,9282,49,8,23,9,8,6,34,23,11,26,20,35
23069,9283,9289,37,7,24,10,6,8,35,32,3,26,22,36
23070,9283,9289,49,8,24,9,9,6,35,24,11,27,21,36
23071,9283,9289,27,14,24,7,3,14,29,41,-12,17,31,24
23072,9283,9289,52,15,24,5,8,11,22,42,-20,18,30,23
23073,9283,9289,43,2,24,15,7,2,60,23,37,37,11,52
23074,9283,9289,57,9,24,9,6,9,43,37,6,24,24,33
23075,9283,9289,24,13,24,5,11,8,23,33,-10,21,27,26
23076,9283,9289,53,6,24,9,10,5,35,31,4,28,20,37
23077,9283,9289,12,11,24,7,7,10,31,42,-11,21,27,28
23078,9283,9289,20,4,24,11,5,8,38,25,13,27,21,38
23079,9283,9289,41,5,24,11,5,8,37,31,6,27,21,38
23080,9283,9289,56,12,24,7,5,12,29,35,-6,19,29,26
23081,9283,9289,13,16,24,4,10,10,16,27,-11,18,30,22
23082,9283,9289,19,17,24,4,8,12,19,44,-25,16,32,20
23083,9283,9289,17,18,24,4,6,14,23,47,-24,14,34,18
23084,9283,9289,4,3,24,12,6,6,39,25,14,30,18,42
23085,9283,9289,21,10,24,8,8,8,26,32,-6,24,24,32
23086,9283,9289,1,1,24,17,4,3,52,21,31,38,10,55
23087,9122,9124,37,3,3,2,0,1,6,5,1,4,2,6
23088,9122,9124,49,9,3,1,1,1,3,4,-1,3,3,4
23089,9122,9124,19,11,3,1,1,1,3,5,-2,3,3,4
23090,9122,9124,17,16,3,0,2,1,2,5,-3,2,4,2
23091,9122,9124,24,14,3,0,2,1,1,2,-1,2,4,2
23092,9122,9124,57,18,3,0,1,2,3,6,-3,1,5,1
23093,9122,9124,53,2,3,2,1,0,5,1,4,5,1,7
23094,9122,9124,52,12,3,0,3,0,1,1,0,3,3,3
23095,9122,9124,20,6,3,1,2,0,3,1,2,4,2,5
23096,9122,9124,41,8,3,1,1,1,5,5,0,3,3,4
23097,9122,9124,13,10,3,1,1,1,2,3,-1,3,3,4
23098,9122,9124,56,17,3,0,1,2,4,7,-3,1,5,1
23099,9122,9124,43,1,3,2,1,0,10,3,7,5,1,7
23100,9122,9124,1,7,3,1,1,1,4,3,1,3,3,4
23101,9122,9124,12,13,3,0,2,1,2,3,-1,2,4,2
23102,9122,9124,27,15,3,0,2,1,1,3,-2,2,4,2
23103,9122,9124,4,4,3,2,0,1,5,5,0,4,2,6
23104,9122,9124,21,5,3,1,2,0,4,2,2,4,2,5
23105,9339,9345,49,3,31,14,10,7,55,29,26,38,24,52
23106,9339,9345,37,7,31,13,9,9,47,36,11,35,27,48
23107,9339,9345,27,13,31,9,6,16,38,58,-20,24,38,33
23108,9339,9345,53,8,31,11,13,7,40,38,2,35,27,46
23109,9339,9345,12,11,31,9,8,14,44,60,-16,26,36,35
23110,9339,9345,52,14,31,8,9,14,32,51,-19,25,37,33
23111,9339,9345,17,17,31,5,10,16,29,56,-27,20,42,25
23112,9339,9345,19,18,31,5,9,17,21,54,-33,19,43,24
23113,9339,9345,41,4,31,14,8,9,42,34,8,36,26,50
23114,9339,9345,20,6,31,14,6,11,47,32,15,34,28,48
23115,9339,9345,13,15,31,6,11,14,20,35,-15,23,39,29
23116,9339,9345,56,16,31,7,7,17,35,51,-16,21,41,28
23117,9339,9345,43,1,31,20,8,3,76,31,45,48,14,68
23118,9339,9345,57,9,31,12,9,10,52,42,10,33,29,45
23119,9339,9345,24,12,31,6,16,9,31,41,-10,28,34,34
23120,9339,9345,4,5,31,13,10,8,45,36,9,36,26,49
23121,9339,9345,21,10,31,9,13,9,34,40,-6,31,31,40
23122,9339,9345,1,2,31,19,8,4,66,30,36,46,16,65
23123,9493,9499,21,5,1,0,1,0,1,1,0,1,1,1
23124,9493,9499,4,17,1,0,0,1,0,5,-5,0,2,0
23125,9493,9499,56,4,1,1,0,0,3,2,1,2,0,3
23126,9493,9499,41,5,1,0,1,0,1,1,0,1,1,1
23127,9493,9499,13,16,1,0,0,1,1,3,-2,0,2,0
23128,9493,9499,20,18,1,0,0,1,0,8,-8,0,2,0
23129,9493,9499,52,5,1,0,1,0,1,1,0,1,1,1
23130,9493,9499,48,13,1,0,1,0,0,0,0,1,1,1
23131,9493,9499,43,3,1,1,0,0,3,1,2,2,0,3
23132,9493,9499,24,5,1,0,1,0,1,1,0,1,1,1
23133,9493,9499,2,5,1,0,1,0,1,1,0,1,1,1
23134,9493,9499,57,15,1,0,0,1,2,3,-1,0,2,0
23135,9493,9499,1,1,1,1,0,0,8,0,8,2,0,3
23136,9493,9499,53,5,1,0,1,0,1,1,0,1,1,1
23137,9493,9499,12,5,1,0,1,0,1,1,0,1,1,1
23138,9493,9499,27,5,1,0,1,0,1,1,0,1,1,1
23139,9493,9499,49,2,1,1,0,0,5,0,5,2,0,3
23140,9493,9499,37,13,1,0,1,0,0,0,0,1,1,1
23141,9570,9576,12,5,11,5,5,1,13,10,3,15,7,20
23142,9570,9576,53,10,11,3,5,3,9,14,-5,11,11,14
23143,9570,9576,1,2,11,8,3,0,31,9,22,19,3,27
23144,9570,9576,27,4,11,6,2,3,16,13,3,14,8,20
23145,9570,9576,52,16,11,2,2,7,11,23,-12,6,16,8
23146,20805,20811,27,2,4,4,0,0,9,2,7,8,0,12
23147,20805,20811,45,3,4,3,0,1,12,2,10,6,2,9
23148,20805,20811,10,8,4,1,2,1,10,8,2,4,4,5
23149,20805,20811,15,13,4,1,0,3,4,11,-7,2,6,3
23150,20805,20811,21,6,4,2,1,1,6,6,0,5,3,7
23151,20805,20811,4,15,4,0,1,3,5,8,-3,1,7,1
23152,20805,20811,9,16,4,0,0,4,1,7,-6,0,8,0
23153,20805,20811,22,9,4,1,1,2,9,9,0,3,5,4
23154,20805,20811,43,10,4,1,1,2,3,5,-2,3,5,4
23155,20805,20811,24,14,4,0,3,1,5,6,-1,3,5,3
23156,20805,20811,12,12,4,1,0,3,3,9,-6,2,6,3
23157,20805,20811,38,4,4,3,0,1,8,7,1,6,2,9
23158,20805,20811,28,5,4,3,0,1,7,6,1,6,2,9
23159,20805,20811,56,7,4,2,0,2,4,4,0,4,4,6
23160,20805,20811,49,11,4,1,1,2,3,7,-4,3,5,4
23161,20805,20811,1,1,4,4,0,0,11,3,8,8,0,12
23162,21295,21301,1,2,20,11,5,4,47,22,25,27,13,38
23163,21295,21301,21,3,20,10,5,5,28,23,5,25,15,35
23164,21295,21301,4,7,20,9,4,7,37,33,4,22,18,31
23165,21295,21301,9,12,20,6,4,10,20,36,-16,16,24,22
23166,21295,21301,49,4,20,9,6,5,32,22,10,24,16,33
23167,21295,21301,56,10,20,6,7,7,24,28,-4,19,21,25
23168,21295,21301,27,8,20,9,3,8,32,28,4,21,19,30
23169,21295,21301,15,11,20,7,1,12,21,38,-17,15,25,22
23170,21295,21301,45,13,20,5,5,10,31,42,-11,15,25,20
23171,21295,21301,10,14,20,4,8,8,23,27,-4,16,24,20
23172,21295,21301,12,16,20,3,5,12,19,34,-15,11,29,14
23173,21295,21301,22,1,20,13,6,1,46,18,28,32,8,45
23174,21295,21301,43,6,20,9,4,7,34,27,7,22,18,31
23175,21295,21301,57,9,20,7,4,9,24,38,-14,18,22,25
23176,21295,21301,28,5,20,8,8,4,31,23,8,24,16,32
23177,21295,21301,38,15,20,4,5,11,15,25,-10,13,27,17
23178,21379,21511,4,5,30,15,5,10,53,45,8,35,25,50
23179,21379,21511,21,6,30,14,7,9,39,34,5,35,25,49
23180,21379,21511,9,14,30,6,9,15,29,52,-23,21,39,27
23181,21379,21511,22,1,30,18,9,3,63,31,32,45,15,63
23182,21379,21511,43,4,30,15,6,9,49,34,15,36,24,51
23183,21379,21511,57,13,30,7,7,16,35,59,-24,21,39,28
23184,21379,21511,27,9,30,12,6,12,43,43,0,30,30,42
23185,21379,21511,45,11,30,8,9,13,49,60,-11,25,35,33
23186,21379,21511,15,12,30,10,2,18,34,57,-23,22,38,32
23187,21379,21511,10,15,30,5,12,13,37,50,-13,22,38,27
23188,21379,21511,12,16,30,5,5,20,28,53,-25,15,45,20
23189,21379,21511,28,7,30,12,11,7,47,36,11,35,25,47
23190,21379,21511,38,10,30,11,7,12,33,33,0,29,31,40
23191,21379,21511,56,8,30,12,7,11,44,42,2,31,29,43
23192,21379,21511,49,3,30,15,8,7,49,35,14,38,22,53
23193,21379,21511,1,2,30,16,8,6,64,32,32,40,20,56
23194,21204,21210,1,1,8,7,1,0,23,7,16,15,1,22
23195,21204,21210,49,8,8,3,3,2,11,8,3,9,7,12
23196,21204,21210,56,11,8,2,2,4,9,13,-4,6,10,8
23197,21204,21210,28,7,8,3,4,1,11,8,3,10,6,13
23198,21204,21210,38,16,8,1,1,6,3,10,-7,3,13,4
23199,21204,21210,12,14,8,1,2,5,6,15,-9,4,12,5
23200,21204,21210,22,2,8,6,2,0,22,9,13,14,2,20
23201,21204,21210,43,3,8,5,1,2,17,9,8,11,5,16
23202,21204,21210,57,9,8,2,3,3,9,13,-4,7,9,9
23203,21204,21210,21,4,8,4,3,1,10,5,5,11,5,15
23204,21204,21210,4,5,8,4,1,3,16,14,2,9,7,13
23205,21204,21210,9,6,8,4,1,3,12,13,-1,9,7,13
23206,21204,21210,27,10,8,2,2,4,10,11,-1,6,10,8
23207,21204,21210,15,12,8,2,1,5,9,19,-10,5,11,7
23208,21204,21210,45,13,8,1,2,5,12,21,-9,4,12,5
23209,21204,21210,10,15,8,0,5,3,8,13,-5,5,11,5
23210,21638,21644,27,4,17,9,5,3,26,16,10,23,11,32
23211,21638,21644,45,6,17,8,4,5,26,19,7,20,14,28
23212,21638,21644,15,12,17,4,4,9,14,29,-15,12,22,16
23213,21638,21644,10,15,17,2,5,10,14,33,-19,9,25,11
23214,21638,21644,4,3,17,9,5,3,35,20,15,23,11,32
23215,21638,21644,21,5,17,9,4,4,33,24,9,22,12,31
23216,21638,21644,9,14,17,4,3,10,20,33,-13,11,23,15
23217,21638,21644,24,7,17,8,3,6,27,26,1,19,15,27
23218,21638,21644,22,8,17,6,4,7,24,25,-1,16,18,22
23219,21638,21644,43,11,17,5,6,6,21,21,0,16,18,21
23220,21638,21644,57,16,17,2,2,13,15,39,-24,6,28,8
23221,21638,21644,28,9,17,6,4,7,19,29,-10,16,18,22
23222,21638,21644,38,10,17,5,7,5,23,22,1,17,17,22
23223,21638,21644,56,13,17,4,3,10,23,30,-7,11,23,15
23224,21638,21644,49,2,17,10,3,4,33,17,16,23,11,33
23225,21638,21644,1,1,17,12,4,1,36,6,30,28,6,40
23226,8219,8225,13,16,24,2,11,11,23,52,-29,15,33,17
23227,8219,8225,12,6,24,11,6,7,32,22,10,28,20,39
23228,8219,8225,53,12,24,7,7,10,32,42,-10,21,27,28
23229,8219,8225,49,3,24,14,6,4,56,26,30,34,14,48
23230,8219,8225,37,8,24,9,9,6,48,26,22,27,21,36
23231,8219,8225,19,5,24,11,7,6,37,30,7,29,19,40
23232,8219,8225,17,11,24,8,5,11,24,35,-11,21,27,29
23233,8471,8477,21,7,12,5,3,4,18,13,5,13,11,18
23234,8471,8477,4,14,12,3,3,6,14,18,-4,9,15,12
23235,8471,8477,53,11,12,3,6,3,16,22,-6,12,12,15
23236,8471,8477,12,12,12,4,2,6,12,16,-4,10,14,14
23237,8471,8477,19,6,12,5,4,3,19,14,5,14,10,19
23238,8471,8477,17,13,12,4,1,7,17,23,-6,9,15,13
23239,8471,8477,8,17,12,2,2,8,11,29,-18,6,18,8
23240,8471,8477,37,1,12,8,4,0,22,13,9,20,4,28
23241,8471,8477,49,10,12,4,4,4,17,13,4,12,12,16
23242,8471,8477,52,18,12,1,5,6,10,18,-8,7,17,8
23243,8471,8477,13,2,12,7,3,2,24,12,12,17,7,24
23244,8471,8477,20,4,12,6,2,4,18,10,8,14,10,20
23245,8471,8477,41,15,12,3,2,7,12,22,-10,8,16,11
23246,8471,8477,56,16,12,2,4,6,10,17,-7,8,16,10
23247,8471,8477,43,3,12,6,4,2,28,15,13,16,8,22
23248,8471,8477,57,5,12,6,2,4,12,9,3,14,10,20
23249,8471,8477,24,9,12,3,8,1,18,15,3,14,10,17
23250,8471,8477,1,8,12,4,5,3,19,18,1,13,11,17
23251,8569,8582,1,5,23,10,8,5,39,25,14,28,18,38
23252,8569,8582,43,3,23,12,7,4,53,30,23,31,15,43
23253,8569,8582,57,8,23,9,5,9,25,22,3,23,23,32
23254,8569,8582,24,9,23,7,10,6,27,31,-4,24,22,31
23255,8569,8582,13,2,23,13,5,5,45,25,20,31,15,44
23256,8569,8582,20,7,23,9,5,9,32,29,3,23,23,32
23257,8569,8582,56,11,23,7,7,9,24,29,-5,21,25,28
23258,8569,8582,41,12,23,7,6,10,23,30,-7,20,26,27
23259,8569,8582,52,18,23,3,10,10,20,31,-11,16,30,19
23260,8569,8582,12,13,23,7,6,10,23,31,-8,20,26,27
23261,8569,8582,53,15,23,5,9,9,30,45,-15,19,27,24
23262,8569,8582,21,6,23,9,8,6,40,28,12,26,20,35
23263,8569,8582,4,16,23,5,4,14,23,35,-12,14,32,19
23264,8569,8582,37,1,23,16,6,1,46,24,22,38,8,54
23265,8569,8582,49,4,23,11,5,7,35,25,10,27,19,38
23266,8569,8582,19,10,23,8,6,9,30,33,-3,22,24,30
23267,8569,8582,17,14,23,7,3,13,28,42,-14,17,29,24
23268,8569,8582,8,17,23,5,4,14,20,48,-28,14,32,19
23269,8583,8589,19,10,24,8,6,10,31,36,-5,22,26,30
23270,8583,8589,17,14,24,7,3,14,28,46,-18,17,31,24
23271,8583,8589,8,16,24,6,4,14,22,48,-26,16,32,22
23272,8583,8589,37,1,24,16,6,2,47,26,21,38,10,54
23273,8583,8589,49,4,24,12,5,7,40,26,14,29,19,41
23274,8583,8589,21,7,24,9,8,7,40,31,9,26,22,35
23275,8583,8589,4,18,24,5,5,14,24,36,-12,15,33,20
23276,8583,8589,12,11,24,8,6,10,26,32,-6,22,26,30
23277,8583,8589,53,15,24,5,9,10,31,50,-19,19,29,24
23278,8583,8589,52,17,24,4,10,10,24,31,-7,18,30,22
23279,8583,8589,13,3,24,13,5,6,45,27,18,31,17,44
23280,8583,8589,20,6,24,10,5,9,37,31,6,25,23,35
23281,8583,8589,56,12,24,7,7,10,25,31,-6,21,27,28
23282,8583,8589,41,13,24,7,6,11,25,35,-10,20,28,27
23283,8583,8589,43,2,24,13,7,4,56,30,26,33,15,46
23284,8583,8589,24,8,24,8,10,6,29,32,-3,26,22,34
23285,8583,8589,57,9,24,9,6,9,26,23,3,24,24,33
23286,8583,8589,1,5,24,11,8,5,41,26,15,30,18,41
23287,8611,8617,1,4,28,13,9,6,52,33,19,35,21,48
23288,8611,8617,37,1,28,17,7,4,49,30,19,41,15,58
23289,8611,8617,13,5,28,14,5,9,53,39,14,33,23,47
23290,8611,8617,20,6,28,12,6,10,44,38,6,30,26,42
23291,8611,8617,56,11,28,9,8,11,30,33,-3,26,30,35
23292,8611,8617,41,14,28,8,6,14,30,43,-13,22,34,30
23293,8611,8617,21,8,28,10,9,9,43,38,5,29,27,39
23294,8611,8617,4,13,28,8,6,14,32,39,-7,22,34,30
23295,8611,8617,43,2,28,16,7,5,63,33,30,39,17,55
23296,8611,8617,24,9,28,9,12,7,37,37,0,30,26,39
23297,8611,8617,57,10,28,10,7,11,29,27,2,27,29,37
23298,8611,8617,52,18,28,5,10,13,27,36,-9,20,36,25
23299,8611,8617,12,12,28,9,7,12,34,40,-6,25,31,34
23300,8611,8617,53,16,28,6,10,12,37,60,-23,22,34,28
23301,8611,8617,49,3,28,14,6,8,50,36,14,34,22,48
23302,8611,8617,19,7,28,11,6,11,37,39,-2,28,28,39
23303,8611,8617,17,15,28,8,5,15,34,53,-19,21,35,29
23304,14295,14301,34,11,10,4,2,4,19,16,3,10,10,14
23305,14295,14301,25,9,10,4,3,3,20,21,-1,11,9,15
23306,14295,14301,17,2,10,7,2,1,22,11,11,16,4,23
23307,14295,14301,27,8,10,4,3,3,15,13,2,11,9,15
23308,14295,14301,12,15,10,1,4,5,12,19,-7,6,14,7
23309,14295,14301,58,18,10,0,5,5,5,20,-15,5,15,5
23310,14295,14301,1,7,10,5,1,4,21,10,11,11,9,16
23311,14295,14301,33,10,10,4,2,4,21,18,3,10,10,14
23312,14295,14301,35,6,10,5,2,3,18,15,3,12,8,17
23313,14295,14301,6,16,10,1,3,6,13,25,-12,5,15,6
23314,14295,14301,37,17,10,1,2,7,13,27,-14,4,16,5
23315,14295,14301,28,13,10,2,2,6,13,24,-11,6,14,8
23316,14295,14301,4,3,10,7,0,3,31,18,13,14,6,21
23317,14295,14301,47,14,10,1,4,5,10,16,-6,6,14,7
23318,14330,14336,47,14,15,3,4,8,20,26,-6,10,20,13
23319,14330,14336,33,9,15,6,3,6,28,23,5,15,15,21
23320,14330,14336,28,18,15,2,3,10,16,38,-22,7,23,9
23321,14330,14336,35,6,15,8,2,5,27,23,4,18,12,26
23322,14330,14336,6,17,15,1,7,7,14,30,-16,9,21,10
23323,14330,14336,1,4,15,9,1,5,33,16,17,19,11,28
23324,14330,14336,27,12,15,4,5,6,20,25,-5,13,17,17
23325,14330,14336,17,3,15,9,3,3,29,15,14,21,9,30
23326,14330,14336,49,7,15,7,1,7,24,28,-4,15,15,22
23327,14330,14336,37,15,15,2,5,8,19,32,-13,9,21,11
23328,14330,14336,43,1,15,12,2,1,44,19,25,26,4,38
23329,14330,14336,22,2,15,9,5,1,39,17,22,23,7,32
23330,14330,14336,34,10,15,6,2,7,29,25,4,14,16,20
23331,14330,14336,24,11,15,6,2,7,22,34,-12,14,16,20
23332,14330,14336,4,5,15,9,0,6,40,29,11,18,12,27
23333,14330,14336,25,8,15,6,4,5,31,32,-1,16,14,22
23334,14330,14336,12,13,15,4,5,6,25,31,-6,13,17,17
23335,14330,14336,58,16,15,1,8,6,9,26,-17,10,20,11
23336,14225,14231,4,6,2,1,0,1,5,3,2,2,2,3
23337,14225,14231,49,9,2,1,0,1,3,3,0,2,2,3
23338,14225,14231,37,18,2,0,0,2,2,7,-5,0,4,0
23339,14225,14231,43,2,2,2,0,0,8,4,4,4,0,6
23340,14225,14231,22,4,2,1,1,0,8,6,2,3,1,4
23341,14225,14231,34,7,2,1,0,1,4,3,1,2,2,3
23342,14225,14231,24,9,2,1,0,1,3,3,0,2,2,3
23343,14225,14231,25,5,2,1,1,0,8,7,1,3,1,4
23344,14225,14231,58,15,2,0,1,1,2,6,-4,1,3,1
23345,14225,14231,12,17,2,0,0,2,2,6,-4,0,4,0
23346,14225,14231,27,9,2,1,0,1,3,3,0,2,2,3
23347,14225,14231,35,8,2,1,0,1,4,4,0,2,2,3
23348,14225,14231,6,12,2,1,0,1,2,3,-1,2,2,3
23349,14225,14231,33,13,2,0,1,1,3,4,-1,1,3,1
23350,14225,14231,28,16,2,0,1,1,1,5,-4,1,3,1
23351,14225,14231,47,14,2,0,1,1,2,3,-1,1,3,1
23352,14225,14231,17,3,2,2,0,0,6,3,3,4,0,6
23353,14225,14231,1,1,2,2,0,0,9,2,7,4,0,6
23354,14435,14441,1,4,26,14,4,8,54,27,27,32,20,46
23355,14435,14441,47,13,26,8,4,14,43,52,-9,20,32,28
23356,14435,14441,33,5,26,14,4,8,56,38,18,32,20,46
23357,14435,14441,28,15,26,6,4,16,29,56,-27,16,36,22
23358,14435,14441,35,8,26,12,6,8,43,37,6,30,22,42
23359,14435,14441,6,18,26,2,10,14,25,54,-29,14,38,16
23360,14435,14441,27,16,26,5,6,15,31,53,-22,16,36,21
23361,14435,14441,17,6,26,13,5,8,54,34,20,31,21,44
23362,14435,14441,25,9,26,11,6,9,48,57,-9,28,24,39
23363,14435,14441,12,11,26,9,7,10,44,50,-6,25,27,34
23364,14435,14441,58,17,26,3,9,14,21,48,-27,15,37,18
23365,14435,14441,49,2,26,17,2,7,60,37,23,36,16,53
23366,14435,14441,37,14,26,7,6,13,38,50,-12,20,32,27
23367,14435,14441,43,1,26,19,6,1,71,25,46,44,8,63
23368,14435,14441,22,7,26,12,6,8,52,44,8,30,22,42
23369,14435,14441,24,10,26,10,4,12,40,56,-16,24,28,34
23370,14435,14441,34,12,26,10,2,14,46,55,-9,22,30,32
23371,14435,14441,4,3,26,16,1,9,63,45,18,33,19,49
23372,14491,14497,4,3,33,20,3,10,76,51,25,43,23,63
23373,14491,14497,43,1,33,22,8,3,85,35,50,52,14,74
23374,14491,14497,22,9,33,15,6,12,60,58,2,36,30,51
23375,14491,14497,24,11,33,12,5,16,46,74,-28,29,37,41
23376,14491,14497,34,13,33,11,3,19,52,71,-19,25,41,36
23377,14491,14497,25,6,33,15,8,10,70,64,6,38,28,53
23378,14491,14497,12,10,33,11,11,11,54,57,-3,33,33,44
23379,14491,14497,58,17,33,5,13,15,32,58,-26,23,43,28
23380,14491,14497,17,7,33,15,7,11,64,45,19,37,29,52
23381,14491,14497,27,16,33,7,9,17,41,61,-20,23,43,30
23382,14491,14497,49,4,33,18,2,13,65,49,16,38,28,56
23383,21946,21959,28,16,8,1,3,4,6,13,-7,5,11,6
23384,21946,21959,38,18,8,0,3,5,3,12,-9,3,13,3
23385,21946,21959,45,15,8,2,1,5,10,18,-8,5,11,7
23386,21946,21959,10,17,8,1,1,6,12,22,-10,3,13,4
23387,21946,21959,56,10,8,3,2,3,9,9,0,8,8,11
23388,21946,21959,49,3,8,5,2,1,12,6,6,12,4,17
23389,21946,21959,16,6,8,4,2,2,13,12,1,10,6,14
23390,21946,21959,21,5,8,4,2,2,15,11,4,10,6,14
23391,21946,21959,9,9,8,3,3,2,12,8,4,9,7,12
23392,21946,21959,4,12,8,3,0,5,12,11,1,6,10,9
23393,21946,21959,27,1,8,6,1,1,14,5,9,13,3,19
23394,21946,21959,15,13,8,1,5,2,8,12,-4,7,9,8
23395,21946,21959,43,7,8,3,4,1,15,12,3,10,6,13
23396,22310,22323,56,8,10,4,3,3,14,12,2,11,9,15
23397,22310,22323,13,13,10,4,0,6,13,17,-4,8,12,12
23398,22310,22323,22,5,10,5,2,3,21,15,6,12,8,17
23399,22310,22323,24,6,10,5,1,4,18,19,-1,11,9,16
23400,22310,22323,43,7,10,4,4,2,19,12,7,12,8,16
23401,22310,22323,57,17,10,2,2,6,11,16,-5,6,14,8
23402,22310,22323,15,1,10,6,2,2,21,12,9,14,6,20
23403,22310,22323,39,3,10,6,1,3,20,9,11,13,7,19
23404,22310,22323,27,11,10,3,5,2,17,13,4,11,9,14
23405,22310,22323,45,15,10,2,3,5,15,23,-8,7,13,9
23406,22310,22323,49,12,10,4,1,5,10,17,-7,9,11,13
23407,22310,22323,16,16,10,1,6,3,9,17,-8,8,12,9
23408,22310,22323,53,18,10,0,2,8,7,22,-15,2,18,2
23409,22310,22323,28,9,10,4,2,4,10,12,-2,10,10,14
23410,22310,22323,21,2,10,6,2,2,20,13,7,14,6,20
23411,22310,22323,9,10,10,4,2,4,14,18,-4,10,10,14
23412,22310,22323,4,14,10,3,2,5,16,13,3,8,12,11
23413,22310,22323,1,4,10,5,4,1,18,13,5,14,6,19
23414,22387,22393,1,2,20,11,7,2,41,26,15,29,11,40
23415,22387,22393,28,15,20,6,3,11,20,31,-11,15,25,21
23416,22387,22393,53,18,20,2,3,15,15,35,-20,7,33,9
23417,22387,22393,39,1,20,15,1,4,50,20,30,31,9,46
23418,22387,22393,27,4,20,10,5,5,38,26,12,25,15,35
23419,22387,22393,15,11,20,7,4,9,30,34,-4,18,22,25
23420,22387,22393,45,16,20,5,5,10,30,45,-15,15,25,20
23421,22387,22393,56,7,20,8,7,5,26,22,4,23,17,31
23422,22387,22393,13,17,20,6,1,13,23,40,-17,13,27,19
23423,22387,22393,49,10,20,7,5,8,23,33,-10,19,21,26
23424,22387,22393,16,13,20,5,8,7,26,34,-8,18,22,23
23425,22387,22393,21,3,20,11,4,5,37,24,13,26,14,37
23426,22387,22393,4,6,20,10,3,7,33,22,11,23,17,33
23427,22387,22393,9,12,20,7,2,11,23,39,-16,16,24,23
23428,22387,22393,43,5,20,9,8,3,43,26,17,26,14,35
23429,22387,22393,24,8,20,9,3,8,35,37,-2,21,19,30
23430,22387,22393,22,9,20,7,5,8,36,33,3,19,21,26
23431,22387,22393,57,14,20,6,4,10,26,28,-2,16,24,22
23432,22681,22687,22,2,11,9,1,1,26,11,15,19,3,28
23433,22681,22687,43,9,11,5,1,5,19,12,7,11,11,16
23434,22681,22687,24,12,11,3,2,6,17,21,-4,8,14,11
23435,22681,22687,57,17,11,2,3,6,10,20,-10,7,15,9
23436,22681,22687,25,7,11,6,0,5,20,18,2,12,10,18
23437,22681,22687,4,8,11,5,2,4,20,14,6,12,10,17
23438,22681,22687,9,13,11,3,2,6,12,16,-4,8,14,11
23439,22681,22687,16,5,11,6,2,3,21,18,3,14,8,20
23440,22681,22687,49,6,11,6,1,4,16,15,1,13,9,19
23441,22681,22687,13,14,11,3,1,7,11,19,-8,7,15,10
23442,22681,22687,56,15,11,3,1,7,9,18,-9,7,15,10
23443,22681,22687,39,4,11,7,1,3,19,15,4,15,7,22
23444,22681,22687,27,10,11,5,0,6,16,17,-1,10,12,15
23445,22681,22687,15,16,11,3,0,8,9,20,-11,6,16,9
23446,22681,22687,45,18,11,1,2,8,9,25,-16,4,18,5
23447,22681,22687,28,11,11,3,4,4,10,11,-1,10,12,13
23448,22681,22687,1,3,11,7,1,3,22,12,10,15,7,22
23449,22681,22687,21,1,11,10,0,1,24,8,16,20,2,30
23450,22688,22691,1,3,12,8,1,3,23,12,11,17,7,25
23451,22688,22691,28,10,12,4,4,4,12,12,0,12,12,16
23452,22688,22691,39,4,12,8,1,3,25,16,9,17,7,25
23453,22688,22691,27,11,12,5,0,7,17,19,-2,10,14,15
23454,22688,22691,15,17,12,3,0,9,10,25,-15,6,18,9
23455,22688,22691,45,18,12,2,2,8,12,26,-14,6,18,8
23456,22688,22691,13,14,12,3,2,7,13,21,-8,8,16,11
23457,22688,22691,56,16,12,3,1,8,10,21,-11,7,17,10
23458,22688,22691,49,5,12,7,1,4,19,15,4,15,9,22
23459,22688,22691,16,7,12,6,2,4,21,19,2,14,10,20
23460,22688,22691,21,2,12,10,0,2,24,11,13,20,4,30
23461,22688,22691,4,6,12,6,2,4,23,14,9,14,10,20
23462,22688,22691,9,15,12,3,2,7,13,22,-9,8,16,11
23463,21519,21525,1,1,2,2,0,0,9,1,8,4,0,6
23464,21519,21525,49,3,2,2,0,0,6,0,6,4,0,6
23465,21519,21525,56,10,2,0,1,1,2,3,-1,1,3,1
23466,21519,21525,38,7,2,1,1,0,1,0,1,3,1,4
23467,21519,21525,28,15,2,0,0,2,0,7,-7,0,4,0
23468,21519,21525,24,4,2,2,0,0,5,1,4,4,0,6
23469,21519,21525,22,8,2,1,0,1,3,4,-1,2,2,3
23470,21519,21525,43,11,2,0,1,1,1,2,-1,1,3,1
23471,21519,21525,57,12,2,0,0,2,1,5,-4,0,4,0
23472,21519,21525,27,9,2,0,2,0,2,2,0,2,2,2
23473,21519,21525,10,13,2,0,0,2,2,7,-5,0,4,0
23474,21519,21525,45,14,2,0,0,2,0,6,-6,0,4,0
23475,21519,21525,15,16,2,0,0,2,2,10,-8,0,4,0
23476,21519,21525,21,2,2,2,0,0,8,2,6,4,0,6
23477,21519,21525,9,5,2,2,0,0,5,2,3,4,0,6
23478,21519,21525,4,6,2,1,1,0,7,2,5,3,1,4
23479,21715,21721,4,2,26,15,7,4,54,28,26,37,15,52
23480,21715,21721,21,4,26,13,8,5,45,30,15,34,18,47
23481,21715,21721,9,14,26,6,3,17,25,50,-25,15,37,21
23482,21715,21721,22,6,26,11,5,10,39,38,1,27,25,38
23483,21715,21721,24,7,26,11,4,11,38,42,-4,26,26,37
23484,21715,21721,43,9,26,8,10,8,29,28,1,26,26,34
23485,21715,21721,57,16,26,5,2,19,24,52,-28,12,40,17
23486,21715,21721,38,10,26,8,9,9,36,37,-1,25,27,33
23487,21715,21721,28,12,26,9,5,12,32,43,-11,23,29,32
23488,21715,21721,27,3,26,13,9,4,43,21,22,35,17,48
23489,21715,21721,45,8,26,10,4,12,38,39,-1,24,28,34
23490,21715,21721,15,13,26,7,5,14,24,43,-19,19,33,26
23491,21715,21721,10,15,26,5,5,16,21,52,-31,15,37,20
23492,21715,21721,49,5,26,13,6,7,46,30,16,32,20,45
23493,21715,21721,56,11,26,9,5,12,38,40,-2,23,29,32
23494,21715,21721,1,1,26,18,7,1,53,12,41,43,9,61
23495,21722,21728,1,1,27,19,7,1,54,12,42,45,9,64
23496,21722,21728,56,11,27,9,5,13,38,41,-3,23,31,32
23497,21722,21728,49,3,27,14,6,7,47,30,17,34,20,48
23498,21722,21728,27,4,27,13,9,5,43,22,21,35,19,48
23499,21722,21728,45,9,27,10,5,12,39,40,-1,25,29,35
23500,21722,21728,15,13,27,7,5,15,25,49,-24,19,35,26
23501,21722,21728,10,16,27,5,5,17,21,56,-35,15,39,20
23502,21722,21728,38,10,27,8,9,10,36,38,-2,25,29,33
23503,21722,21728,28,12,27,9,5,13,33,47,-14,23,31,32
23504,21722,21728,22,6,27,12,5,10,40,38,2,29,25,41
23505,21722,21728,24,7,27,12,4,11,42,42,0,28,26,40
23506,21722,21728,43,8,27,9,10,8,35,29,6,28,26,37
23507,21722,21728,57,15,27,6,2,19,25,52,-27,14,40,20
23508,21722,21728,4,2,27,16,7,4,58,29,29,39,15,55
23509,21722,21728,21,5,27,13,8,6,45,31,14,34,20,47
23510,21722,21728,9,14,27,6,4,17,26,51,-25,16,38,22
23511,22062,22064,22,2,22,12,5,5,47,30,17,29,15,41
23512,22062,22064,43,5,22,8,10,4,31,25,6,26,18,34
23513,22062,22064,24,11,22,8,5,9,35,38,-3,21,23,29
23514,22062,22064,57,17,22,7,1,14,29,38,-9,15,29,22
23515,22062,22064,53,6,22,10,3,9,43,44,-1,23,21,33
23516,22062,22064,28,14,22,6,6,10,27,35,-8,18,26,24
23517,22062,22064,38,15,22,6,6,10,21,31,-10,18,26,24
23518,22062,22064,27,4,22,10,4,8,33,27,6,24,20,34
23519,22062,22064,45,12,22,8,3,11,33,41,-8,19,25,27
23520,22062,22064,15,16,22,5,9,8,24,37,-13,19,25,24
23521,22062,22064,10,18,22,5,5,12,28,47,-19,15,29,20
23522,22062,22064,49,8,22,8,8,6,28,25,3,24,20,32
23523,22062,22064,16,9,22,8,6,8,36,38,-2,22,22,30
23524,22062,22064,21,3,22,11,4,7,37,29,8,26,18,37
23525,22062,22064,9,7,22,9,6,7,31,27,4,24,20,33
23526,22062,22064,4,10,22,9,2,11,32,29,3,20,24,29
23527,22062,22064,56,13,22,7,6,9,26,31,-5,20,24,27
23528,22062,22064,1,1,22,15,3,4,46,15,31,33,11,48
23529,22076,22078,1,1,25,18,3,4,53,17,36,39,11,57
23530,22076,22078,56,14,25,8,6,11,30,36,-6,22,28,30
23531,22076,22078,49,8,25,9,9,7,34,29,5,27,23,36
23532,22076,22078,16,9,25,9,7,9,40,42,-2,25,25,34
23533,22076,22078,28,13,25,8,6,11,33,38,-5,22,28,30
23534,22076,22078,38,16,25,6,8,11,23,36,-13,20,30,26
23535,22076,22078,53,6,25,11,3,11,46,49,-3,25,25,36
23536,22076,22078,27,5,25,11,5,9,37,32,5,27,23,38
23537,22076,22078,45,12,25,9,4,12,38,46,-8,22,28,31
23538,22076,22078,15,15,25,6,11,8,30,41,-11,23,27,29
23539,22076,22078,10,18,25,5,6,14,31,53,-22,16,34,21
23540,22076,22078,22,3,25,12,7,6,49,33,16,31,19,43
23541,22076,22078,43,4,25,10,11,4,36,26,10,31,19,41
23542,9570,9576,48,18,11,0,3,8,4,26,-22,3,19,3
23543,9570,9576,41,7,11,5,4,2,17,11,6,14,8,19
23544,9570,9576,56,11,11,3,3,5,15,14,1,9,13,12
23545,9570,9576,13,12,11,3,3,5,13,17,-4,9,13,12
23546,9570,9576,20,15,11,3,1,7,10,23,-13,7,15,10
23547,9570,9576,4,14,11,3,1,7,9,21,-12,7,15,10
23548,9570,9576,21,17,11,0,3,8,6,22,-16,3,19,3
23549,9570,9576,49,3,11,6,3,2,20,8,12,15,7,21
23550,9570,9576,37,8,11,4,7,0,15,6,9,15,7,19
23551,9570,9576,43,1,11,9,1,1,29,5,24,19,3,28
23552,9570,9576,24,6,11,5,4,2,16,7,9,14,8,19
23553,9570,9576,2,9,11,4,3,4,12,17,-5,11,11,15
23554,9570,9576,57,13,11,3,1,7,15,15,0,7,15,10
23555,9846,9849,2,3,1,1,0,0,2,1,1,2,0,3
23556,9846,9849,43,4,1,1,0,0,1,0,1,2,0,3
23557,9846,9849,57,9,1,0,1,0,0,0,0,1,1,1
23558,9846,9849,24,9,1,0,1,0,0,0,0,1,1,1
23559,9846,9849,22,17,1,0,0,1,0,2,-2,0,2,0
23560,9846,9849,49,13,1,0,0,1,1,2,-1,0,2,0
23561,9846,9849,37,14,1,0,0,1,0,1,-1,0,2,0
23562,9846,9849,41,2,1,1,0,0,2,0,2,2,0,3
23563,9846,9849,27,14,1,0,0,1,0,1,-1,0,2,0
23564,9846,9849,53,9,1,0,1,0,0,0,0,1,1,1
23565,9846,9849,52,7,1,0,1,0,1,1,0,1,1,1
23566,9846,9849,28,9,1,0,1,0,0,0,0,1,1,1
23567,9846,9849,20,7,1,0,1,0,1,1,0,1,1,1
23568,9846,9849,56,18,1,0,0,1,0,3,-3,0,2,0
23569,9846,9849,12,4,1,1,0,0,1,0,1,2,0,3
23570,9846,9849,21,1,1,1,0,0,3,0,3,2,0,3
23571,9846,9849,4,14,1,0,0,1,0,1,-1,0,2,0
23572,9846,9849,1,4,1,1,0,0,1,0,1,2,0,3
23573,9878,9884,1,4,7,4,2,1,12,7,5,10,4,14
23574,9878,9884,12,6,7,3,3,1,10,8,2,9,5,12
23575,9878,9884,49,7,7,3,2,2,13,8,5,8,6,11
23576,9878,9884,37,13,7,2,1,4,10,10,0,5,9,7
23577,9878,9884,20,5,7,4,1,2,16,10,6,9,5,13
23578,9878,9884,41,10,7,2,4,1,11,8,3,8,6,10
23579,9878,9884,56,17,7,0,3,4,7,16,-9,3,11,3
23580,9878,9884,28,8,7,3,2,2,7,8,-1,8,6,11
23581,9878,9884,52,12,7,2,2,3,8,13,-5,6,8,8
23582,9878,9884,53,9,7,3,1,3,5,9,-4,7,7,10
23583,9878,9884,27,16,7,1,2,4,7,10,-3,4,10,5
23584,9878,9884,21,2,7,4,3,0,17,7,10,11,3,15
23585,9878,9884,4,18,7,0,0,7,6,17,-11,0,14,0
23586,9878,9884,24,1,7,5,1,1,10,4,6,11,3,16
23587,9878,9884,43,3,7,4,3,0,12,2,10,11,3,15
23588,9878,9884,22,11,7,3,0,4,8,16,-8,6,8,9
23589,9878,9884,2,14,7,2,1,4,7,12,-5,5,9,7
23590,9878,9884,57,15,7,1,3,3,8,9,-1,5,9,6
23591,10263,10276,17,14,12,2,4,6,9,20,-11,8,16,10
23592,10263,10276,24,1,12,9,3,0,25,8,17,21,3,30
23593,10263,10276,43,2,12,9,2,1,28,10,18,20,4,29
23594,10263,10276,57,16,12,2,3,7,11,19,-8,7,17,9
23595,10263,10276,22,17,12,1,6,5,6,22,-16,8,16,9
23596,10263,10276,49,7,12,5,3,4,17,15,2,13,11,18
23597,10263,10276,37,12,12,3,3,6,14,15,-1,9,15,12
23598,10263,10276,41,3,12,7,4,1,25,8,17,18,6,25
23599,10263,10276,20,8,12,5,2,5,18,22,-4,12,12,17
23600,10263,10276,56,9,12,4,3,5,21,21,0,11,13,15
23601,10263,10276,27,15,12,2,4,6,8,22,-14,8,16,10
23602,10263,10276,28,6,12,5,4,3,14,15,-1,14,10,19
23603,10263,10276,52,10,12,4,2,6,9,15,-6,10,14,14
23604,10263,10276,54,18,12,2,2,8,14,22,-8,6,18,8
23605,10263,10276,1,4,12,7,2,3,27,13,14,16,8,23
23606,10263,10276,53,11,12,3,4,5,17,22,-5,10,14,13
23607,10263,10276,12,13,12,3,3,6,14,17,-3,9,15,12
23608,10263,10276,21,5,12,6,4,2,25,16,9,16,8,22
23609,10410,10416,21,5,24,12,8,4,48,28,20,32,16,44
23610,10410,10416,41,3,24,13,8,3,49,16,33,34,14,47
23611,10410,10416,20,7,24,10,4,10,38,36,2,24,24,34
23612,10410,10416,56,9,24,7,11,6,38,32,6,25,23,32
23613,10410,10416,28,8,24,9,6,9,27,36,-9,24,24,33
23614,10410,10416,52,12,24,7,3,14,23,45,-22,17,31,24
23615,10410,10416,54,14,24,6,5,13,26,44,-18,17,31,23
23616,10410,10416,12,11,24,6,8,10,31,36,-5,20,28,26
23617,10410,10416,53,15,24,5,8,11,27,40,-13,18,30,23
23618,10410,10416,17,13,24,6,6,12,17,37,-20,18,30,24
23619,10410,10416,27,16,24,4,11,9,20,38,-18,19,29,23
23620,10410,10416,49,6,24,11,6,7,36,30,6,28,20,39
23621,10410,10416,37,10,24,8,5,11,28,34,-6,21,27,29
23622,10410,10416,24,1,24,18,5,1,49,14,35,41,7,59
23623,20994,21000,56,6,28,11,6,11,39,37,2,28,28,39
23624,20994,21000,43,3,28,14,7,7,44,39,5,35,21,49
23625,20994,21000,22,5,28,10,11,7,42,34,8,31,25,41
23626,20994,21000,24,16,28,5,9,14,27,46,-19,19,37,24
23627,20994,21000,27,2,28,13,11,4,46,28,18,37,19,50
23628,20994,21000,10,10,28,9,8,11,50,48,2,26,30,35
23629,20994,21000,45,11,28,10,4,14,43,49,-6,24,32,34
23630,20994,21000,15,15,28,5,9,14,36,55,-19,19,37,24
23631,21008,21147,27,3,30,13,12,5,46,30,16,38,22,51
23632,21008,21147,45,9,30,11,4,15,47,52,-5,26,34,37
23633,21008,21147,10,12,30,9,8,13,50,51,-1,26,34,35
23634,21008,21147,15,15,30,6,9,15,40,57,-17,21,39,27
23635,21008,21147,43,2,30,16,7,7,49,42,7,39,21,55
23636,21008,21147,22,5,30,11,11,8,44,36,8,33,27,44
23637,21008,21147,24,16,30,6,9,15,31,49,-18,21,39,27
23638,21008,21147,56,7,30,12,6,12,42,39,3,30,30,42
23639,21008,21147,28,10,30,9,10,11,29,41,-12,28,32,37
23640,21008,21147,38,14,30,8,6,16,40,59,-19,22,38,30
23641,21008,21147,12,13,30,8,7,15,33,49,-16,23,37,31
23642,21008,21147,1,1,30,20,7,3,68,33,35,47,13,67
23643,21008,21147,49,6,30,11,11,8,43,41,2,33,27,44
23644,21008,21147,4,4,30,14,8,8,45,27,18,36,24,50
23645,21008,21147,21,8,30,10,11,9,38,40,-2,31,29,41
23646,21008,21147,9,11,30,10,6,14,42,41,1,26,34,36
23647,20826,20832,21,5,6,3,2,1,11,10,1,8,4,11
23648,20826,20832,4,15,6,0,3,3,6,9,-3,3,9,3
23649,20826,20832,9,16,6,0,1,5,5,12,-7,1,11,1
23650,20826,20832,22,8,6,2,2,2,11,10,1,6,6,8
23651,20826,20832,27,1,6,5,1,0,12,4,8,11,1,16
23652,20826,20832,45,6,6,3,1,2,16,7,9,7,5,10
23653,20826,20832,10,7,6,2,2,2,15,10,5,6,6,8
23654,20826,20832,15,14,6,1,0,5,5,19,-14,2,10,3
23655,20826,20832,12,11,6,2,0,4,8,12,-4,4,8,6
23656,20826,20832,38,3,6,4,1,1,11,9,2,9,3,13
23657,20826,20832,28,4,6,4,1,1,9,7,2,9,3,13
23658,20826,20832,56,9,6,2,2,2,7,7,0,6,6,8
23659,20826,20832,49,12,6,1,2,3,3,11,-8,4,8,5
23660,20826,20832,43,10,6,2,2,2,6,7,-1,6,6,8
23661,20826,20832,24,13,6,0,4,2,6,8,-2,4,8,4
23662,20826,20832,1,2,6,5,0,1,16,5,11,10,2,15
23663,21243,21245,27,8,13,5,2,6,18,18,0,12,14,17
23664,21243,21245,15,9,13,5,1,7,18,25,-7,11,15,16
23665,21243,21245,10,13,13,1,8,4,15,18,-3,10,16,11
23666,21243,21245,45,15,13,2,3,8,20,33,-13,7,19,9
23667,21243,21245,22,1,13,10,3,0,38,14,24,23,3,33
23668,21243,21245,43,4,13,7,3,3,25,15,10,17,9,24
23669,21243,21245,57,12,13,3,4,6,14,25,-11,10,16,13
23670,21243,21245,21,3,13,7,4,2,19,13,6,18,8,25
23671,21243,21245,4,5,13,6,2,5,26,25,1,14,12,20
23672,21243,21245,9,11,13,4,3,6,14,25,-11,11,15,15
23673,21243,21245,49,6,13,5,5,3,19,14,5,15,11,20
23674,21243,21245,56,10,13,4,4,5,19,21,-2,12,14,16
23675,21243,21245,38,14,13,2,3,8,9,19,-10,7,19,9
23676,21243,21245,12,16,13,1,4,8,10,23,-13,6,20,7
23677,21243,21245,28,7,13,4,6,3,17,15,2,14,12,18
23678,21243,21245,1,2,13,9,3,1,35,13,22,21,5,30
23679,21281,21287,28,5,18,8,7,3,31,21,10,23,13,31
23680,21281,21287,38,14,18,3,5,10,12,23,-11,11,25,14
23681,21281,21287,56,9,18,6,5,7,24,28,-4,17,19,23
23682,21281,21287,49,8,18,7,6,5,25,20,5,20,16,27
23683,21281,21287,21,2,18,10,5,3,27,16,11,25,11,35
23684,21281,21287,4,6,18,8,4,6,33,30,3,20,16,28
23685,21281,21287,9,11,18,6,4,8,19,31,-12,16,20,22
23686,21281,21287,22,1,18,11,6,1,42,18,24,28,8,39
23687,21281,21287,43,4,18,9,4,5,32,22,10,22,14,31
23688,21281,21287,57,10,18,6,4,8,21,33,-12,16,20,22
23689,21281,21287,27,7,18,8,3,7,29,25,4,19,17,27
23690,21281,21287,15,12,18,6,1,11,20,36,-16,13,23,19
23691,21281,21287,45,13,18,4,5,9,27,37,-10,13,23,17
23692,21281,21287,10,15,18,2,8,8,19,26,-7,12,24,14
23693,21281,21287,1,3,18,10,4,4,42,21,21,24,12,34
23694,21281,21287,12,16,18,2,5,11,16,32,-16,9,27,11
23695,21197,21203,27,10,7,2,1,4,9,10,-1,5,9,7
23696,21197,21203,15,11,7,2,1,4,8,17,-9,5,9,7
23697,21197,21203,45,13,7,1,2,4,12,19,-7,4,10,5
23698,21197,21203,10,15,7,0,4,3,7,12,-5,4,10,4
23699,21197,21203,22,2,7,5,2,0,17,7,10,12,2,17
23700,21197,21203,43,4,7,4,1,2,15,8,7,9,5,13
23701,21197,21203,57,9,7,2,3,2,7,8,-1,7,7,9
23702,22076,22078,24,10,25,9,6,10,36,42,-6,24,26,33
23703,22076,22078,57,17,25,7,1,17,29,43,-14,15,35,22
23704,22076,22078,21,2,25,14,4,7,43,32,11,32,18,46
23705,22076,22078,9,7,25,10,6,9,36,32,4,26,24,36
23706,22076,22078,4,11,25,9,5,11,35,32,3,23,27,32
23707,22107,22113,21,2,30,15,6,9,48,40,8,36,24,51
23708,22107,22113,9,4,30,13,7,10,45,37,8,33,27,46
23709,22107,22113,4,11,30,11,7,12,42,38,4,29,31,40
23710,22107,22113,22,3,30,14,7,9,56,41,15,35,25,49
23711,22107,22113,43,5,30,11,13,6,40,31,9,35,25,46
23712,22107,22113,24,10,30,11,8,11,43,47,-4,30,30,41
23713,22107,22113,57,17,30,9,2,19,34,48,-14,20,40,29
23714,22107,22113,45,8,30,13,4,13,46,53,-7,30,30,43
23715,22107,22113,27,9,30,11,8,11,42,39,3,30,30,41
23716,22107,22113,15,13,30,8,13,9,38,47,-9,29,31,37
23717,22107,22113,10,18,30,6,7,17,35,61,-26,19,41,25
23718,22107,22113,53,6,30,13,5,12,54,56,-2,31,29,44
23719,22107,22113,28,15,30,8,8,14,35,44,-9,24,36,32
23720,22107,22113,38,16,30,7,9,14,27,45,-18,23,37,30
23721,22107,22113,56,14,30,10,6,14,38,46,-8,26,34,36
23722,22107,22113,16,7,30,12,8,10,49,49,0,32,28,44
23723,22107,22113,49,12,30,10,10,10,41,38,3,30,30,40
23724,22107,22113,1,1,30,22,4,4,66,19,47,48,12,70
23725,22380,22383,1,2,18,10,6,2,35,23,12,26,10,36
23726,22380,22383,43,5,18,8,7,3,39,24,15,23,13,31
23727,22380,22383,24,7,18,8,3,7,29,31,-2,19,17,27
23728,22380,22383,22,11,18,6,4,8,31,30,1,16,20,22
23729,22380,22383,57,16,18,5,4,9,22,25,-3,14,22,19
23730,22380,22383,49,10,18,6,5,7,21,31,-10,17,19,23
23731,22380,22383,16,14,18,4,8,6,23,29,-6,16,20,20
23732,22380,22383,56,9,18,6,7,5,22,22,0,19,17,25
23733,22380,22383,13,15,18,6,1,11,23,36,-13,13,23,19
23734,22380,22383,28,12,18,6,3,9,19,27,-8,15,21,21
23735,22380,22383,39,1,18,13,1,4,45,18,27,27,9,40
23736,22380,22383,27,4,18,9,5,4,32,22,10,23,13,32
23737,22380,22383,15,8,18,7,4,7,28,26,2,18,18,25
23738,22380,22383,45,17,18,4,5,9,27,41,-14,13,23,17
23739,22380,22383,53,18,18,2,3,13,15,32,-17,7,29,9
23740,22380,22383,21,3,18,10,3,5,32,21,11,23,13,33
23741,22380,22383,4,6,18,9,3,6,28,17,11,21,15,30
23742,22380,22383,9,13,18,6,2,10,21,37,-16,14,22,20
23743,22415,22421,21,2,22,13,4,5,42,24,18,30,14,43
23744,22415,22421,4,5,22,10,5,7,35,24,11,25,19,35
23745,22415,22421,9,15,22,7,3,12,23,43,-20,17,27,24
23746,22415,22421,45,16,22,6,6,10,31,45,-14,18,26,24
23747,22415,22421,53,18,22,2,3,17,16,46,-30,7,37,9
23748,22415,22421,39,1,22,16,2,4,54,20,34,34,10,50
23749,22415,22421,27,6,22,10,5,7,38,32,6,25,19,35
23750,22415,22421,15,13,22,7,4,11,30,38,-8,18,26,25
23751,22415,22421,28,14,22,7,3,12,22,33,-11,17,27,24
23752,22415,22421,56,9,22,8,8,6,28,26,2,24,20,32
23753,22415,22421,13,17,22,6,1,15,23,46,-23,13,31,19
23754,22415,22421,16,10,22,7,8,7,34,34,0,22,22,29
23755,22415,22421,49,12,22,7,6,9,24,35,-11,20,24,27
23756,22415,22421,43,4,22,10,9,3,51,27,24,29,15,39
23757,22415,22421,24,7,22,10,3,9,37,42,-5,23,21,33
23758,22415,22421,22,8,22,9,5,8,44,34,10,23,21,32
23759,22415,22421,57,11,22,8,4,10,30,28,2,20,24,28
23760,22415,22421,1,3,22,12,7,3,43,28,15,31,13,43
23761,22429,22435,1,3,25,13,9,3,46,30,16,35,15,48
23762,22429,22435,43,4,25,11,9,5,52,30,22,31,19,42
23763,22429,22435,24,7,25,11,3,11,40,48,-8,25,25,36
23764,22429,22435,22,8,25,10,5,10,50,39,11,25,25,35
23765,22429,22435,57,9,25,10,4,11,35,30,5,24,26,34
23766,22429,22435,16,11,25,8,9,8,38,39,-1,25,25,33
23767,22429,22435,49,12,25,8,7,10,29,39,-10,23,27,31
23768,22429,22435,56,10,25,8,10,7,30,29,1,26,24,34
23769,22429,22435,13,17,25,7,2,16,26,50,-24,16,34,23
23770,22429,22435,28,13,25,8,4,13,26,36,-10,20,30,28
23771,22429,22435,53,18,25,3,4,18,23,52,-29,10,40,13
23772,22429,22435,15,15,25,7,6,12,31,41,-10,20,30,27
23773,22429,22435,45,16,25,6,8,11,36,52,-16,20,30,26
23774,22429,22435,39,1,25,18,3,4,57,21,36,39,11,57
23775,22429,22435,27,5,25,11,7,7,40,33,7,29,21,40
23776,22429,22435,21,2,25,15,5,5,46,26,20,35,15,50
23777,22429,22435,4,6,25,10,7,8,36,26,10,27,23,37
23778,22429,22435,9,14,25,8,4,13,26,46,-20,20,30,28
23779,22464,22470,21,3,30,17,5,8,51,35,16,39,21,56
23780,22688,22691,25,8,12,6,1,5,22,20,2,13,11,19
23781,22688,22691,22,1,12,10,1,1,27,11,16,21,3,31
23782,22688,22691,43,9,12,5,1,6,19,13,6,11,13,16
23783,22688,22691,57,12,12,3,3,6,15,21,-6,9,15,12
23784,22688,22691,24,13,12,3,2,7,17,24,-7,8,16,11
23785,22786,22792,22,1,22,18,2,2,53,20,33,38,6,56
23786,22786,22792,57,10,22,8,6,8,29,30,-1,22,22,30
23787,22786,22792,24,11,22,8,4,10,35,38,-3,20,24,28
23788,22786,22792,43,12,22,8,3,11,31,32,-1,19,25,27
23789,22786,22792,25,7,22,9,4,9,42,39,3,22,22,31
23790,22786,22792,9,17,22,5,2,15,23,49,-26,12,32,17
23791,22786,22792,56,15,22,6,3,13,24,42,-18,15,29,21
23792,22786,22792,13,18,22,4,3,15,21,40,-19,11,33,15
23793,22786,22792,39,2,22,15,4,3,45,24,21,34,10,49
23794,22786,22792,27,13,22,8,3,11,28,39,-11,19,25,27
23795,22786,22792,15,14,22,6,3,13,28,44,-16,15,29,21
23796,22786,22792,45,16,22,5,5,12,29,46,-17,15,29,20
23797,22786,22792,28,8,22,8,7,7,23,24,-1,23,21,31
23798,22786,22792,1,5,22,10,7,5,40,28,12,27,17,37
23799,22786,22792,49,6,22,10,4,8,34,28,6,24,20,34
23800,22786,22792,16,9,22,8,6,8,36,33,3,22,22,30
23801,22786,22792,21,3,22,14,3,5,42,23,19,31,13,45
23802,22786,22792,4,4,22,11,5,6,37,21,16,27,17,38
23803,22618,22624,49,8,3,1,1,1,5,5,0,3,3,4
23804,22618,22624,22,2,3,2,0,1,9,6,3,4,2,6
23805,22618,22624,43,3,3,2,0,1,5,2,3,4,2,6
23806,22618,22624,24,12,3,1,0,2,4,4,0,2,4,3
23807,22618,22624,57,16,3,1,0,2,1,4,-3,2,4,3
23808,22618,22624,1,8,3,1,1,1,5,5,0,3,3,4
23809,22618,22624,25,14,3,1,0,2,3,4,-1,2,4,3
23810,22618,22624,28,17,3,0,3,0,2,2,0,3,3,3
23811,22618,22624,45,7,3,1,1,1,3,2,1,3,3,4
23812,22618,22624,39,11,3,1,1,1,2,4,-2,3,3,4
23813,22618,22624,27,13,3,1,0,2,4,5,-1,2,4,3
23814,22618,22624,15,15,3,1,0,2,5,8,-3,2,4,3
23815,22618,22624,56,10,3,1,1,1,1,2,-1,3,3,4
23816,22618,22624,13,18,3,0,0,3,1,6,-5,0,6,0
23817,22618,22624,21,1,3,3,0,0,7,2,5,6,0,9
23818,22618,22624,9,5,3,2,0,1,5,4,1,4,2,6
23819,22618,22624,4,6,3,1,2,0,5,4,1,4,2,5
23820,22618,22624,16,4,3,2,0,1,6,4,2,4,2,6
23821,22653,22659,16,4,8,5,1,2,16,13,3,11,5,16
23822,22653,22659,49,6,8,4,1,3,12,13,-1,9,7,13
23823,22653,22659,21,1,8,8,0,0,19,5,14,16,0,24
23824,22653,22659,4,5,8,4,2,2,13,9,4,10,6,14
23825,22653,22659,9,13,8,3,0,5,8,11,-3,6,10,9
23826,22653,22659,56,14,8,2,1,5,5,11,-6,5,11,7
23827,22653,22659,13,16,8,2,0,6,7,16,-9,4,12,6
23828,22653,22659,39,6,8,4,1,3,12,13,-1,9,7,13
23829,22653,22659,27,8,8,4,0,4,13,13,0,8,8,12
23830,22653,22659,15,15,8,2,0,6,7,14,-7,4,12,6
23831,22653,22659,45,17,8,1,2,5,7,15,-8,4,12,5
23832,22653,22659,28,11,8,2,4,2,7,8,-1,8,8,10
23833,22653,22659,25,12,8,3,0,5,13,16,-3,6,10,9
23834,22653,22659,22,2,8,6,1,1,21,9,12,13,3,19
23835,22653,22659,43,9,8,3,1,4,12,9,3,7,9,10
23836,22653,22659,24,10,8,3,1,4,16,15,1,7,9,10
23837,22653,22659,57,18,8,1,2,5,3,13,-10,4,12,5
23838,22653,22659,1,3,8,6,1,1,19,7,12,13,3,19
23839,23080,23093,1,7,14,5,5,4,26,15,11,15,13,20
23840,23080,23093,43,2,14,8,4,2,27,15,12,20,8,28
23841,23080,23093,22,4,14,6,6,2,28,14,14,18,10,24
23842,23080,23093,57,6,14,7,1,6,16,14,2,15,13,22
23843,23080,23093,24,11,14,4,3,7,13,19,-6,11,17,15
23844,23080,23093,55,10,14,4,5,5,17,25,-8,13,15,17
23845,23080,23093,25,15,14,2,5,7,18,26,-8,9,19,11
23846,23080,23093,28,8,14,4,6,4,17,23,-6,14,14,18
23847,23080,23093,39,1,14,11,1,2,34,15,19,23,5,34
23848,23080,23093,15,12,14,4,2,8,18,30,-12,10,18,14
23849,23080,23093,27,13,14,3,4,7,14,23,-9,10,18,13
23850,23080,23093,4,3,14,7,6,1,23,15,8,20,8,27
23851,23080,23093,21,5,14,6,5,3,29,12,17,17,11,23
23852,23080,23093,49,9,14,4,5,5,15,21,-6,13,15,17
23853,23080,23093,16,14,14,3,3,8,20,29,-9,9,19,12
23854,23080,23093,56,16,14,2,3,9,10,29,-19,7,21,9
23855,23101,23107,56,16,16,2,4,10,11,33,-22,8,24,10
23856,23101,23107,49,9,16,5,5,6,16,23,-7,15,17,20
23857,23101,23107,16,14,16,3,3,10,20,31,-11,9,23,12
23858,23101,23107,4,3,16,7,8,1,26,18,8,22,10,29
23859,23101,23107,21,4,16,7,6,3,31,13,18,20,12,27
23860,21197,21203,21,3,7,4,3,0,10,3,7,11,3,15
23861,21197,21203,4,5,7,4,1,2,16,10,6,9,5,13
23862,21197,21203,9,7,7,3,1,3,10,12,-2,7,7,10
23863,21197,21203,49,6,7,3,3,1,10,6,4,9,5,12
23864,21197,21203,56,12,7,1,2,4,7,13,-6,4,10,5
23865,21197,21203,12,14,7,1,1,5,6,15,-9,3,11,4
23866,21197,21203,28,8,7,2,4,1,9,8,1,8,6,10
23867,21197,21203,38,16,7,1,0,6,3,10,-7,2,12,3
23868,21197,21203,1,1,7,6,1,0,19,7,12,13,1,19
23869,21607,21609,28,10,13,4,4,5,14,23,-9,12,14,16
23870,21607,21609,38,9,13,4,5,4,16,16,0,13,13,17
23871,21607,21609,24,4,13,7,2,4,23,20,3,16,10,23
23872,21607,21609,22,7,13,6,3,4,21,17,4,15,11,21
23873,21607,21609,43,12,13,3,5,5,15,16,-1,11,15,14
23874,21607,21609,57,16,13,1,1,11,10,33,-23,3,23,4
23875,21607,21609,27,6,13,6,4,3,18,13,5,16,10,22
23876,21607,21609,45,8,13,5,4,4,20,16,4,14,12,19
23877,21607,21609,15,13,13,3,4,6,11,25,-14,10,16,13
23878,21607,21609,10,15,13,1,4,8,9,27,-18,6,20,7
23879,21607,21609,1,1,13,9,4,0,29,4,25,22,4,31
23880,21607,21609,49,2,13,8,3,2,27,10,17,19,7,27
23881,21607,21609,21,3,13,7,3,3,28,19,9,17,9,24
23882,21607,21609,4,5,13,6,4,3,27,18,9,16,10,22
23883,21607,21609,9,14,13,3,2,8,15,26,-11,8,18,11
23884,21607,21609,56,11,13,4,2,7,22,22,0,10,16,14
23885,21561,21567,21,2,7,5,0,2,16,9,7,10,4,15
23886,21561,21567,4,5,7,4,1,2,18,9,9,9,5,13
23887,21561,21567,9,10,7,3,1,3,10,13,-3,7,7,10
23888,21561,21567,1,3,7,4,3,0,14,2,12,11,3,15
23889,21561,21567,27,6,7,3,3,1,11,7,4,9,5,12
23890,21561,21567,45,8,7,3,2,2,8,8,0,8,6,11
23891,21561,21567,15,15,7,0,3,4,4,16,-12,3,11,3
23892,21561,21567,10,16,7,0,2,5,4,18,-14,2,12,2
23893,21561,21567,24,7,7,3,2,2,11,9,2,8,6,11
23894,21561,21567,22,9,7,3,1,3,10,9,1,7,7,10
23895,21561,21567,43,13,7,1,2,4,5,9,-4,4,10,5
23896,21561,21567,57,14,7,1,0,6,6,16,-10,2,12,3
23897,21561,21567,38,4,7,4,2,1,10,7,3,10,4,14
23898,21561,21567,28,12,7,2,2,3,5,11,-6,6,8,8
23899,21561,21567,56,11,7,2,2,3,12,12,0,6,8,8
23900,21561,21567,49,1,7,5,0,2,17,6,11,10,4,15
23901,22051,22057,16,8,20,8,5,7,35,34,1,21,19,29
23902,22051,22057,49,9,20,7,7,6,23,21,2,21,19,28
23903,22051,22057,21,3,20,10,4,6,34,27,7,24,16,34
23904,22051,22057,9,7,20,8,5,7,27,24,3,21,19,29
23905,22051,22057,4,12,20,8,1,11,28,28,0,17,23,25
23906,22051,22057,56,11,20,7,5,8,25,29,-4,19,21,26
23907,22051,22057,28,14,20,6,5,9,26,32,-6,17,23,23
23908,22051,22057,38,16,20,5,5,10,18,30,-12,15,25,20
23909,22051,22057,22,2,20,11,5,4,42,25,17,27,13,38
23910,22051,22057,43,5,20,8,8,4,30,24,6,24,16,32
23911,22051,22057,24,15,20,6,5,9,29,36,-7,17,23,23
23912,22051,22057,57,17,20,6,1,13,26,35,-9,13,27,19
23913,22051,22057,27,4,20,10,3,7,30,23,7,23,17,33
23914,22051,22057,45,10,20,8,3,9,31,35,-4,19,21,27
23915,22051,22057,15,13,20,5,9,6,24,32,-8,19,21,24
23916,22051,22057,10,18,20,5,4,11,26,44,-18,14,26,19
23917,22051,22057,1,1,20,13,3,4,41,12,29,29,11,42
23918,22051,22057,53,6,20,9,2,9,40,44,-4,20,20,29
23919,21911,21924,27,1,4,4,0,0,7,1,6,8,0,12
23920,21911,21924,45,6,4,2,0,2,7,6,1,4,4,6
23921,21911,21924,10,15,4,1,0,3,6,10,-4,2,6,3
23922,21911,21924,15,16,4,0,3,1,2,6,-4,3,5,3
23923,21911,21924,57,7,4,2,0,2,5,5,0,4,4,6
23924,21911,21924,43,8,4,1,3,0,8,6,2,5,3,6
23925,21911,21924,22,10,4,1,2,1,4,4,0,4,4,5
23926,21911,21924,24,12,4,1,1,2,5,6,-1,3,5,4
23927,21911,21924,28,11,4,1,2,1,4,5,-1,4,4,5
23928,21911,21924,38,18,4,0,2,2,2,4,-2,2,6,2
23929,21911,21924,53,3,4,3,0,1,6,5,1,6,2,9
23930,21911,21924,56,4,4,2,1,1,4,4,0,5,3,7
23931,21911,21924,49,2,4,3,1,0,6,1,5,7,1,10
23932,21911,21924,16,9,4,1,2,1,6,6,0,4,4,5
23933,21911,21924,4,14,4,1,0,3,3,5,-2,2,6,3
23934,21911,21924,9,17,4,0,2,2,3,5,-2,2,6,2
23935,21911,21924,21,13,4,1,1,2,3,5,-2,3,5,4
23936,21911,21924,1,5,4,2,0,2,6,3,3,4,4,6
23937,22366,22372,24,4,16,8,2,6,28,28,0,18,14,26
23938,22366,22372,43,6,16,6,7,3,31,22,9,19,13,25
23939,22366,22372,22,10,16,6,3,7,30,28,2,15,17,21
23940,22366,22372,57,17,16,3,4,9,18,24,-6,10,22,13
23941,8611,8617,8,17,28,7,6,15,27,54,-27,20,36,27
23942,8989,8991,4,6,27,11,8,8,53,32,21,30,24,41
23943,8989,8991,21,7,27,8,12,7,30,37,-7,28,26,36
23944,8989,8991,12,9,27,9,7,11,43,46,-3,25,29,34
23945,8989,8991,53,16,27,6,6,15,33,53,-20,18,36,24
23946,8989,8991,11,17,27,4,8,15,30,59,-29,16,38,20
23947,8989,8991,1,3,27,14,9,4,50,31,19,37,17,51
23948,8989,8991,19,12,27,7,10,10,20,31,-11,24,30,31
23949,8989,8991,17,15,27,7,7,13,23,45,-22,21,33,28
23950,8989,8991,49,11,27,7,10,10,31,34,-3,24,30,31
23951,8989,8991,37,4,27,14,6,7,51,20,31,34,20,48
23952,8989,8991,43,1,27,21,6,0,80,18,62,48,6,69
23953,8989,8991,57,8,27,9,8,10,29,37,-8,26,28,35
23954,8989,8991,24,10,27,8,9,10,33,39,-6,25,29,33
23955,8989,8991,2,18,27,4,6,17,29,60,-31,14,40,18
23956,8989,8991,20,2,27,17,4,6,54,30,24,38,16,55
23957,8989,8991,41,5,27,13,9,5,47,29,18,35,19,48
23958,8989,8991,13,13,27,8,6,13,33,49,-16,22,32,30
23959,8989,8991,56,14,27,7,7,13,33,52,-19,21,33,28
23960,8807,8813,20,4,9,5,1,3,14,12,2,11,7,16
23961,8807,8813,41,5,9,3,5,1,15,9,6,11,7,14
23962,8807,8813,56,10,9,3,3,3,14,12,2,9,9,12
23963,8807,8813,13,12,9,3,3,3,13,15,-2,9,9,12
23964,8807,8813,43,1,9,6,3,0,30,9,21,15,3,21
23965,8807,8813,57,8,9,3,4,2,13,11,2,10,8,13
23966,8807,8813,24,15,9,1,5,3,12,15,-3,7,11,8
23967,8807,8813,2,18,9,1,1,7,8,26,-18,3,15,4
23968,8807,8813,12,7,9,4,1,4,13,19,-6,9,9,13
23969,8807,8813,11,11,9,3,3,3,11,11,0,9,9,12
23970,8807,8813,53,14,9,2,2,5,9,17,-8,6,12,8
23971,8807,8813,4,2,9,5,3,1,26,9,17,13,5,18
23972,8807,8813,21,9,9,3,4,2,12,11,1,10,8,13
23973,8807,8813,37,6,9,4,1,4,15,10,5,9,9,13
23974,8807,8813,49,13,9,2,3,4,13,16,-3,7,11,9
23975,8807,8813,17,16,9,2,1,6,5,20,-15,5,13,7
23976,8807,8813,19,17,9,0,6,3,3,9,-6,6,12,6
23977,8807,8813,1,3,9,5,3,1,14,9,5,13,5,18
23978,9164,9170,1,1,10,7,1,2,26,12,14,15,5,22
23979,9164,9170,19,14,10,2,3,5,11,23,-12,7,13,9
23980,9164,9170,4,3,10,6,2,2,18,8,10,14,6,20
23981,9164,9170,21,13,10,2,4,4,9,14,-5,8,12,10
23982,9164,9170,27,18,10,1,2,7,8,17,-9,4,16,5
23983,9164,9170,53,7,10,4,4,2,13,10,3,12,8,16
23984,9164,9170,12,10,10,3,4,3,15,15,0,10,10,13
23985,9164,9170,52,15,10,1,5,4,8,16,-8,7,13,8
23986,9164,9170,57,9,10,4,1,5,14,17,-3,9,11,13
23987,9164,9170,17,11,10,3,4,3,9,12,-3,10,10,13
23988,9164,9170,37,5,10,5,2,3,18,17,1,12,8,17
23989,9164,9170,49,8,10,4,4,2,12,10,2,12,8,16
23990,9164,9170,56,16,10,1,4,5,8,15,-7,6,14,7
23991,9164,9170,20,4,10,5,3,2,20,5,15,13,7,18
23992,9164,9170,41,6,10,5,1,4,15,13,2,11,9,16
23993,9164,9170,13,12,10,2,5,3,7,9,-2,9,11,11
23994,9164,9170,24,17,10,0,6,4,5,16,-11,6,14,6
23995,9164,9170,43,2,10,6,3,1,25,12,13,15,5,21
23996,9220,9226,20,5,17,8,4,5,30,14,16,20,14,28
23997,9220,9226,41,7,17,8,2,7,27,25,2,18,16,26
23998,9220,9226,13,11,17,4,7,6,13,17,-4,15,19,19
23999,9220,9226,56,17,17,3,5,9,15,28,-13,11,23,14
24000,9220,9226,4,3,17,10,3,4,28,14,14,23,11,33
24001,9220,9226,21,10,17,6,5,6,18,23,-5,17,17,23
24002,9220,9226,43,2,17,10,5,2,43,18,25,25,9,35
24003,9220,9226,57,8,17,7,4,6,26,24,2,18,16,25
24004,9220,9226,24,13,17,3,8,6,17,27,-10,14,20,17
24005,9220,9226,52,16,17,3,6,8,16,30,-14,12,22,15
24006,9220,9226,53,6,17,7,6,4,27,24,3,20,14,27
24007,9220,9226,12,14,17,4,4,9,20,31,-11,12,22,16
24008,9220,9226,37,4,17,9,2,6,29,25,4,20,14,29
24009,9220,9226,49,9,17,6,6,5,23,19,4,18,16,24
24010,9220,9226,17,12,17,4,6,7,18,24,-6,14,20,18
24011,9220,9226,19,18,17,3,4,10,15,37,-22,10,24,13
24012,9220,9226,27,15,17,4,3,10,20,31,-11,11,23,15
24013,9220,9226,1,1,17,13,2,2,41,15,26,28,6,41
24014,9563,9569,1,2,10,7,3,0,26,8,18,17,3,24
24015,9563,9569,27,4,10,5,2,3,14,13,1,12,8,17
24016,9563,9569,4,14,10,3,1,6,8,17,-9,7,13,10
24017,9563,9569,21,17,10,0,3,7,5,18,-13,3,17,3
24018,9563,9569,53,12,10,2,5,3,6,13,-7,9,11,11
24019,9563,9569,12,5,10,4,5,1,11,9,2,13,7,17
24020,23101,23107,39,1,16,12,2,2,37,17,20,26,6,38
24021,23101,23107,27,12,16,4,5,7,17,25,-8,13,19,17
24022,23101,23107,15,13,16,4,3,9,19,33,-14,11,21,15
24023,23101,23107,28,8,16,5,7,4,20,24,-4,17,15,22
24024,23101,23107,55,11,16,4,6,6,18,27,-9,14,18,18
24025,23101,23107,25,15,16,2,5,9,21,32,-11,9,23,11
24026,23101,23107,43,2,16,10,4,2,32,17,15,24,8,34
24027,23101,23107,1,5,16,7,5,4,29,15,14,19,13,26
24028,23101,23107,57,6,16,8,1,7,19,16,3,17,15,25
24029,23101,23107,22,7,16,6,7,3,30,17,13,19,13,25
24030,23101,23107,24,10,16,5,3,8,16,21,-5,13,19,18
24031,23161,23163,4,4,23,10,9,4,40,28,12,29,17,39
24032,23161,23163,21,5,23,10,8,5,42,22,20,28,18,38
24033,23161,23163,43,2,23,12,9,2,44,26,18,33,13,45
24034,23161,23163,22,6,23,9,9,5,44,24,20,27,19,36
24035,23161,23163,57,7,23,10,3,10,29,28,1,23,23,33
24036,23161,23163,24,9,23,8,5,10,27,29,-2,21,25,29
24037,23161,23163,1,3,23,11,8,4,48,21,27,30,16,41
24038,23161,23163,25,10,23,6,7,10,36,42,-6,19,27,25
24039,23161,23163,55,15,23,5,6,12,25,47,-22,16,30,21
24040,23161,23163,28,8,23,7,10,6,29,33,-4,24,22,31
24041,23161,23163,39,1,23,17,4,2,51,25,26,38,8,55
24042,23161,23163,27,11,23,6,6,11,24,38,-14,18,28,24
24043,23161,23163,15,13,23,6,3,14,23,44,-21,15,31,21
24044,23161,23163,49,12,23,5,9,9,20,32,-12,19,27,24
24045,23161,23163,16,14,23,5,6,12,28,40,-12,16,30,21
24046,23161,23163,56,16,23,3,6,14,16,47,-31,12,34,15
24047,23038,23044,49,12,9,2,4,3,8,8,0,8,10,10
24048,23038,23044,16,13,9,2,3,4,12,16,-4,7,11,9
24049,23038,23044,4,2,9,5,4,0,15,9,6,14,4,19
24050,23038,23044,21,5,9,3,5,1,13,4,9,11,7,14
24051,23038,23044,39,1,9,6,1,2,18,12,6,13,5,19
24052,23038,23044,15,11,9,3,1,5,12,18,-6,7,11,10
24053,23038,23044,27,14,9,1,4,4,8,14,-6,6,12,7
24054,23038,23044,56,15,9,1,2,6,8,21,-13,4,14,5
24055,23038,23044,55,9,9,3,3,3,10,18,-8,9,9,12
24056,23038,23044,25,16,9,0,3,6,10,19,-9,3,15,3
24057,23038,23044,28,7,9,3,4,2,11,10,1,10,8,13
24058,23038,23044,43,3,9,5,3,1,13,9,4,13,5,18
24059,23038,23044,22,6,9,3,5,1,15,9,6,11,7,14
24060,23038,23044,57,8,9,4,0,5,9,9,0,8,10,12
24061,23038,23044,24,10,9,3,2,4,10,9,1,8,10,11
24062,23038,23044,1,4,9,4,4,1,22,9,13,12,6,16
24063,22464,22470,4,5,30,15,7,8,46,28,18,37,23,52
24064,22464,22470,9,14,30,9,5,16,28,55,-27,23,37,32
24065,22464,22470,53,18,30,4,4,22,30,63,-33,12,48,16
24066,22464,22470,28,11,30,11,6,13,33,38,-5,28,32,39
24067,22464,22470,39,1,30,21,4,5,65,24,41,46,14,67
24068,22464,22470,27,7,30,13,8,9,45,40,5,34,26,47
24069,22464,22470,15,15,30,8,7,15,36,50,-14,23,37,31
24070,22464,22470,45,16,30,7,8,15,39,63,-24,22,38,29
24071,22464,22470,56,12,30,9,10,11,39,39,0,28,32,37
24072,22464,22470,13,17,30,7,2,21,26,63,-37,16,44,23
24073,22464,22470,16,10,30,10,10,10,45,47,-2,30,30,40
24074,22464,22470,43,4,30,15,10,5,63,32,31,40,20,55
24075,22464,22470,24,6,30,14,5,11,51,54,-3,33,27,47
24076,22464,22470,22,8,30,13,6,11,58,43,15,32,28,45
24077,22464,22470,57,9,30,11,7,12,44,38,6,29,31,40
24078,22464,22470,49,13,30,8,9,13,30,44,-14,25,35,33
24079,22464,22470,1,2,30,17,9,4,61,34,27,43,17,60
24080,22695,22701,1,3,14,9,2,3,28,14,14,20,8,29
24081,22695,22701,49,5,14,8,1,5,24,17,7,17,11,25
24082,22695,22701,16,8,14,6,3,5,23,23,0,15,13,21
24083,22695,22701,13,16,14,3,2,9,14,24,-10,8,20,11
24084,22695,22701,56,17,14,3,2,9,12,25,-13,8,20,11
24085,22695,22701,27,13,14,5,1,8,20,25,-5,11,17,16
24086,22695,22701,15,15,14,4,0,10,15,29,-14,8,20,12
24087,22695,22701,45,18,14,3,2,9,16,30,-14,8,20,11
24088,22695,22701,28,11,14,4,5,5,12,15,-3,13,15,17
24089,22695,22701,39,4,14,9,2,3,29,18,11,20,8,29
24090,22695,22701,25,7,14,7,1,6,25,26,-1,15,13,22
24091,22695,22701,22,1,14,12,1,1,36,13,23,25,3,37
24092,22695,22701,57,9,14,5,3,6,20,22,-2,13,15,18
24093,22695,22701,24,10,14,5,2,7,21,25,-4,12,16,17
24094,22695,22701,43,12,14,5,1,8,21,21,0,11,17,16
24095,22695,22701,21,2,14,11,0,3,28,14,14,22,6,33
24096,22695,22701,4,6,14,7,2,5,25,17,8,16,12,23
24097,22695,22701,9,14,14,4,2,8,15,26,-11,10,18,14
24098,22758,22771,22,1,18,15,1,2,45,16,29,31,5,46
24099,22758,22771,57,9,18,7,5,6,25,25,0,19,17,26
24100,22758,22771,43,11,18,7,2,9,26,25,1,16,20,23
24101,22758,22771,24,12,18,6,4,8,30,31,-1,16,20,22
24102,22758,22771,25,7,18,8,3,7,37,33,4,19,17,27
24103,22758,22771,28,10,18,7,5,6,19,19,0,19,17,26
24104,22758,22771,39,2,18,12,3,3,38,22,16,27,9,39
24105,22758,22771,15,13,18,6,1,11,25,38,-13,13,23,19
24106,22758,22771,27,14,18,6,1,11,22,35,-13,13,23,19
24107,22758,22771,45,17,18,3,4,11,23,42,-19,10,26,13
24108,22758,22771,56,16,18,4,3,11,15,33,-18,11,25,15
24109,22758,22771,13,18,18,3,2,13,16,34,-18,8,28,11
24110,22758,22771,49,6,18,9,2,7,29,22,7,20,16,29
24111,22758,22771,16,8,18,7,5,6,31,27,4,19,17,26
24112,22758,22771,21,3,18,11,3,4,33,20,13,25,11,36
24113,22758,22771,4,5,18,9,4,5,32,18,14,22,14,31
24114,22758,22771,9,15,18,5,2,11,20,40,-20,12,24,17
24115,22758,22771,1,4,18,10,4,4,35,21,14,24,12,34
24116,22793,22799,1,4,23,11,7,5,42,29,13,29,17,40
24117,22793,22799,49,6,23,11,4,8,37,29,8,26,20,37
24118,22793,22799,16,10,23,8,7,8,37,34,3,23,23,31
24119,22793,22799,56,14,23,6,4,13,26,44,-18,16,30,22
24120,22793,22799,13,18,23,4,3,16,21,44,-23,11,35,15
24121,22793,22799,28,9,23,8,8,7,24,25,-1,24,22,32
24122,22793,22799,25,7,23,10,4,9,44,39,5,24,22,34
24123,22793,22799,39,2,23,16,4,3,46,24,22,36,10,52
24124,22793,22799,27,13,23,8,3,12,28,40,-12,19,27,27
24125,22793,22799,15,15,23,6,3,14,29,47,-18,15,31,21
24126,22793,22799,45,16,23,5,5,13,30,48,-18,15,31,20
24127,22793,22799,22,1,23,19,2,2,57,20,37,40,6,59
24128,22793,22799,57,8,23,9,6,8,32,32,0,24,22,33
24129,22793,22799,43,11,23,8,4,11,31,32,-1,20,26,28
24130,22793,22799,24,12,23,8,4,11,35,40,-5,20,26,28
24131,22793,22799,21,3,23,14,4,5,42,23,19,32,14,46
24132,22793,22799,4,5,23,11,5,7,39,24,15,27,19,38
24133,22793,22799,9,17,23,5,3,15,25,51,-26,13,33,18
24134,22814,22820,21,3,26,16,5,5,45,23,22,37,15,53
24135,22814,22820,4,5,26,12,6,8,46,30,16,30,22,42
24136,22814,22820,9,17,26,5,5,16,26,54,-28,15,37,20
24137,22814,22820,22,1,26,20,3,3,62,25,37,43,9,63
24138,22814,22820,57,8,26,9,9,8,35,35,0,27,25,36
24139,22814,22820,43,9,26,10,5,11,38,35,3,25,27,35
24140,22814,22820,24,13,26,8,6,12,40,46,-6,22,30,30
24141,22366,22372,21,2,16,9,3,4,29,18,11,21,11,30
24142,22366,22372,49,12,16,5,5,6,18,26,-8,15,17,20
24143,22366,22372,16,13,16,4,8,4,22,26,-4,16,16,20
24144,22366,22372,4,7,16,7,3,6,26,17,9,17,15,24
24145,22366,22372,9,15,16,5,2,9,19,35,-16,12,20,17
24146,22366,22372,28,11,16,6,3,7,17,23,-6,15,17,21
24147,22366,22372,56,9,16,5,7,4,20,19,1,17,15,22
24148,22366,22372,13,14,16,6,1,9,21,28,-7,13,19,19
24149,22366,22372,53,18,16,2,3,11,15,30,-15,7,25,9
24150,22366,22372,39,1,16,11,1,4,41,17,24,23,9,34
24151,22366,22372,27,5,16,7,5,4,28,22,6,19,13,26
24152,22366,22372,15,8,16,6,4,6,26,24,2,16,16,22
24153,22366,22372,45,16,16,4,5,7,25,35,-10,13,19,17
24154,22366,22372,1,3,16,8,6,2,29,21,8,22,10,30
24155,22384,22386,1,2,19,11,6,2,39,24,15,28,10,39
24156,22384,22386,53,18,19,2,3,14,15,33,-18,7,31,9
24157,22384,22386,28,13,19,6,3,10,19,29,-10,15,23,21
24158,22384,22386,56,8,19,7,7,5,24,22,2,21,17,28
24159,22384,22386,13,16,19,6,1,12,23,38,-15,13,25,19
24160,22384,22386,49,9,19,7,5,7,22,31,-9,19,19,26
24161,22384,22386,16,15,19,4,8,7,24,33,-9,16,22,20
24162,22384,22386,21,3,19,11,3,5,36,23,13,25,13,36
24163,22384,22386,4,6,19,9,3,7,31,21,10,21,17,30
24164,22384,22386,9,14,19,6,2,11,21,39,-18,14,24,20
24165,22384,22386,39,1,19,14,1,4,47,18,29,29,9,43
24166,22384,22386,27,5,19,9,5,5,34,26,8,23,15,32
24167,22384,22386,15,11,19,7,4,8,30,30,0,18,20,25
24168,22384,22386,45,17,19,4,5,10,27,43,-16,13,25,17
24169,22384,22386,43,4,19,9,7,3,41,24,17,25,13,34
24170,22384,22386,24,7,19,9,3,7,33,34,-1,21,17,30
24171,22384,22386,22,10,19,7,4,8,35,32,3,18,20,25
24172,22384,22386,57,12,19,6,4,9,24,25,-1,16,22,22
24173,22254,22260,39,1,3,2,0,1,6,2,4,4,2,6
24174,22254,22260,27,4,3,1,2,0,4,1,3,4,2,5
24175,22254,22260,15,5,3,1,2,0,6,4,2,4,2,5
24176,22254,22260,45,8,3,1,1,1,5,4,1,3,3,4
24177,22254,22260,1,6,3,1,2,0,4,3,1,4,2,5
24178,22254,22260,57,7,3,1,2,0,3,2,1,4,2,5
24179,22254,22260,43,8,3,1,1,1,5,4,1,3,3,4
24180,22254,22260,22,10,3,1,1,1,6,6,0,3,3,4
24181,22254,22260,24,14,3,1,0,2,4,6,-2,2,4,3
24182,22254,22260,49,12,3,1,1,1,5,7,-2,3,3,4
24183,22254,22260,16,16,3,0,3,0,3,3,0,3,3,3
24184,22254,22260,56,2,3,2,0,1,4,2,2,4,2,6
24185,22254,22260,13,15,3,1,0,2,1,5,-4,2,4,3
24186,22254,22260,53,18,3,0,1,2,2,6,-4,1,5,1
24187,22254,22260,28,11,3,1,1,1,3,4,-1,3,3,4
24188,22254,22260,9,3,3,2,0,1,5,6,-1,4,2,6
24189,22254,22260,21,13,3,1,0,2,7,6,1,2,4,3
24190,22254,22260,4,17,3,0,1,2,3,5,-2,1,5,1
24191,22492,22498,28,9,33,14,6,13,39,40,-1,34,32,48
24192,22492,22498,53,18,33,4,4,25,33,71,-38,12,54,16
24193,22492,22498,56,12,33,9,10,14,41,45,-4,28,38,37
24194,22492,22498,13,17,33,8,4,21,30,66,-36,20,46,28
24195,22492,22498,39,1,33,23,5,5,73,27,46,51,15,74
24196,22492,22498,27,7,33,14,9,10,52,46,6,37,29,51
24197,22492,22498,15,15,33,8,8,17,37,59,-22,24,42,32
24198,22492,22498,45,16,33,8,8,17,42,66,-24,24,42,32
24199,22492,22498,9,14,33,9,7,17,32,61,-29,25,41,34
24200,22492,22498,49,13,33,9,9,15,32,48,-16,27,39,36
24201,22492,22498,16,11,33,10,11,12,47,53,-6,31,35,41
24202,22492,22498,21,3,33,19,5,9,54,37,17,43,23,62
24203,22492,22498,4,5,33,17,8,8,51,30,21,42,24,59
24204,22492,22498,43,4,33,17,10,6,69,34,35,44,22,61
24205,22492,22498,24,6,33,15,7,11,57,59,-2,37,29,52
24206,22492,22498,22,8,33,14,6,13,64,47,17,34,32,48
24207,22492,22498,57,10,33,12,8,13,48,45,3,32,34,44
24208,22492,22498,1,2,33,20,9,4,70,37,33,49,17,69
24209,22303,22309,22,3,9,5,2,2,19,12,7,12,6,17
24210,22303,22309,43,6,9,4,3,2,18,11,7,11,7,15
24211,22303,22309,24,9,9,4,1,4,15,18,-3,9,9,13
24212,22303,22309,57,16,9,2,2,5,11,13,-2,6,12,8
24213,22303,22309,21,4,9,5,2,2,19,13,6,12,6,17
24214,22303,22309,9,10,9,4,1,4,13,17,-4,9,9,13
24215,22303,22309,4,13,9,3,2,4,16,12,4,8,10,11
24216,22303,22309,49,11,9,4,1,4,9,14,-5,9,9,13
24217,22303,22309,16,17,9,1,5,3,9,17,-8,7,11,8
24218,22303,22309,53,18,9,0,1,8,7,22,-15,1,17,1
24219,22303,22309,28,8,9,4,1,4,9,11,-2,9,9,13
24220,22303,22309,1,1,9,5,3,1,17,12,5,13,5,18
24221,9563,9569,43,1,10,8,1,1,25,4,21,17,3,25
24222,9563,9569,24,6,10,4,4,2,12,6,6,12,8,16
24223,9563,9569,2,11,10,3,3,4,10,17,-7,9,11,12
24224,9563,9569,49,3,10,6,3,1,20,6,14,15,5,21
24225,9563,9569,37,8,10,3,7,0,14,6,8,13,7,16
24226,9563,9569,41,7,10,4,4,2,16,11,5,12,8,16
24227,9563,9569,56,9,10,3,3,4,14,11,3,9,11,12
24228,9563,9569,13,10,10,3,3,4,12,15,-3,9,11,12
24229,9563,9569,52,16,10,2,2,6,10,18,-8,6,14,8
24230,9563,9569,48,18,10,0,3,7,4,24,-20,3,17,3
24231,9563,9569,57,13,10,3,1,6,15,14,1,7,13,10
24232,9563,9569,20,15,10,3,1,6,10,22,-12,7,13,10
24233,9612,9639,41,5,17,9,4,4,26,15,11,22,12,31
24234,9612,9639,20,8,17,7,2,8,23,27,-4,16,18,23
24235,9612,9639,13,13,17,4,4,9,17,27,-10,12,22,16
24236,9612,9639,56,17,17,3,3,11,16,29,-13,9,25,12
24237,9612,9639,37,6,17,7,10,0,22,10,12,24,10,31
24238,9612,9639,49,9,17,6,5,6,24,16,8,17,17,23
24239,9612,9639,43,1,17,13,3,1,46,8,38,29,5,42
24240,9612,9639,24,2,17,11,4,2,28,8,20,26,8,37
24241,9612,9639,2,10,17,6,4,7,19,24,-5,16,18,22
24242,9612,9639,57,12,17,4,5,8,21,20,1,13,21,17
24243,9612,9639,52,16,17,3,4,10,18,33,-15,10,24,13
24244,9612,9639,48,18,17,1,4,12,7,44,-37,6,28,7
24245,9612,9639,12,3,17,10,5,2,26,16,10,25,9,35
24246,9612,9639,53,11,17,5,6,6,16,22,-6,16,18,21
24247,9612,9639,4,14,17,4,3,10,12,30,-18,11,23,15
24248,9612,9639,21,15,17,3,4,10,18,30,-12,10,24,13
24249,9612,9639,27,7,17,9,2,6,22,21,1,20,14,29
24250,9612,9639,1,4,17,10,4,3,37,18,19,24,10,34
24251,9500,9506,27,14,2,0,1,1,2,3,-1,1,3,1
24252,9500,9506,49,2,2,1,1,0,6,1,5,3,1,4
24253,9500,9506,37,5,2,1,1,0,2,0,2,3,1,4
24254,9500,9506,53,3,2,1,1,0,3,1,2,3,1,4
24255,9500,9506,12,12,2,0,2,0,1,1,0,2,2,2
24256,9500,9506,1,1,2,1,1,0,9,1,8,3,1,4
24257,9500,9506,4,9,2,1,0,1,3,6,-3,2,2,3
24258,9500,9506,21,10,2,0,2,0,2,2,0,2,2,2
24259,9500,9506,48,15,2,0,1,1,1,3,-2,1,3,1
24260,9500,9506,52,16,2,0,1,1,1,5,-4,1,3,1
24261,9500,9506,41,6,2,1,1,0,3,2,1,3,1,4
24262,9500,9506,56,6,2,1,1,0,3,2,1,3,1,4
24263,9500,9506,13,17,2,0,0,2,1,5,-4,0,4,0
24264,9500,9506,20,18,2,0,0,2,0,10,-10,0,4,0
24265,9500,9506,43,3,2,1,1,0,3,1,2,3,1,4
24266,9500,9506,57,8,2,1,0,1,6,3,3,2,2,3
24267,9500,9506,2,10,2,0,2,0,2,2,0,2,2,2
24268,9500,9506,24,12,2,0,2,0,1,1,0,2,2,2
24269,9710,9716,41,6,26,12,5,9,35,30,5,29,23,41
24270,9710,9716,20,8,26,11,5,10,38,34,4,27,25,38
24271,9710,9716,56,13,26,7,5,14,30,39,-9,19,33,26
24272,9710,9716,13,17,26,5,6,15,26,50,-24,16,36,21
24273,9710,9716,37,4,26,11,12,3,35,20,15,34,18,45
24274,9710,9716,49,10,26,8,8,10,32,25,7,24,28,32
24275,9710,9716,12,5,26,12,8,6,39,31,8,32,20,44
24276,9710,9716,53,9,26,9,9,8,25,26,-1,27,25,36
24277,9710,9716,52,15,26,5,9,12,25,41,-16,19,33,24
24278,9710,9716,48,18,26,4,6,16,16,58,-42,14,38,18
24279,9710,9716,43,1,26,18,6,2,64,22,42,42,10,60
24280,9710,9716,24,2,26,18,6,2,42,11,31,42,10,60
24281,9710,9716,2,11,26,7,8,11,26,38,-12,22,30,29
24282,9710,9716,57,12,26,7,7,12,29,33,-4,21,31,28
24283,9710,9716,27,7,26,11,6,9,35,34,1,28,24,39
24284,9710,9716,4,14,26,6,7,13,22,42,-20,19,33,25
24285,9710,9716,21,16,26,5,7,14,28,40,-12,17,35,22
24286,9710,9716,1,3,26,15,6,5,51,24,27,36,16,51
24287,9731,9737,1,3,29,16,7,6,57,26,31,39,19,55
24288,9731,9737,4,15,29,6,8,15,23,46,-23,20,38,26
24289,9731,9737,21,16,29,5,9,15,29,43,-14,19,39,24
24290,9731,9737,27,7,29,12,7,10,40,41,-1,31,27,43
24291,9731,9737,56,13,29,8,6,15,34,43,-9,22,36,30
24292,9731,9737,13,17,29,5,7,17,28,58,-30,17,41,22
24293,9731,9737,52,14,29,6,10,13,28,46,-18,22,36,28
24294,9731,9737,48,18,29,4,7,18,17,65,-48,15,43,19
24295,9731,9737,12,4,29,15,8,6,50,34,16,38,20,53
24296,9731,9737,53,8,29,10,10,9,29,29,0,30,28,40
24297,9731,9737,37,5,29,12,14,3,38,21,17,38,20,50
24298,9731,9737,49,10,29,8,11,10,36,29,7,27,31,35
24299,9731,9737,43,1,29,21,6,2,69,23,46,48,10,69
24300,9731,9737,24,2,29,20,7,2,47,11,36,47,11,67
24301,11502,11515,52,11,24,7,6,11,25,33,-8,20,28,27
24302,11502,11515,21,5,24,12,3,9,33,31,2,27,21,39
24303,11502,11515,4,6,24,10,6,8,38,34,4,26,22,36
24304,11502,11515,49,4,24,11,11,2,38,18,20,33,15,44
24305,11502,11515,37,14,24,5,10,9,29,33,-4,20,28,25
24306,11558,11564,49,3,30,15,12,3,48,22,26,42,18,57
24307,11558,11564,37,15,30,6,11,13,35,47,-12,23,37,29
24308,11558,11564,4,5,30,14,8,8,47,38,9,36,24,50
24309,11558,11564,21,6,30,15,4,11,40,38,2,34,26,49
24310,11558,11564,52,10,30,10,7,13,34,40,-6,27,33,37
24311,11558,11564,43,1,30,19,7,4,58,18,40,45,15,64
24312,11558,11564,24,4,30,14,11,5,39,18,21,39,21,53
24313,11558,11564,57,9,30,10,13,7,48,43,5,33,27,43
24314,11558,11564,22,16,30,6,9,15,26,40,-14,21,39,27
24315,11558,11564,34,18,30,3,6,21,13,58,-45,12,48,15
24316,11558,11564,27,13,30,8,8,14,29,37,-8,24,36,32
24317,11558,11564,1,2,30,18,10,2,55,20,35,46,14,64
24318,11558,11564,35,8,30,11,10,9,46,40,6,32,28,43
24319,11558,11564,20,11,30,10,6,14,44,52,-8,26,34,36
24320,11558,11564,41,14,30,6,12,12,31,41,-10,24,36,30
24321,11558,11564,56,17,30,5,8,17,28,63,-35,18,42,23
24322,11558,11564,12,12,30,8,10,12,36,46,-10,26,34,34
24323,11558,11564,17,7,30,12,8,10,46,42,4,32,28,44
24324,11768,11774,17,10,13,4,4,5,19,20,-1,12,14,16
24325,11768,11774,20,4,13,7,2,4,39,20,19,16,10,23
24326,11768,11774,41,13,13,4,2,7,19,30,-11,10,16,14
24327,11768,11774,35,17,13,3,2,8,20,33,-13,8,18,11
24328,11768,11774,6,18,13,1,1,11,11,35,-24,3,23,4
24329,11768,11774,1,6,13,7,2,4,16,10,6,16,10,23
24330,11768,11774,43,1,13,11,1,1,31,10,21,23,3,34
24331,11768,11774,24,3,13,8,0,5,23,16,7,16,10,24
24332,11768,11774,57,12,13,4,3,6,32,34,-2,11,15,15
24333,11768,11774,22,14,13,3,4,6,13,13,0,10,16,13
24334,11768,11774,52,11,13,3,7,3,18,15,3,13,13,16
24335,11768,11774,12,16,13,3,2,8,12,23,-11,8,18,11
24336,11768,11774,4,7,13,6,3,4,20,14,6,15,11,21
24337,11768,11774,21,9,13,6,1,6,22,26,-4,13,13,19
24338,11768,11774,27,5,13,7,2,4,28,21,7,16,10,23
24339,11768,11774,49,2,13,10,1,2,29,16,13,21,5,31
24340,11768,11774,37,8,13,6,3,4,15,15,0,15,11,21
24341,11768,11774,14,15,13,4,0,9,22,38,-16,8,18,12
24342,12209,12215,21,5,23,10,9,4,33,25,8,29,17,39
24343,12209,12215,9,9,23,6,12,5,32,31,1,24,22,30
24344,12209,12215,4,11,23,5,10,8,33,38,-5,20,26,25
24345,12209,12215,52,16,23,5,7,11,22,33,-11,17,29,22
24346,12209,12215,43,1,23,16,5,2,55,23,32,37,9,53
24347,12209,12215,24,8,23,6,12,5,27,24,3,24,22,30
24348,12209,12215,57,14,23,5,8,10,34,47,-13,18,28,23
24349,12209,12215,22,18,23,2,6,15,26,56,-30,10,36,12
24350,12209,12215,1,2,23,13,9,1,34,15,19,35,11,48
24351,12209,12215,27,3,23,13,4,6,45,30,15,30,16,43
24352,12209,12215,49,6,23,9,7,7,27,16,11,25,21,34
24353,12209,12215,37,12,23,5,9,9,25,29,-4,19,27,24
24354,12209,12215,13,4,23,11,9,3,37,18,19,31,15,42
24355,12209,12215,6,7,23,8,8,7,31,28,3,24,22,32
24356,12209,12215,35,10,23,7,7,9,29,31,-2,21,25,28
24357,12209,12215,41,13,23,5,9,9,26,40,-14,19,27,24
24358,12209,12215,20,17,23,3,6,14,21,45,-24,12,34,15
24359,12209,12215,17,15,23,4,11,8,21,29,-8,19,27,23
24360,12216,12229,17,16,24,4,11,9,21,30,-9,19,29,23
24361,12216,12229,13,4,24,12,9,3,41,20,21,33,15,45
24362,12216,12229,6,8,24,8,8,8,32,30,2,24,24,32
24363,12216,12229,35,10,24,7,8,9,30,32,-2,22,26,29
24364,12216,12229,41,12,24,6,9,9,27,40,-13,21,27,27
24365,12216,12229,20,17,24,3,6,15,21,46,-25,12,36,15
24366,12216,12229,49,6,24,9,8,7,28,17,11,26,22,35
24367,12216,12229,27,3,24,14,4,6,47,31,16,32,16,46
24368,12216,12229,1,2,24,14,9,1,35,15,20,37,11,51
24369,12216,12229,43,1,24,16,5,3,55,24,31,37,11,53
24370,12216,12229,24,7,24,7,12,5,28,24,4,26,22,33
24371,12216,12229,57,15,24,5,9,10,36,49,-13,19,29,24
24372,12216,12229,22,18,24,2,7,15,28,58,-30,11,37,13
24373,12216,12229,52,13,24,6,7,11,24,33,-9,19,29,25
24374,12216,12229,21,5,24,10,9,5,35,29,6,29,19,39
24375,12216,12229,9,9,24,6,12,6,33,33,0,24,24,30
24376,12216,12229,4,14,24,5,10,9,33,40,-7,20,28,25
24377,12216,12229,37,11,24,6,9,9,27,30,-3,21,27,27
24378,12230,12236,49,6,25,10,8,7,30,17,13,28,22,38
24379,10410,10416,43,2,24,15,6,3,57,24,33,36,12,51
24380,10410,10416,57,17,24,4,6,14,23,37,-14,14,34,18
24381,10410,10416,22,18,24,2,8,14,15,48,-33,12,36,14
24382,10410,10416,1,4,24,12,8,4,47,24,23,32,16,44
24383,10438,10444,1,5,29,13,9,7,54,36,18,35,23,48
24384,10438,10444,24,1,29,21,6,2,55,16,39,48,10,69
24385,10438,10444,43,2,29,18,8,3,71,31,40,44,14,62
24386,10438,10444,57,11,29,9,6,14,33,39,-6,24,34,33
24387,10438,10444,22,18,29,2,9,18,18,59,-41,13,45,15
24388,10438,10444,21,4,29,14,9,6,54,33,21,37,21,51
24389,10438,10444,27,13,29,6,13,10,26,42,-16,25,33,31
24390,10438,10444,17,12,29,8,7,14,23,43,-20,23,35,31
24391,10438,10444,53,16,29,7,8,14,35,51,-16,22,36,29
24392,10438,10444,12,16,29,7,8,14,35,51,-16,22,36,29
24393,10438,10444,28,7,29,11,9,9,35,39,-4,31,27,42
24394,10438,10444,52,14,29,9,3,17,30,52,-22,21,37,30
24395,10438,10444,54,15,29,8,6,15,30,49,-19,22,36,30
24396,10438,10444,41,3,29,14,10,5,51,19,32,38,20,52
24397,10438,10444,20,8,29,11,5,13,45,45,0,27,31,38
24398,10438,10444,56,9,29,8,14,7,43,37,6,30,28,38
24399,10438,10444,49,6,29,13,8,8,42,33,9,34,24,47
24400,10438,10444,37,10,29,9,8,12,34,39,-5,26,32,35
24401,10480,10573,27,16,34,6,17,11,31,49,-18,29,39,35
24402,10480,10573,49,6,34,14,8,12,46,43,3,36,32,50
24403,10480,10573,37,11,34,10,8,16,40,51,-11,28,40,38
24404,10480,10573,12,14,34,9,10,15,44,57,-13,28,40,37
24405,10480,10573,53,17,34,8,10,16,41,63,-22,26,42,34
24406,10480,10573,41,3,34,17,12,5,64,22,42,46,22,63
24407,10480,10573,56,8,34,9,17,8,53,44,9,35,33,44
24408,10480,10573,20,9,34,11,8,15,48,52,-4,30,38,41
24409,10480,10573,28,7,34,12,11,11,39,44,-5,35,33,47
24410,10480,10573,54,12,34,10,8,16,37,55,-18,28,40,38
24411,10480,10573,52,15,34,10,5,19,36,59,-23,25,43,35
24412,10480,10573,21,5,34,16,10,8,62,39,23,42,26,58
24413,10480,10573,24,1,34,25,7,2,64,20,44,57,11,82
24414,10480,10573,43,2,34,22,9,3,83,36,47,53,15,75
24415,10480,10573,57,13,34,10,7,17,41,54,-13,27,41,37
24416,10480,10573,22,18,34,2,11,21,20,67,-47,15,53,17
24417,10480,10573,17,10,34,10,9,15,29,46,-17,29,39,39
24418,10480,10573,1,4,34,17,9,8,67,44,23,43,25,60
24419,10245,10248,17,14,9,1,4,4,7,15,-8,6,12,7
24420,10245,10248,22,15,9,1,4,4,4,16,-12,6,12,7
24421,10245,10248,57,16,9,1,3,5,8,15,-7,5,13,6
24422,10245,10248,43,1,9,8,0,1,23,8,15,16,2,24
24423,10245,10248,24,2,9,7,2,0,21,8,13,16,2,23
24424,10245,10248,41,6,9,4,4,1,18,7,11,12,6,16
24425,10245,10248,20,8,9,4,2,3,13,15,-2,10,8,14
24426,10245,10248,56,10,9,2,3,4,13,15,-2,7,11,9
24427,10245,10248,49,7,9,4,3,2,14,9,5,11,7,15
24428,10245,10248,37,9,9,2,3,4,10,10,0,7,11,9
24429,10245,10248,28,5,9,5,2,2,13,11,2,12,6,17
24430,10245,10248,52,13,9,2,2,5,5,13,-8,6,12,8
24431,10245,10248,54,18,9,0,2,7,9,21,-12,2,16,2
24432,10245,10248,1,3,9,6,2,1,23,8,15,14,4,20
24433,10245,10248,53,11,9,2,3,4,13,17,-4,7,11,9
24434,10245,10248,12,12,9,2,2,5,10,12,-2,6,12,8
24435,10245,10248,27,17,9,1,3,5,6,20,-14,5,13,6
24436,10245,10248,21,4,9,6,2,1,22,12,10,14,4,20
24437,10732,10738,1,2,18,12,4,2,34,16,18,28,8,40
24438,10732,10738,12,9,18,6,6,6,21,28,-7,18,18,24
24439,10732,10738,53,16,18,3,6,9,12,30,-18,12,24,15
24440,10732,10738,17,6,18,7,4,7,24,34,-10,18,18,25
24441,10732,10738,28,15,18,3,6,9,13,29,-16,12,24,15
24442,10732,10738,54,18,18,2,6,10,12,26,-14,10,26,12
24443,10732,10738,27,12,18,5,6,7,22,23,-1,16,20,21
24444,10732,10738,49,7,18,6,7,5,24,20,4,19,17,25
24445,10732,10738,37,13,18,5,4,9,17,29,-12,14,22,19
24446,10732,10738,21,3,18,9,7,2,40,18,22,25,11,34
24447,10732,10738,4,8,18,6,7,5,20,18,2,19,17,25
24448,10732,10738,43,1,18,12,4,2,39,7,32,28,8,40
24449,10732,10738,24,4,18,8,10,0,29,5,24,26,10,34
24450,10732,10738,57,5,18,8,5,5,26,19,7,21,15,29
24451,10732,10738,35,10,18,7,2,9,24,26,-2,16,20,23
24452,10732,10738,56,11,18,5,7,6,16,23,-7,17,19,22
24453,10732,10738,41,14,18,4,6,8,13,16,-3,14,22,18
24454,10732,10738,20,17,18,3,5,10,18,37,-19,11,25,14
24455,10753,10759,56,11,21,6,7,8,20,29,-9,19,23,25
24456,10753,10759,35,12,21,7,2,12,24,34,-10,16,26,23
24457,22814,22820,25,7,26,11,6,9,49,43,6,28,24,39
24458,22814,22820,28,10,26,9,8,9,26,29,-3,26,26,35
24459,22814,22820,39,2,26,17,5,4,53,29,24,39,13,56
24460,22814,22820,27,11,26,9,5,12,33,42,-9,23,29,32
24461,22814,22820,15,15,26,7,4,15,32,51,-19,18,34,25
24462,22814,22820,45,16,26,5,7,14,32,54,-22,17,35,22
24463,22814,22820,56,14,26,7,5,14,30,47,-17,19,33,26
24464,22814,22820,13,18,26,5,4,17,24,49,-25,14,38,19
24465,22814,22820,49,6,26,12,5,9,42,34,8,29,23,41
24466,22814,22820,16,12,26,8,8,10,38,38,0,24,28,32
24467,22814,22820,1,4,26,11,10,5,45,32,13,32,20,43
24468,22870,22876,1,5,33,15,11,7,54,36,18,41,25,56
24469,22870,22876,49,6,33,16,7,10,56,42,14,39,27,55
24470,22870,22876,16,11,33,12,9,12,53,46,7,33,33,45
24471,22870,22876,21,3,33,21,6,6,58,26,32,48,18,69
24472,22870,22876,4,4,33,16,8,9,63,36,27,40,26,56
24473,22870,22876,9,17,33,6,6,21,35,75,-40,18,48,24
24474,22870,22876,56,14,33,8,7,18,35,57,-22,23,43,31
24475,22870,22876,13,18,33,5,4,24,27,67,-40,14,52,19
24476,22870,22876,39,2,33,22,6,5,66,39,27,50,16,72
24477,22870,22876,27,8,33,14,5,14,43,50,-7,33,33,47
24478,22870,22876,15,15,33,7,7,19,40,68,-28,21,45,28
24479,22870,22876,45,16,33,6,9,18,48,75,-27,21,45,27
24480,22870,22876,28,12,33,11,9,13,37,39,-2,31,35,42
24481,22870,22876,25,7,33,14,8,11,60,52,8,36,30,50
24482,22870,22876,22,1,33,23,5,5,76,35,41,51,15,74
24483,22870,22876,57,9,33,12,11,10,47,44,3,35,31,47
24484,22870,22876,43,10,33,13,7,13,47,43,4,33,33,46
24485,22870,22876,24,13,33,10,7,16,46,61,-15,27,39,37
24486,22625,22631,21,1,4,4,0,0,8,2,6,8,0,12
24487,22625,22631,4,4,4,2,2,0,8,5,3,6,2,8
24488,22625,22631,9,9,4,2,0,2,6,7,-1,4,4,6
24489,22625,22631,25,7,4,2,0,2,7,6,1,4,4,6
24490,22625,22631,28,17,4,0,3,1,2,5,-3,3,5,3
24491,22625,22631,56,14,4,1,1,2,2,4,-2,3,5,4
24492,22625,22631,13,18,4,0,0,4,1,7,-6,0,8,0
24493,22625,22631,39,6,4,2,1,1,4,5,-1,5,3,7
24494,22625,22631,27,8,4,2,0,2,5,5,0,4,4,6
24495,22625,22631,45,13,4,1,1,2,4,6,-2,3,5,4
24496,22625,22631,15,16,4,1,0,3,5,9,-4,2,6,3
24497,22625,22631,1,5,4,2,1,1,8,5,3,5,3,7
24498,22625,22631,22,2,4,3,0,1,13,7,6,6,2,9
24499,22625,22631,43,3,4,3,0,1,8,2,6,6,2,9
24500,22625,22631,24,11,4,1,1,2,4,4,0,3,5,4
24501,22625,22631,57,15,4,1,1,2,1,4,-3,3,5,4
24502,22625,22631,16,9,4,2,0,2,6,7,-1,4,4,6
24503,22625,22631,49,12,4,1,1,2,7,9,-2,3,5,4
24504,23059,23065,43,2,11,6,3,2,18,13,5,15,7,21
24505,23059,23065,57,4,11,6,0,5,14,11,3,12,10,18
24506,23059,23065,22,5,11,4,6,1,20,10,10,14,8,18
24507,23059,23065,24,13,11,3,2,6,11,16,-5,8,14,11
24508,23059,23065,1,7,11,4,4,3,23,12,11,12,10,16
24509,23059,23065,56,15,11,2,2,7,9,22,-13,6,16,8
24510,23059,23065,4,3,11,5,5,1,16,12,4,15,7,20
24511,23059,23065,21,6,11,4,5,2,19,8,11,13,9,17
24512,23059,23065,49,8,11,4,4,3,13,11,2,12,10,16
24513,23059,23065,16,12,11,3,3,5,18,19,-1,9,13,12
24514,23059,23065,28,10,11,3,4,4,11,18,-7,10,12,13
24515,23059,23065,39,1,11,8,1,2,26,13,13,17,5,25
24516,23059,23065,27,9,11,3,4,4,13,17,-4,10,12,13
24517,23059,23065,15,14,11,3,1,7,14,26,-12,7,15,10
24518,23059,23065,25,16,11,1,4,6,12,20,-8,6,16,7
24519,23059,23065,55,11,11,3,4,4,12,21,-9,10,12,13
24520,23108,23114,55,11,17,4,6,7,18,31,-13,14,20,18
24521,23108,23114,25,14,17,3,5,9,23,33,-10,11,23,14
24522,23108,23114,39,1,17,13,2,2,40,18,22,28,6,41
24523,23108,23114,27,12,17,4,5,8,18,28,-10,13,21,17
24524,23108,23114,15,13,17,4,3,10,20,36,-16,11,23,15
24525,23108,23114,28,8,17,5,8,4,21,25,-4,18,16,23
24526,23108,23114,4,3,17,8,8,1,30,18,12,24,10,32
24527,23108,23114,21,4,17,8,6,3,34,14,20,22,12,30
24528,23108,23114,49,9,17,5,6,6,18,25,-7,16,18,21
24529,23108,23114,16,15,17,3,4,10,21,32,-11,10,24,13
24530,23108,23114,56,16,17,2,4,11,12,35,-23,8,26,10
24531,23108,23114,1,6,17,7,6,4,29,15,14,20,14,27
24532,23108,23114,43,2,17,10,5,2,34,19,15,25,9,35
24533,23108,23114,22,5,17,7,7,3,33,18,15,21,13,28
24534,23108,23114,57,7,17,8,1,8,20,19,1,17,17,25
24535,23108,23114,24,10,17,5,4,8,16,21,-5,14,20,19
24536,10753,10759,41,13,21,5,7,9,17,20,-3,17,25,22
24537,10753,10759,20,17,21,3,5,13,19,45,-26,11,31,14
24538,10753,10759,17,8,21,8,4,9,27,38,-11,20,22,28
24539,10753,10759,43,2,21,14,4,3,49,8,41,32,10,46
24540,10753,10759,24,3,21,10,10,1,34,8,26,30,12,40
24541,10753,10759,57,5,21,10,6,5,34,22,12,26,16,36
24542,10753,10759,21,4,21,10,8,3,42,20,22,28,14,38
24543,10753,10759,4,7,21,7,8,6,24,22,2,22,20,29
24544,10753,10759,49,6,21,9,7,5,29,20,9,25,17,34
24545,10753,10759,37,16,21,5,4,12,18,38,-20,14,28,19
24546,10753,10759,27,10,21,7,6,8,29,27,2,20,22,27
24547,10753,10759,1,1,21,14,5,2,42,18,24,33,9,47
24548,10753,10759,28,14,21,5,7,9,18,30,-12,17,25,22
24549,10753,10759,54,18,21,2,7,12,13,33,-20,11,31,13
24550,10753,10759,12,9,21,7,7,7,24,36,-12,21,21,28
24551,10753,10759,53,15,21,5,6,10,19,34,-15,16,26,21
24552,10788,10794,12,8,26,9,7,10,27,45,-18,25,27,34
24553,10788,10794,53,12,26,8,6,12,26,42,-16,22,30,30
24554,10788,10794,21,4,26,12,10,4,51,24,27,34,18,46
24555,10788,10794,4,6,26,9,11,6,33,28,5,29,23,38
24556,10788,10794,28,15,26,6,8,12,19,37,-18,20,32,26
24557,10788,10794,54,18,26,4,7,15,20,45,-25,15,37,19
24558,10788,10794,27,9,26,8,8,10,35,37,-2,24,28,32
24559,10788,10794,49,5,26,11,8,7,37,24,13,30,22,41
24560,10788,10794,37,16,26,5,5,16,19,48,-29,15,37,20
24561,10788,10794,17,13,26,8,5,13,30,51,-21,21,31,29
24562,10788,10794,43,1,26,19,4,3,63,10,53,42,10,61
24563,10788,10794,24,3,26,14,11,1,50,9,41,39,13,53
24564,10788,10794,57,7,26,10,7,9,39,32,7,27,25,37
24565,10788,10794,35,10,26,9,4,13,32,40,-8,22,30,31
24566,10788,10794,56,11,26,8,7,11,29,38,-9,23,29,31
24567,10788,10794,41,14,26,6,10,10,22,30,-8,22,30,28
24568,10788,10794,20,17,26,4,8,14,25,52,-27,16,36,20
24569,10788,10794,1,2,26,18,6,2,54,19,35,42,10,60
24570,10809,10815,1,1,29,21,6,2,65,19,46,48,10,69
24571,10809,10815,56,8,29,10,7,12,33,42,-9,27,31,37
24572,10809,10815,35,13,29,9,6,14,36,46,-10,24,34,33
24573,10809,10815,41,14,29,7,10,12,26,36,-10,24,34,31
24574,10809,10815,20,17,29,5,8,16,27,57,-30,18,40,23
24575,10809,10815,43,2,29,21,4,4,67,14,53,46,12,67
24576,10809,10815,24,3,29,17,11,1,59,9,50,45,13,62
24577,10809,10815,57,7,29,10,7,12,41,41,0,27,31,37
24578,10809,10815,17,11,29,10,5,14,35,55,-20,25,33,35
24579,10809,10815,27,9,29,9,9,11,38,40,-2,27,31,36
24580,10809,10815,28,15,29,6,10,13,21,40,-19,22,36,28
24581,10809,10815,54,18,29,4,8,17,22,54,-32,16,42,20
24582,10809,10815,21,4,29,13,10,6,55,31,24,36,22,49
24583,10809,10815,4,6,29,10,12,7,39,32,7,32,26,42
24584,10809,10815,49,5,29,12,10,7,43,27,16,34,24,46
24585,10809,10815,37,16,29,6,6,17,23,52,-29,18,40,24
24586,10809,10815,12,10,29,9,9,11,30,51,-21,27,31,36
24587,10809,10815,53,12,29,9,8,12,29,43,-14,26,32,35
24588,10844,10941,37,17,34,8,8,18,31,57,-26,24,44,32
24589,10844,10941,21,5,34,15,13,6,63,32,31,43,25,58
24590,10844,10941,4,6,34,12,12,10,46,38,8,36,32,48
24591,10844,10941,28,15,34,8,11,15,25,45,-20,27,41,35
24592,10844,10941,54,18,34,5,11,18,29,61,-32,21,47,26
24593,10844,10941,27,13,34,9,9,16,41,56,-15,27,41,36
24594,10844,10941,53,9,34,11,10,13,34,47,-13,32,36,43
24595,10844,10941,12,12,34,9,10,15,34,66,-32,28,40,37
24596,10844,10941,17,10,34,11,6,17,42,66,-24,28,40,39
24597,10844,10941,43,2,34,24,5,5,76,21,55,53,15,77
24598,10844,10941,24,3,34,19,12,3,65,14,51,50,18,69
24599,10844,10941,57,8,34,12,7,15,46,47,-1,31,37,43
24600,10844,10941,49,4,34,16,10,8,54,33,21,42,26,58
24601,10844,10941,56,7,34,13,7,14,39,46,-7,33,35,46
24602,10844,10941,35,11,34,10,7,17,38,52,-14,27,41,37
24603,10844,10941,41,14,34,8,12,14,35,45,-10,28,40,36
24604,10844,10941,20,16,34,8,9,17,35,64,-29,25,43,33
24605,10844,10941,1,1,34,25,7,2,76,19,57,57,11,82
24606,10634,10640,56,7,9,4,2,3,12,13,-1,10,8,14
24607,10634,10640,35,12,9,3,1,5,12,13,-1,7,11,10
24608,10634,10640,41,15,9,2,2,5,4,8,-4,6,12,8
24609,10634,10640,20,16,9,2,2,5,9,18,-9,6,12,8
24610,10634,10640,4,5,9,4,2,3,14,12,2,10,8,14
24611,10634,10640,21,8,9,3,5,1,15,8,7,11,7,14
24612,10634,10640,43,1,9,7,2,0,24,3,21,16,2,23
24613,10634,10640,24,2,9,6,3,0,20,4,16,15,3,21
24614,22303,22309,15,2,9,5,2,2,18,10,8,12,6,17
24615,22303,22309,39,5,9,5,1,3,17,9,8,11,7,16
24616,22303,22309,27,12,9,3,4,2,15,11,4,10,8,13
24617,22303,22309,45,15,9,2,3,4,14,18,-4,7,11,9
24618,22303,22309,56,7,9,4,2,3,12,10,2,10,8,14
24619,22303,22309,13,14,9,3,0,6,8,16,-8,6,12,9
24620,22604,22610,25,2,1,1,0,0,2,0,2,2,0,3
24621,22604,22610,27,1,1,1,0,0,3,1,2,2,0,3
24622,22604,22610,45,2,1,1,0,0,2,0,2,2,0,3
24623,22604,22610,39,10,1,0,1,0,1,1,0,1,1,1
24624,22604,22610,15,13,1,0,0,1,1,3,-2,0,2,0
24625,22604,22610,28,10,1,0,1,0,1,1,0,1,1,1
24626,22604,22610,13,14,1,0,0,1,0,2,-2,0,2,0
24627,22604,22610,56,14,1,0,0,1,0,2,-2,0,2,0
24628,22604,22610,21,2,1,1,0,0,2,0,2,2,0,3
24629,22604,22610,4,8,1,0,1,0,2,2,0,1,1,1
24630,22604,22610,9,14,1,0,0,1,0,2,-2,0,2,0
24631,22604,22610,16,2,1,1,0,0,2,0,2,2,0,3
24632,22604,22610,49,8,1,0,1,0,2,2,0,1,1,1
24633,22604,22610,1,7,1,1,0,0,3,2,1,2,0,3
24634,22604,22610,43,2,1,1,0,0,2,0,2,2,0,3
24635,22604,22610,22,12,1,0,0,1,2,3,-1,0,2,0
24636,22604,22610,57,14,1,0,0,1,0,2,-2,0,2,0
24637,22604,22610,24,14,1,0,0,1,0,2,-2,0,2,0
24638,22674,22680,16,5,10,5,2,3,16,16,0,12,8,17
24639,22674,22680,49,6,10,5,1,4,15,15,0,11,9,16
24640,22674,22680,21,1,10,9,0,1,22,8,14,18,2,27
24641,22674,22680,4,9,10,4,2,4,16,14,2,10,10,14
24642,22674,22680,9,13,10,3,1,6,11,15,-4,7,13,10
24643,22674,22680,56,14,10,3,1,6,8,16,-8,7,13,10
24644,22674,22680,13,16,10,3,0,7,10,18,-8,6,14,9
24645,22674,22680,28,11,10,3,4,3,10,9,1,10,10,13
24646,22674,22680,39,4,10,6,1,3,17,14,3,13,7,19
24647,22674,22680,27,8,10,5,0,5,16,16,0,10,10,15
24648,22674,22680,15,15,10,3,0,7,9,16,-7,6,14,9
24649,22674,22680,45,18,10,1,2,7,7,20,-13,4,16,5
24650,22674,22680,1,3,10,7,1,2,22,10,12,15,5,22
24651,22674,22680,25,7,10,5,0,5,18,18,0,10,10,15
24652,22674,22680,22,2,10,8,1,1,24,10,14,17,3,25
24653,22674,22680,43,10,10,4,1,5,16,11,5,9,11,13
24654,22674,22680,24,12,10,3,2,5,16,18,-2,8,12,11
24655,22674,22680,57,17,10,2,3,5,9,18,-9,7,13,9
24656,22709,22715,22,1,16,14,1,1,43,15,28,29,3,43
24657,22709,22715,57,10,16,6,4,6,23,24,-1,16,16,22
24658,22709,22715,43,11,16,6,2,8,25,23,2,14,18,20
24659,22709,22715,24,13,16,5,3,8,24,30,-6,13,19,18
24660,22709,22715,25,7,16,7,2,7,28,30,-2,16,16,23
24661,22709,22715,1,4,16,10,2,4,32,18,14,22,10,32
24662,22709,22715,39,3,16,10,3,3,32,20,12,23,9,33
24663,22709,22715,27,12,16,6,1,9,22,29,-7,13,19,19
24664,22709,22715,15,15,16,5,0,11,19,33,-14,10,22,15
24665,22709,22715,45,17,16,3,3,10,18,35,-17,9,23,12
24666,22709,22715,28,8,16,6,5,5,17,18,-1,17,15,23
24667,22709,22715,56,16,16,3,3,10,14,29,-15,9,23,12
24668,22709,22715,13,18,16,3,2,11,16,28,-12,8,24,11
24669,22709,22715,9,14,16,5,2,9,20,31,-11,12,20,17
24670,22709,22715,49,5,16,9,1,6,27,19,8,19,13,28
24671,22709,22715,16,9,16,6,4,6,25,26,-1,16,16,22
24672,22709,22715,21,2,16,11,1,4,28,15,13,23,9,34
24673,22709,22715,4,6,16,8,3,5,28,18,10,19,13,27
24674,22842,22855,56,14,30,8,6,16,35,54,-19,22,38,30
24675,22842,22855,13,18,30,5,4,21,26,58,-32,14,46,19
24676,22842,22855,49,7,30,13,7,10,48,40,8,33,27,46
24677,22842,22855,16,11,30,10,9,11,44,43,1,29,31,39
24678,22842,22855,21,3,30,18,6,6,53,25,28,42,18,60
24679,22842,22855,4,4,30,15,6,9,56,34,22,36,24,51
24680,22842,22855,9,16,30,6,6,18,34,63,-29,18,42,24
24681,22842,22855,45,17,30,5,9,16,41,69,-28,19,41,24
24682,22842,22855,28,12,30,10,9,11,30,34,-4,29,31,39
24683,22842,22855,25,6,30,14,6,10,58,49,9,34,26,48
24684,22842,22855,39,2,30,20,5,5,61,36,25,45,15,65
24685,22842,22855,27,9,30,12,5,13,36,43,-7,29,31,41
24686,22842,22855,15,15,30,7,6,17,39,62,-23,20,40,27
24687,22842,22855,1,5,30,13,10,7,49,36,13,36,24,49
24688,22842,22855,22,1,30,21,5,4,69,30,39,47,13,68
24689,22842,22855,43,8,30,12,6,12,44,38,6,30,30,42
24690,22842,22855,57,10,30,10,11,9,41,41,0,31,29,41
24691,22842,22855,24,13,30,10,6,14,44,53,-9,26,34,36
24692,22856,22862,22,1,31,22,5,4,71,31,40,49,13,71
24693,22856,22862,43,8,31,13,6,12,45,38,7,32,30,45
24694,23150,23156,43,2,21,12,7,2,40,22,18,31,11,43
24695,23150,23156,22,5,21,9,8,4,42,21,21,26,16,35
24696,23150,23156,57,7,21,10,2,9,26,23,3,22,20,32
24697,23150,23156,24,9,21,7,4,10,22,26,-4,18,24,25
24698,23150,23156,49,10,21,5,8,8,19,30,-11,18,24,23
24699,23150,23156,16,15,21,4,5,12,26,39,-13,13,29,17
24700,23150,23156,1,4,21,10,7,4,41,17,24,27,15,37
24701,23150,23156,56,16,21,3,4,14,13,44,-31,10,32,13
24702,23150,23156,4,3,21,10,8,3,37,22,15,28,14,38
24703,23150,23156,21,6,21,9,8,4,41,21,20,26,16,35
24704,23150,23156,28,8,21,6,9,6,24,31,-7,21,21,27
24705,23150,23156,39,1,21,16,3,2,46,21,25,35,7,51
24706,23150,23156,27,12,21,5,6,10,22,34,-12,16,26,21
24707,23150,23156,15,14,21,5,3,13,22,43,-21,13,29,18
24708,23150,23156,25,11,21,5,6,10,30,38,-8,16,26,21
24709,23150,23156,55,13,21,5,6,10,22,41,-19,16,26,21
24710,23178,23184,25,10,26,7,8,11,40,48,-8,22,30,29
24711,23178,23184,55,14,26,5,7,14,28,56,-28,17,35,22
24712,23178,23184,28,9,26,8,10,8,32,41,-9,26,26,34
24713,23178,23184,39,1,26,19,5,2,57,28,29,43,9,62
24714,23178,23184,27,13,26,6,7,13,25,42,-17,19,33,25
24715,23178,23184,15,15,26,6,3,17,23,51,-28,15,37,21
24716,23178,23184,56,16,26,4,6,16,18,51,-33,14,38,18
24717,23178,23184,21,4,26,12,8,6,48,24,24,32,20,44
24718,23178,23184,4,5,26,11,9,6,43,31,12,31,21,42
24719,23178,23184,1,3,26,12,9,5,54,24,30,33,19,45
24720,23178,23184,43,2,26,15,9,2,52,28,24,39,13,54
24721,23178,23184,57,6,26,12,4,10,36,31,5,28,24,40
24722,23178,23184,22,7,26,10,10,6,48,27,21,30,22,40
24723,23178,23184,24,8,26,10,6,10,30,30,0,26,26,36
24724,23178,23184,49,11,26,6,10,10,24,36,-12,22,30,28
24725,23178,23184,16,12,26,6,7,13,31,41,-10,19,33,25
24726,23185,23191,49,11,27,6,10,11,25,38,-13,22,32,28
24727,23185,23191,16,12,27,6,8,13,32,42,-10,20,34,26
24728,23185,23191,43,2,27,16,9,2,54,29,25,41,13,57
24729,23185,23191,57,5,27,13,4,10,38,31,7,30,24,43
24730,23185,23191,22,6,27,11,10,6,49,27,22,32,22,43
24731,23185,23191,24,8,27,11,6,10,33,30,3,28,26,39
24732,23185,23191,1,3,27,12,9,6,55,26,29,33,21,45
24733,23185,23191,21,4,27,12,9,6,50,26,24,33,21,45
24734,23185,23191,4,7,27,11,10,6,45,33,12,32,22,43
24735,23185,23191,56,16,27,4,6,17,18,54,-36,14,40,18
24736,23185,23191,39,1,27,20,5,2,59,29,30,45,9,65
24737,23185,23191,27,13,27,6,7,14,25,43,-18,19,35,25
24738,23185,23191,15,15,27,6,3,18,23,53,-30,15,39,21
24739,23185,23191,28,9,27,9,10,8,33,41,-8,28,26,37
24740,23185,23191,25,10,27,7,8,12,40,49,-9,22,32,29
24741,23185,23191,55,14,27,5,8,14,29,57,-28,18,36,23
24742,22989,22995,55,8,3,2,0,1,3,5,-2,4,2,6
24743,22989,22995,25,14,3,0,1,2,3,6,-3,1,5,1
24744,22989,22995,22,5,3,2,0,1,5,1,4,4,2,6
24745,22989,22995,43,7,3,2,0,1,2,2,0,4,2,6
24746,22989,22995,28,6,3,2,0,1,2,1,1,4,2,6
24747,22989,22995,39,1,3,3,0,0,8,1,7,6,0,9
24748,22989,22995,15,9,3,1,1,1,3,7,-4,3,3,4
24749,22989,22995,27,11,3,0,2,1,2,4,-2,2,4,2
24750,22989,22995,4,2,3,3,0,0,7,3,4,6,0,9
24751,22989,22995,21,4,3,2,0,1,7,1,6,4,2,6
24752,22989,22995,49,12,3,0,1,2,1,3,-2,1,5,1
24753,22989,22995,16,15,3,0,1,2,3,8,-5,1,5,1
24754,22989,22995,56,16,3,0,0,3,2,10,-8,0,6,0
24755,22989,22995,1,3,3,2,1,0,7,1,6,5,1,7
24756,22989,22995,57,10,3,1,0,2,2,2,0,2,4,3
24757,22989,22995,24,12,3,0,1,2,1,3,-2,1,5,1
24758,9731,9737,2,11,29,8,10,11,28,39,-11,26,32,34
24759,9731,9737,57,12,29,7,10,12,31,35,-4,24,34,31
24760,9731,9737,41,6,29,12,7,10,36,32,4,31,27,43
24761,9731,9737,20,9,29,11,6,12,40,39,1,28,30,39
24762,9521,9527,13,11,5,1,2,2,5,7,-2,4,6,5
24763,9521,9527,20,15,5,1,1,3,6,15,-9,3,7,4
24764,9521,9527,43,4,5,3,1,1,11,3,8,7,3,10
24765,9521,9527,24,7,5,2,2,1,7,3,4,6,4,8
24766,9521,9527,2,12,5,1,2,2,6,9,-3,4,6,5
24767,9521,9527,57,16,5,1,0,4,7,8,-1,2,8,3
24768,9521,9527,49,2,5,3,2,0,10,2,8,8,2,11
24769,9521,9527,37,3,5,3,2,0,9,1,8,8,2,11
24770,9521,9527,4,9,5,2,0,3,5,13,-8,4,6,6
24771,9521,9527,21,17,5,0,3,2,2,6,-4,3,7,3
24772,9521,9527,56,6,5,2,2,1,11,4,7,6,4,8
24773,9521,9527,41,10,5,1,3,1,6,7,-1,5,5,6
24774,9521,9527,53,5,5,2,3,0,5,2,3,7,3,9
24775,9521,9527,12,8,5,1,4,0,4,3,1,6,4,7
24776,9521,9527,52,13,5,1,1,3,6,10,-4,3,7,4
24777,9521,9527,48,18,5,0,2,3,2,13,-11,2,8,2
24778,9521,9527,27,14,5,1,1,3,4,12,-8,3,7,4
24779,9521,9527,1,1,5,4,1,0,16,4,12,9,1,13
24780,9528,9534,1,1,6,4,2,0,18,6,12,10,2,14
24781,9528,9534,27,15,6,1,2,3,4,12,-8,4,8,5
24782,9528,9534,52,11,6,2,1,3,8,10,-2,5,7,7
24783,9528,9534,48,18,6,0,2,4,2,15,-13,2,10,2
24784,9528,9534,12,6,6,2,4,0,6,3,3,8,4,10
24785,9528,9534,53,8,6,2,3,1,5,7,-2,7,5,9
24786,9528,9534,4,13,6,2,1,3,5,13,-8,5,7,7
24787,9528,9534,21,17,6,0,3,3,3,8,-5,3,9,3
24788,9528,9534,37,3,6,3,3,0,11,3,8,9,3,12
24789,9528,9534,49,4,6,3,2,1,10,3,7,8,4,11
24790,9528,9534,43,2,6,4,1,1,16,3,13,9,3,13
24791,9528,9534,24,5,6,3,2,1,9,4,5,8,4,11
24792,9528,9534,2,14,6,1,2,3,6,12,-6,4,8,5
24793,9528,9534,57,16,6,1,0,5,7,10,-3,2,10,3
24794,9528,9534,41,7,6,2,3,1,9,7,2,7,5,9
24795,9528,9534,56,9,6,2,2,2,12,6,6,6,6,8
24796,9528,9534,13,10,6,2,2,2,7,8,-1,6,6,8
24797,9528,9534,20,12,6,2,1,3,7,15,-8,5,7,7
24798,9913,9926,21,3,12,7,5,0,27,11,16,19,5,26
24799,9913,9926,4,14,12,3,1,8,12,24,-12,7,17,10
24800,9913,9926,53,8,12,5,1,6,14,16,-2,11,13,16
24801,9913,9926,12,9,12,4,4,4,14,14,0,12,12,16
24802,9913,9926,28,7,12,6,3,3,13,12,1,15,9,21
24803,9913,9926,52,13,12,3,3,6,11,18,-7,9,15,12
24804,9913,9926,24,2,12,8,2,2,16,8,8,18,6,26
24805,9913,9926,43,4,12,6,5,1,23,6,17,17,7,23
24806,9913,9926,57,11,12,3,4,5,14,16,-2,10,14,13
24807,9913,9926,22,12,12,4,0,8,15,31,-16,8,16,12
24808,9913,9926,2,15,12,3,1,8,10,22,-12,7,17,10
24809,9913,9926,41,5,12,6,5,1,20,11,9,17,7,23
24810,9913,9926,20,6,12,7,1,4,25,15,10,15,9,22
24811,9913,9926,56,18,12,2,3,7,11,22,-11,7,17,9
24812,9913,9926,27,16,12,2,4,6,13,22,-9,8,16,10
24813,9913,9926,49,10,12,4,3,5,19,19,0,11,13,15
24814,9913,9926,37,17,12,2,3,7,13,17,-4,7,17,9
24815,9913,9926,1,1,12,8,2,2,27,13,14,18,6,26
24816,10046,10052,49,8,24,8,7,9,35,33,2,23,25,31
24817,10046,10052,37,14,24,6,7,11,28,26,2,19,29,25
24818,10046,10052,28,9,24,8,7,9,21,27,-6,23,25,31
24819,10046,10052,52,12,24,6,10,8,26,30,-4,22,26,28
24820,10046,10052,27,11,24,8,6,10,30,37,-7,22,26,30
24821,10046,10052,24,1,24,17,3,4,38,18,20,37,11,54
24822,10046,10052,43,6,24,10,8,6,40,21,19,28,20,38
24823,10046,10052,57,10,24,8,6,10,34,36,-2,22,26,30
24824,10046,10052,2,17,24,6,3,15,19,43,-24,15,33,21
24825,10046,10052,22,18,24,5,4,15,24,61,-37,14,34,19
24826,10046,10052,1,2,24,16,3,5,55,28,27,35,13,51
24827,10046,10052,53,7,24,9,5,10,31,30,1,23,25,32
24828,10046,10052,12,15,24,6,7,11,28,33,-5,19,29,25
24829,10046,10052,21,3,24,14,7,3,53,27,26,35,13,49
24830,10046,10052,4,13,24,8,3,13,26,41,-15,19,29,27
24831,10046,10052,41,4,24,10,11,3,39,21,18,31,17,41
24832,10046,10052,20,5,24,12,4,8,40,32,8,28,20,40
24833,10046,10052,56,16,24,6,5,13,27,50,-23,17,31,23
24834,9871,9877,21,1,6,4,2,0,17,7,10,10,2,14
24835,9871,9877,4,18,6,0,0,6,6,16,-10,0,12,0
24836,9871,9877,24,3,6,4,1,1,9,4,5,9,3,13
24837,9871,9877,43,4,6,3,3,0,7,1,6,9,3,12
24838,9871,9877,2,12,6,2,1,3,6,10,-4,5,7,7
24839,22856,22862,57,10,31,11,11,9,43,41,2,33,29,44
24840,22856,22862,24,13,31,10,6,15,44,56,-12,26,36,36
24841,22856,22862,1,5,31,14,10,7,52,36,16,38,24,52
24842,22856,22862,25,7,31,14,6,11,60,52,8,34,28,48
24843,22856,22862,28,12,31,10,9,12,31,36,-5,29,33,39
24844,22856,22862,39,2,31,21,5,5,63,37,26,47,15,68
24845,22856,22862,27,9,31,13,5,13,39,45,-6,31,31,44
24846,22856,22862,15,15,31,7,6,18,39,63,-24,20,42,27
24847,22856,22862,45,17,31,5,9,17,41,71,-30,19,43,24
24848,22856,22862,21,3,31,19,6,6,55,25,30,44,18,63
24849,22856,22862,4,4,31,16,6,9,61,34,27,38,24,54
24850,22856,22862,9,16,31,6,6,19,35,66,-31,18,44,24
24851,22856,22862,49,6,31,14,7,10,51,41,10,35,27,49
24852,22856,22862,16,11,31,10,9,12,45,45,0,29,33,39
24853,22856,22862,56,14,31,8,6,17,35,56,-21,22,40,30
24854,22856,22862,13,18,31,5,4,22,26,63,-37,14,48,19
24855,23073,23079,4,3,13,7,5,1,22,14,8,19,7,26
24856,23073,23079,21,6,13,5,5,3,23,12,11,15,11,20
24857,23073,23079,49,8,13,4,5,4,15,15,0,13,13,17
24858,23073,23079,16,13,13,3,3,7,19,26,-7,9,17,12
24859,23073,23079,39,1,13,10,1,2,31,15,16,21,5,31
24860,23073,23079,15,10,13,4,2,7,17,27,-10,10,16,14
24861,23073,23079,27,12,13,3,4,6,14,22,-8,10,16,13
24862,23073,23079,56,16,13,2,3,8,10,26,-16,7,19,9
24863,23073,23079,28,9,13,4,5,4,14,20,-6,13,13,17
24864,23073,23079,55,11,13,3,5,5,14,24,-10,11,15,14
24865,23073,23079,25,15,13,2,4,7,15,23,-8,8,18,10
24866,23073,23079,1,7,13,5,4,4,26,15,11,14,12,19
24867,23073,23079,43,2,13,8,3,2,26,14,12,19,7,27
24868,23073,23079,57,4,13,7,0,6,16,14,2,14,12,21
24869,23073,23079,22,5,13,5,6,2,25,13,12,16,10,21
24870,23073,23079,24,14,13,3,3,7,12,19,-7,9,17,12
24871,23122,23128,43,2,19,11,6,2,37,21,16,28,10,39
24872,23122,23128,57,6,19,10,1,8,25,20,5,21,17,31
24873,23122,23128,22,7,19,8,7,4,38,20,18,23,15,31
24874,23122,23128,24,9,19,6,4,9,19,22,-3,16,22,22
24875,23122,23128,1,4,19,9,6,4,37,16,21,24,14,33
24876,23122,23128,55,11,19,5,6,8,22,37,-15,16,22,21
24877,23122,23128,25,12,19,4,6,9,27,35,-8,14,24,18
24878,23122,23128,28,8,19,6,8,5,22,28,-6,20,18,26
24879,23122,23128,56,16,19,2,4,13,12,42,-30,8,30,10
24880,23122,23128,39,1,19,15,2,2,43,19,24,32,6,47
24881,23122,23128,27,13,19,4,6,9,18,29,-11,14,24,18
24882,23122,23128,15,14,19,4,3,12,21,40,-19,11,27,15
24883,23122,23128,4,3,19,9,8,2,34,20,14,26,12,35
24884,23122,23128,21,5,19,8,8,3,37,17,20,24,14,32
24885,23122,23128,49,10,19,5,7,7,18,28,-10,17,21,22
24886,23122,23128,16,15,19,3,4,12,22,38,-16,10,28,13
24887,14491,14497,37,14,33,9,8,16,50,65,-15,26,40,35
24888,14491,14497,35,8,33,15,7,11,52,44,8,37,29,52
24889,14491,14497,6,18,33,4,12,17,31,65,-34,20,46,24
24890,14491,14497,1,2,33,20,4,9,68,32,36,44,22,64
24891,14491,14497,47,15,33,9,5,19,53,71,-18,23,43,32
24892,14491,14497,33,5,33,16,8,9,66,44,22,40,26,56
24893,14491,14497,28,12,33,10,7,16,40,61,-21,27,39,37
24894,14498,14588,33,4,34,16,9,9,67,45,22,41,27,57
24895,14498,14588,28,13,34,10,7,17,41,65,-24,27,41,37
24896,14498,14588,47,14,34,10,5,19,56,72,-16,25,43,35
24897,14498,14588,1,2,34,21,4,9,70,32,38,46,22,67
24898,14498,14588,35,7,34,16,7,11,56,45,11,39,29,55
24899,14498,14588,6,18,34,5,12,17,35,66,-31,22,46,27
24900,14498,14588,49,5,34,18,2,14,66,52,14,38,30,56
24901,14498,14588,37,15,34,9,8,17,51,69,-18,26,42,35
24902,14498,14588,27,16,34,7,10,17,42,62,-20,24,44,31
24903,14498,14588,17,9,34,15,7,12,65,47,18,37,31,52
24904,14498,14588,25,6,34,16,8,10,73,66,7,40,28,56
24905,14498,14588,12,10,34,12,11,11,56,58,-2,35,33,47
24906,14498,14588,58,17,34,5,13,16,32,60,-28,23,45,28
24907,14498,14588,43,1,34,22,9,3,86,36,50,53,15,75
24908,14498,14588,22,8,34,16,6,12,63,59,4,38,30,54
24909,14498,14588,24,11,34,12,5,17,47,77,-30,29,39,41
24910,14498,14588,34,12,34,11,4,19,53,72,-19,26,42,37
24911,14498,14588,4,3,34,20,3,11,78,54,24,43,25,63
24912,14274,14287,43,1,8,6,2,0,23,12,11,14,2,20
24913,14274,14287,34,7,8,4,1,3,16,12,4,9,7,13
24914,14274,14287,22,9,8,3,4,1,22,14,8,10,6,13
24915,14274,14287,24,10,8,4,0,4,11,19,-8,8,8,12
24916,14274,14287,49,11,8,3,1,4,10,14,-4,7,9,10
24917,14274,14287,37,18,8,1,1,6,12,23,-11,3,13,4
24918,14274,14287,25,6,8,4,2,2,16,16,0,10,6,14
24919,14274,14287,12,13,8,1,3,4,9,14,-5,5,11,6
24920,14274,14287,58,17,8,0,5,3,4,12,-8,5,11,5
24921,14274,14287,17,2,8,6,1,1,20,10,10,13,3,19
24922,14274,14287,35,5,8,4,2,2,17,13,4,10,6,14
24923,14274,14287,6,15,8,1,3,4,12,20,-8,5,11,6
24924,14274,14287,33,12,8,2,2,4,14,17,-3,6,10,8
24925,14274,14287,28,16,8,1,2,5,9,19,-10,4,12,5
24926,14274,14287,1,3,8,5,1,2,20,6,14,11,5,16
24927,14274,14287,47,13,8,1,3,4,9,14,-5,5,11,6
24928,14274,14287,27,8,8,4,1,3,13,11,2,9,7,13
24929,14274,14287,4,4,8,5,0,3,24,15,9,10,6,15
24930,14589,14595,33,2,1,1,0,0,3,0,3,2,0,3
24931,14589,14595,28,7,1,0,1,0,0,0,0,1,1,1
24932,14589,14595,47,13,1,0,0,1,3,4,-1,0,2,0
24933,14589,14595,1,1,1,1,0,0,6,2,4,2,0,3
24934,14589,14595,35,17,1,0,0,1,0,3,-3,0,2,0
24935,14589,14595,17,3,1,1,0,0,3,1,2,2,0,3
24936,14589,14595,27,5,1,1,0,0,2,1,1,2,0,3
24937,14589,14595,49,4,1,1,0,0,4,3,1,2,0,3
24938,14589,14595,37,14,1,0,0,1,1,2,-1,0,2,0
24939,14589,14595,25,5,1,1,0,0,2,1,1,2,0,3
24940,14589,14595,12,7,1,0,1,0,0,0,0,1,1,1
24941,14589,14595,21,14,1,0,0,1,1,2,-1,0,2,0
24942,14589,14595,4,18,1,0,0,1,2,6,-4,0,2,0
24943,14589,14595,34,16,1,0,0,1,1,3,-2,0,2,0
24944,14589,14595,24,7,1,0,1,0,0,0,0,1,1,1
24945,14589,14595,43,7,1,0,1,0,0,0,0,1,1,1
24946,14589,14595,40,7,1,0,1,0,0,0,0,1,1,1
24947,14589,14595,22,7,1,0,1,0,0,0,0,1,1,1
24948,14680,14686,43,2,12,9,3,0,39,14,25,21,3,30
24949,14680,14686,22,12,12,3,5,4,15,14,1,11,13,14
24950,14680,14686,49,3,12,8,2,2,34,14,20,18,6,26
24951,14680,14686,37,11,12,4,2,6,11,26,-15,10,14,14
24952,14680,14686,34,14,12,3,1,8,15,32,-17,7,17,10
24953,14680,14686,40,17,12,1,4,7,11,25,-14,6,18,7
24954,14680,14686,24,18,12,1,2,9,14,28,-14,4,20,5
24955,14680,14686,4,6,12,6,2,4,28,22,6,14,10,20
24956,14680,14686,21,13,12,4,1,7,12,19,-7,9,15,13
24957,14680,14686,27,4,12,8,0,4,22,21,1,16,8,24
24958,14680,14686,17,8,12,6,1,5,22,20,2,13,11,19
24959,14680,14686,25,7,12,6,2,4,20,20,0,14,10,20
24960,14680,14686,12,9,12,4,4,4,14,20,-6,12,12,16
24961,14680,14686,35,10,12,5,0,7,19,21,-2,10,14,15
24962,14680,14686,1,1,12,12,0,0,47,8,39,24,0,36
24963,14680,14686,33,5,12,7,1,4,28,13,15,15,9,22
24964,14680,14686,28,15,12,2,3,7,11,24,-13,7,17,9
24965,14680,14686,47,16,12,2,1,9,16,37,-21,5,19,7
24966,14701,14707,47,17,15,2,1,12,19,49,-30,5,25,7
24967,7330,7336,17,5,6,3,2,1,14,8,6,8,4,11
24968,7330,7336,19,12,6,2,1,3,9,11,-2,5,7,7
24969,7834,7840,17,6,23,11,5,7,31,32,-1,27,19,38
24970,7834,7840,19,10,23,8,6,9,30,37,-7,22,24,30
24971,7834,7840,8,14,23,6,6,11,21,33,-12,18,28,24
24972,7834,7840,3,16,23,5,7,11,25,42,-17,17,29,22
24973,7834,7840,4,2,23,11,9,3,30,15,15,31,15,42
24974,7834,7840,21,5,23,11,5,7,30,18,12,27,19,38
24975,7834,7840,49,3,23,11,9,3,34,20,14,31,15,42
24976,7834,7840,37,8,23,9,9,5,26,18,8,27,19,36
24977,7834,7840,12,7,23,10,7,6,38,26,12,27,19,37
24978,7834,7840,56,4,23,11,6,6,29,25,4,28,18,39
24979,7834,7840,20,11,23,7,8,8,24,22,2,22,24,29
24980,7834,7840,41,12,23,7,5,11,28,32,-4,19,27,26
24981,7834,7840,52,9,23,9,4,10,30,29,1,22,24,31
24982,7834,7840,43,1,23,13,6,4,39,22,17,32,14,45
24983,7834,7840,22,13,23,6,7,10,17,29,-12,19,27,25
24984,7834,7840,57,15,23,5,7,11,35,44,-9,17,29,22
24985,7834,7840,24,18,23,4,4,15,21,37,-16,12,34,16
24986,7834,7840,1,17,23,5,6,12,30,37,-7,16,30,21
24987,7876,7882,1,16,28,6,8,14,35,44,-9,20,36,26
24988,7876,7882,12,4,28,13,8,7,46,29,17,34,22,47
24989,7876,7882,52,9,28,11,4,13,36,35,1,26,30,37
24990,7876,7882,3,15,28,7,8,13,29,50,-21,22,34,29
24991,7876,7882,17,6,28,13,6,9,41,42,-1,32,24,45
24992,7876,7882,19,11,28,9,7,12,35,45,-10,25,31,34
24993,7876,7882,8,17,28,6,7,15,24,45,-21,19,37,25
24994,7876,7882,56,7,28,12,8,8,36,30,6,32,24,44
24995,7876,7882,20,10,28,9,9,10,28,26,2,27,29,36
24996,7876,7882,41,13,28,9,6,13,33,40,-7,24,32,33
24997,7876,7882,49,2,28,15,10,3,46,23,23,40,16,55
24998,7876,7882,37,8,28,11,9,8,33,24,9,31,25,42
24999,7876,7882,21,3,28,14,7,7,37,19,18,35,21,49
25000,7876,7882,4,5,28,12,11,5,33,19,14,35,21,47
25001,7876,7882,43,1,28,16,7,5,48,26,22,39,17,55
25002,7876,7882,22,12,28,9,7,12,23,34,-11,25,31,34
25003,7876,7882,57,14,28,8,8,12,42,49,-7,24,32,32
25004,7876,7882,24,18,28,5,4,19,24,49,-25,14,42,19
25005,7890,7896,43,1,30,17,7,6,51,27,24,41,19,58
25006,7890,7896,57,12,30,9,8,13,51,51,0,26,34,35
25007,7890,7896,22,14,30,9,8,13,23,42,-19,26,34,35
25008,7890,7896,24,18,30,6,4,20,26,56,-30,16,44,22
25009,7890,7896,21,3,30,15,8,7,39,20,19,38,22,53
25010,7890,7896,4,5,30,13,12,5,34,19,15,38,22,51
25011,7890,7896,49,2,30,16,10,4,54,26,28,42,18,58
25012,7890,7896,37,8,30,12,9,9,36,27,9,33,27,45
25013,7890,7896,56,6,30,13,8,9,38,32,6,34,26,47
25014,7890,7896,20,11,30,9,9,12,28,30,-2,27,33,36
25015,7890,7896,41,15,30,9,7,14,34,45,-11,25,35,34
25016,7890,7896,17,7,30,13,7,10,43,45,-2,33,27,46
25017,7890,7896,19,10,30,10,7,13,37,47,-10,27,33,37
25018,7890,7896,8,16,30,8,7,15,27,46,-19,23,37,31
25019,7890,7896,52,9,30,11,4,15,37,40,-3,26,34,37
25020,7890,7896,3,13,30,9,8,13,33,50,-17,26,34,35
25021,7890,7896,12,4,30,14,9,7,50,29,21,37,23,51
25022,7890,7896,1,17,30,7,8,15,36,45,-9,22,38,29
25023,7904,7910,1,15,32,9,8,15,41,45,-4,26,38,35
25024,7904,7910,12,4,32,15,10,7,53,31,22,40,24,55
25025,7904,7910,52,9,32,11,6,15,40,43,-3,28,36,39
25026,7904,7910,3,13,32,10,8,14,35,52,-17,28,36,38
25027,7904,7910,17,8,32,13,8,11,45,48,-3,34,30,47
25028,7904,7910,19,12,32,10,8,14,40,52,-12,28,36,38
25029,7904,7910,8,17,32,9,8,15,31,47,-16,26,38,35
25030,7904,7910,49,2,32,17,10,5,55,27,28,44,20,61
25031,7904,7910,37,7,32,13,9,10,40,29,11,35,29,48
25032,7904,7910,56,6,32,13,10,9,38,32,6,36,28,49
25033,7904,7910,20,10,32,10,9,13,30,32,-2,29,35,39
25034,7904,7910,41,16,32,9,8,15,35,49,-14,26,38,35
25035,7904,7910,21,3,32,16,8,8,43,22,21,40,24,56
25036,7904,7910,4,5,32,14,13,5,35,19,16,41,23,55
25037,7904,7910,43,1,32,18,7,7,53,30,23,43,21,61
25038,7904,7910,57,11,32,10,8,14,56,57,-1,28,36,38
25039,7904,7910,22,14,32,9,9,14,23,46,-23,27,37,36
25040,7904,7910,24,18,32,6,5,21,27,59,-32,17,47,23
25041,8086,8099,43,2,11,6,2,3,23,13,10,14,8,20
25042,8086,8099,21,4,11,6,2,3,15,12,3,14,8,20
25043,8086,8099,4,8,11,4,5,2,16,12,4,13,9,17
25044,8086,8099,19,6,11,5,4,2,14,10,4,14,8,19
25045,9871,9877,22,14,6,2,0,4,7,16,-9,4,8,6
25046,9871,9877,57,15,6,1,3,2,8,8,0,5,7,6
25047,9871,9877,27,16,6,1,2,3,7,9,-2,4,8,5
25048,9871,9877,20,2,6,4,1,1,15,5,10,9,3,13
25049,9871,9877,41,6,6,2,3,1,11,8,3,7,5,9
25050,9871,9877,56,17,6,0,3,3,7,14,-7,3,9,3
25051,9871,9877,52,9,6,2,2,2,8,9,-1,6,6,8
25052,9871,9877,28,10,6,2,2,2,6,8,-2,6,6,8
25053,9871,9877,12,7,6,2,3,1,8,7,1,7,5,9
25054,9871,9877,53,13,6,2,1,3,4,9,-5,5,7,7
25055,9871,9877,49,8,6,2,2,2,9,8,1,6,6,8
25056,9871,9877,37,11,6,2,1,3,10,9,1,5,7,7
25057,9871,9877,1,5,6,3,2,1,10,7,3,8,4,11
25058,10830,10836,1,1,32,24,6,2,73,19,54,54,10,78
25059,10830,10836,21,5,32,14,12,6,60,32,28,40,24,54
25060,10830,10836,4,6,32,11,12,9,41,36,5,34,30,45
25061,10830,10836,28,15,32,7,11,14,23,42,-19,25,39,32
25062,10830,10836,54,18,32,5,10,17,28,59,-31,20,44,25
25063,10830,10836,27,12,32,9,9,14,41,50,-9,27,37,36
25064,10830,10836,53,10,32,10,9,13,33,47,-14,29,35,39
25065,10830,10836,12,13,32,9,9,14,33,61,-28,27,37,36
25066,10830,10836,43,2,32,23,4,5,71,18,53,50,14,73
25067,10830,10836,24,3,32,17,12,3,61,14,47,46,18,63
25068,10830,10836,57,8,32,11,7,14,43,45,-2,29,35,40
25069,10830,10836,17,9,32,11,6,15,41,61,-20,28,36,39
25070,10830,10836,49,4,32,15,10,7,51,28,23,40,24,55
25071,10830,10836,37,17,32,7,7,18,29,56,-27,21,43,28
25072,10830,10836,56,7,32,12,7,13,38,45,-7,31,33,43
25073,10830,10836,35,11,32,10,7,15,38,49,-11,27,37,37
25074,10830,10836,41,14,32,7,12,13,29,41,-12,26,38,33
25075,10830,10836,20,16,32,7,8,17,32,62,-30,22,42,29
25076,10942,10948,56,4,1,1,0,0,4,1,3,2,0,3
25077,10942,10948,35,5,1,1,0,0,3,0,3,2,0,3
25078,10942,10948,41,11,1,0,0,1,0,1,-1,0,2,0
25079,10942,10948,20,11,1,0,0,1,0,1,-1,0,2,0
25080,10942,10948,17,17,1,0,0,1,0,4,-4,0,2,0
25081,10942,10948,24,2,1,1,0,0,4,0,4,2,0,3
25082,10942,10948,22,7,1,1,0,0,1,0,1,2,0,3
25083,10942,10948,57,9,1,0,1,0,0,0,0,1,1,1
25084,10942,10948,43,9,1,0,1,0,0,0,0,1,1,1
25085,10942,10948,12,16,1,0,0,1,0,3,-3,0,2,0
25086,10942,10948,53,18,1,0,0,1,1,7,-6,0,2,0
25087,10942,10948,27,7,1,1,0,0,1,0,1,2,0,3
25088,10942,10948,52,13,1,0,0,1,0,2,-2,0,2,0
25089,10942,10948,28,14,1,0,0,1,3,6,-3,0,2,0
25090,10942,10948,4,3,1,1,0,0,6,3,3,2,0,3
25091,10942,10948,21,15,1,0,0,1,1,4,-3,0,2,0
25092,10942,10948,49,1,1,1,0,0,7,1,6,2,0,3
25093,10942,10948,1,6,1,1,0,0,2,0,2,2,0,3
25094,11026,11028,1,3,12,7,4,1,18,11,7,18,6,25
25095,11026,11028,49,2,12,7,4,1,23,13,10,18,6,25
25096,11026,11028,4,1,12,8,4,0,27,11,16,20,4,28
25097,11026,11028,21,7,12,4,5,3,19,15,4,13,11,17
25098,11026,11028,35,8,12,4,4,4,19,18,1,12,12,16
25099,11026,11028,41,9,12,4,3,5,15,14,1,11,13,15
25100,11026,11028,20,13,12,3,3,6,12,20,-8,9,15,12
25101,11026,11028,56,15,12,3,1,8,14,26,-12,7,17,10
25102,11026,11028,43,4,12,7,3,2,33,10,23,17,7,24
25103,11026,11028,24,5,12,6,4,2,24,13,11,16,8,22
25104,11026,11028,57,10,12,4,2,6,16,20,-4,10,14,14
25105,11026,11028,22,18,12,2,3,7,8,27,-19,7,17,9
25106,11026,11028,52,12,12,3,3,6,14,19,-5,9,15,12
25107,11026,11028,28,17,12,2,4,6,10,21,-11,8,16,10
25108,11026,11028,27,11,12,3,5,4,14,13,1,11,13,14
25109,11026,11028,17,16,12,2,4,6,7,16,-9,8,16,10
25110,11026,11028,12,6,12,5,3,4,16,12,4,13,11,18
25111,11026,11028,53,14,12,3,3,6,19,29,-10,9,15,12
25112,11047,11053,12,6,16,7,4,5,22,16,6,18,14,25
25113,11047,11053,53,14,16,4,3,9,22,36,-14,11,21,15
25114,11047,11053,17,15,16,3,6,7,10,20,-10,12,20,15
25115,11047,11053,27,10,16,4,7,5,18,18,0,15,17,19
25116,11047,11053,52,17,16,3,3,10,16,30,-14,9,23,12
25117,11047,11053,28,18,16,2,5,9,12,27,-15,9,23,11
25118,11047,11053,35,7,16,6,5,5,25,23,2,17,15,23
25119,11047,11053,41,11,16,4,6,6,19,20,-1,14,18,18
25120,11047,11053,20,12,16,4,4,8,15,26,-11,12,20,16
25121,11047,11053,56,16,16,4,2,10,18,30,-12,10,22,14
25122,11047,11053,49,5,16,7,7,2,25,17,8,21,11,28
25123,11047,11053,43,2,16,10,4,2,41,11,30,24,8,34
25124,11047,11053,24,4,16,8,5,3,30,17,13,21,11,29
25125,12419,12425,37,13,3,1,0,2,2,5,-3,2,4,3
25126,12419,12425,27,15,3,0,2,1,2,3,-1,2,4,2
25127,12419,12425,21,3,3,2,0,1,6,3,3,4,2,6
25128,12419,12425,9,11,3,1,0,2,4,7,-3,2,4,3
25129,12419,12425,4,12,3,1,0,2,3,6,-3,2,4,3
25130,12426,12432,21,4,4,2,1,1,9,6,3,5,3,7
25131,12426,12432,4,14,4,1,1,2,6,9,-3,3,5,4
25132,12426,12432,9,15,4,1,0,3,5,11,-6,2,6,3
25133,12426,12432,27,16,4,0,2,2,2,6,-4,2,6,2
25134,12426,12432,49,1,4,4,0,0,10,1,9,8,0,12
25135,12426,12432,37,9,4,2,0,2,4,5,-1,4,4,6
25136,12426,12432,43,6,4,2,1,1,9,7,2,5,3,7
25137,12426,12432,34,7,4,2,1,1,7,6,1,5,3,7
25138,12426,12432,24,8,4,2,0,2,6,6,0,4,4,6
25139,12426,12432,57,10,4,2,0,2,4,7,-3,4,4,6
25140,12426,12432,13,5,4,2,1,1,7,4,3,5,3,7
25141,12426,12432,35,11,4,1,2,1,8,6,2,4,4,5
25142,12426,12432,41,17,4,0,2,2,3,10,-7,2,6,2
25143,12426,12432,6,18,4,0,1,3,4,8,-4,1,7,1
25144,12426,12432,28,12,4,1,2,1,5,5,0,4,4,5
25145,12426,12432,52,13,4,1,1,2,6,8,-2,3,5,4
25146,12426,12432,1,3,4,2,1,1,9,5,4,5,3,7
25147,12426,12432,17,2,4,3,0,1,13,7,6,6,2,9
25148,12461,12467,17,3,8,5,0,3,21,14,7,10,6,15
25149,12461,12467,13,6,8,4,2,2,16,10,6,10,6,14
25150,12461,12467,35,12,8,2,3,3,15,13,2,7,9,9
25151,12461,12467,6,15,8,2,1,5,8,15,-7,5,11,7
25152,12461,12467,41,18,8,0,4,4,10,20,-10,4,12,4
25153,12461,12467,1,5,8,4,2,2,19,10,9,10,6,14
25154,12461,12467,43,2,8,5,2,1,20,12,8,12,4,17
25155,12461,12467,24,4,8,5,0,3,12,9,3,10,6,15
25156,12461,12467,34,10,8,3,1,4,14,20,-6,7,9,10
25157,12461,12467,57,17,8,2,1,5,5,13,-8,5,11,7
25158,12461,12467,52,11,8,2,4,2,11,12,-1,8,8,10
25159,12461,12467,28,14,8,2,2,4,7,12,-5,6,10,8
25160,12461,12467,27,13,8,2,3,3,7,9,-2,7,9,9
25161,12461,12467,49,1,8,6,2,0,16,3,13,14,2,20
25162,12461,12467,37,7,8,4,0,4,14,14,0,8,8,12
25163,12461,12467,21,8,8,3,2,3,13,12,1,8,8,11
25164,12461,12467,4,9,8,3,2,3,11,13,-2,8,8,11
25165,12461,12467,9,16,8,2,1,5,8,16,-8,5,11,7
25166,12755,12761,4,9,1,0,1,0,2,2,0,1,1,1
25167,12755,12761,21,11,1,0,0,1,2,3,-1,0,2,0
25168,12755,12761,49,6,1,1,0,0,1,0,1,2,0,3
25169,12755,12761,37,13,1,0,0,1,0,1,-1,0,2,0
25170,12755,12761,34,3,1,1,0,0,3,1,2,2,0,3
25171,12755,12761,57,4,1,1,0,0,3,2,1,2,0,3
25172,12755,12761,24,16,1,0,0,1,2,4,-2,0,2,0
25173,12755,12761,43,17,1,0,0,1,1,3,-2,0,2,0
25174,12755,12761,20,9,1,0,1,0,2,2,0,1,1,1
25175,12755,12761,35,12,1,0,0,1,1,2,-1,0,2,0
25176,12755,12761,6,13,1,0,0,1,0,1,-1,0,2,0
25177,12755,12761,13,18,1,0,0,1,1,4,-3,0,2,0
25178,12755,12761,28,1,1,1,0,0,4,1,3,2,0,3
25179,12755,12761,52,6,1,1,0,0,1,0,1,2,0,3
25180,12755,12761,1,5,1,1,0,0,2,1,1,2,0,3
25181,12755,12761,27,2,1,1,0,0,4,2,2,2,0,3
25182,12755,12761,17,13,1,0,0,1,0,1,-1,0,2,0
25183,12755,12761,47,6,1,1,0,0,1,0,1,2,0,3
25184,12832,12838,47,5,13,7,2,4,19,14,5,16,10,23
25185,12832,12838,17,2,13,8,3,2,24,13,11,19,7,27
25186,12832,12838,27,7,13,5,5,3,26,25,1,15,11,20
25187,12832,12838,1,1,13,8,3,2,29,11,18,19,7,27
25188,12832,12838,52,4,13,6,6,1,14,10,4,18,8,24
25189,12832,12838,28,15,13,3,3,7,14,25,-11,9,17,12
25190,12832,12838,35,10,13,4,5,4,22,16,6,13,13,17
25191,12832,12838,13,14,13,3,3,7,15,23,-8,9,17,12
25192,12832,12838,6,17,13,2,3,8,13,23,-10,7,19,9
25193,12832,12838,20,18,13,2,3,8,13,27,-14,7,19,9
25194,12832,12838,43,3,13,7,3,3,26,14,12,17,9,24
25195,12832,12838,34,8,13,5,4,4,20,18,2,14,12,19
25196,12832,12838,24,9,13,5,4,4,18,22,-4,14,12,19
25197,12832,12838,57,12,13,2,9,2,16,19,-3,13,13,15
25198,12832,12838,49,6,13,5,6,2,19,11,8,16,10,21
25199,12832,12838,37,11,13,4,3,6,15,16,-1,11,15,15
25200,12832,12838,21,13,13,3,3,7,16,22,-6,9,17,12
25201,12832,12838,4,16,13,2,4,7,14,24,-10,8,18,10
25202,12979,12992,21,11,28,10,7,11,33,36,-3,27,29,37
25203,12979,12992,4,15,28,8,9,11,32,42,-10,25,31,33
25204,12979,12992,49,6,28,10,11,7,41,33,8,31,25,41
25205,12979,12992,37,17,28,5,7,16,28,45,-17,17,39,22
25206,12979,12992,27,9,28,9,11,8,47,45,2,29,27,38
25207,12230,12236,37,12,25,6,9,10,29,33,-4,21,29,27
25208,12230,12236,21,5,25,11,9,5,38,30,8,31,19,42
25209,12230,12236,9,8,25,7,12,6,35,33,2,26,24,33
25210,12230,12236,4,11,25,6,10,9,36,41,-5,22,28,28
25211,12230,12236,52,16,25,6,7,12,24,34,-10,19,31,25
25212,12230,12236,43,1,25,17,5,3,58,26,32,39,11,56
25213,12230,12236,24,9,25,7,12,6,29,27,2,26,24,33
25214,12230,12236,57,13,25,6,9,10,37,49,-12,21,29,27
25215,12230,12236,22,18,25,2,7,16,29,61,-32,11,39,13
25216,12230,12236,1,2,25,14,10,1,35,15,20,38,12,52
25217,12230,12236,27,3,25,14,4,7,47,33,14,32,18,46
25218,12230,12236,13,4,25,12,9,4,42,22,20,33,17,45
25219,12230,12236,6,7,25,8,9,8,32,30,2,25,25,33
25220,12230,12236,35,10,25,7,8,10,32,35,-3,22,28,29
25221,12230,12236,41,14,25,6,9,10,27,42,-15,21,29,27
25222,12230,12236,20,17,25,4,6,15,23,47,-24,14,36,18
25223,12230,12236,17,15,25,5,11,9,24,32,-8,21,29,26
25224,12286,12292,17,15,31,6,13,12,26,38,-12,25,37,31
25225,12286,12292,13,3,31,14,12,5,48,24,24,40,22,54
25226,12286,12292,35,8,31,10,9,12,44,45,-1,29,33,39
25227,12286,12292,6,11,31,9,10,12,36,44,-8,28,34,37
25228,12286,12292,41,13,31,8,11,12,36,51,-15,27,35,35
25229,12286,12292,20,18,31,4,7,20,27,59,-32,15,47,19
25230,12286,12292,1,2,31,18,12,1,45,16,29,48,14,66
25231,12286,12292,43,1,31,21,7,3,73,30,43,49,13,70
25232,12286,12292,24,9,31,8,14,9,34,38,-4,30,32,38
25233,12286,12292,57,12,31,8,11,12,47,58,-11,27,35,35
25234,12286,12292,22,17,31,4,9,18,34,71,-37,17,45,21
25235,12286,12292,52,14,31,7,11,13,30,40,-10,25,37,32
25236,12286,12292,49,6,31,12,11,8,40,19,21,35,27,47
25237,12286,12292,37,10,31,9,10,12,37,38,-1,28,34,37
25238,12286,12292,27,4,31,16,5,10,55,45,10,37,25,53
25239,12286,12292,21,5,31,14,11,6,44,33,11,39,23,53
25240,12286,12292,9,7,31,10,15,6,43,35,8,35,27,45
25241,12286,12292,4,16,31,6,12,13,37,52,-15,24,38,30
25242,12293,12299,21,5,32,14,12,6,44,33,11,40,24,54
25243,12293,12299,9,7,32,10,15,7,43,37,6,35,29,45
25244,12293,12299,4,15,32,7,12,13,40,53,-13,26,38,33
25245,12293,12299,27,3,32,17,5,10,57,46,11,39,25,56
25246,12293,12299,49,6,32,12,12,8,40,19,21,36,28,48
25247,12293,12299,37,10,32,10,10,12,40,39,1,30,34,40
25248,12293,12299,52,16,32,7,11,14,31,43,-12,25,39,32
25249,12293,12299,43,1,32,22,7,3,75,30,45,51,13,73
25250,12293,12299,24,9,32,9,14,9,37,39,-2,32,32,41
25251,12293,12299,57,12,32,8,11,13,49,61,-12,27,37,35
25252,12293,12299,22,17,32,4,9,19,35,74,-39,17,47,21
25253,12293,12299,1,2,32,18,13,1,45,16,29,49,15,67
25254,12293,12299,13,4,32,14,13,5,48,24,24,41,23,55
25255,12293,12299,35,8,32,11,9,12,48,46,2,31,33,42
25256,12293,12299,6,11,32,9,10,13,37,47,-10,28,36,37
25257,12293,12299,41,13,32,8,11,13,37,55,-18,27,37,35
25258,12293,12299,20,18,32,4,7,21,28,61,-33,15,49,19
25259,12293,12299,17,14,32,7,13,12,29,40,-11,27,37,34
25260,12524,12544,17,4,16,9,2,5,31,24,7,20,12,29
25261,12524,12544,13,7,16,6,6,4,25,18,7,18,14,24
25262,12524,12544,35,9,16,5,6,5,29,21,8,16,16,21
25263,12524,12544,6,10,16,5,4,7,18,21,-3,14,18,19
25264,12524,12544,41,18,16,1,6,9,17,32,-15,8,24,9
25265,12524,12544,27,16,16,3,7,6,11,21,-10,13,19,16
25266,12524,12544,1,3,16,9,4,3,35,17,18,22,10,31
25267,12524,12544,43,1,16,11,3,2,36,16,20,25,7,36
25268,12524,12544,21,8,16,6,4,6,28,24,4,16,16,22
25269,12524,12544,4,14,16,5,3,8,23,29,-6,13,19,18
25270,12524,12544,9,17,16,3,2,11,16,40,-24,8,24,11
25271,12524,12544,49,2,16,10,4,2,27,13,14,24,8,34
25272,12524,12544,37,12,16,5,4,7,19,27,-8,14,18,19
25273,12524,12544,52,13,16,4,7,5,16,19,-3,15,17,19
25274,12524,12544,28,15,16,3,7,6,14,23,-9,13,19,16
25275,12524,12544,34,5,16,7,4,5,33,30,3,18,14,25
25276,12524,12544,24,6,16,7,3,6,20,20,0,17,15,24
25277,12524,12544,57,10,16,5,4,7,18,21,-3,14,18,19
25278,12573,12579,49,3,21,13,5,3,34,17,17,31,11,44
25279,12573,12579,37,13,21,6,7,8,25,31,-6,19,23,25
25280,12573,12579,21,12,21,7,4,10,32,33,-1,18,24,25
25281,12573,12579,4,15,21,7,3,11,28,41,-13,17,25,24
25282,12573,12579,9,17,21,3,5,13,21,51,-30,11,31,14
25283,12573,12579,43,1,21,15,4,2,55,22,33,34,8,49
25284,12573,12579,34,4,21,9,5,7,44,42,2,23,19,32
25285,14701,14707,25,6,15,8,3,4,27,22,5,19,11,27
25286,14701,14707,12,11,15,4,6,5,16,23,-7,14,16,18
25287,14701,14707,33,4,15,9,1,5,34,18,16,19,11,28
25288,14701,14707,28,14,15,3,4,8,16,26,-10,10,20,13
25289,14701,14707,1,1,15,14,0,1,53,10,43,28,2,42
25290,14701,14707,35,9,15,6,1,8,22,24,-2,13,17,19
25291,14701,14707,49,3,15,9,3,3,38,18,20,21,9,30
25292,14701,14707,37,12,15,4,5,6,13,28,-15,13,17,17
25293,14701,14707,17,8,15,7,3,5,26,22,4,17,13,24
25294,14701,14707,27,7,15,8,1,6,25,29,-4,17,13,25
25295,14701,14707,4,5,15,8,3,4,32,24,8,19,11,27
25296,14701,14707,21,13,15,5,1,9,16,24,-8,11,19,16
25297,14701,14707,43,2,15,12,3,0,44,14,30,27,3,39
25298,14701,14707,22,10,15,4,6,5,17,16,1,14,16,18
25299,14701,14707,34,15,15,3,4,8,17,34,-17,10,20,13
25300,14701,14707,24,16,15,2,3,10,20,35,-15,7,23,9
25301,14701,14707,40,18,15,1,4,10,11,30,-19,6,24,7
25302,14792,14798,43,1,24,19,5,0,68,19,49,43,5,62
25303,14792,14798,22,12,24,7,7,10,29,35,-6,21,27,28
25304,14792,14798,34,14,24,5,5,14,23,52,-29,15,33,20
25305,14792,14798,40,17,24,2,8,14,18,44,-26,12,36,14
25306,14792,14798,24,18,24,2,6,16,28,57,-29,10,38,12
25307,14792,14798,27,8,24,11,4,9,39,42,-3,26,22,37
25308,14792,14798,17,10,24,10,6,8,35,29,6,26,22,36
25309,14792,14798,37,11,24,8,7,9,22,43,-21,23,25,31
25310,14792,14798,1,2,24,17,6,1,65,18,47,40,8,57
25311,14792,14798,33,7,24,11,5,8,45,31,14,27,21,38
25312,14792,14798,28,16,24,4,5,15,23,42,-19,13,35,17
25313,14792,14798,35,6,24,12,3,9,46,35,11,27,21,39
25314,14792,14798,25,5,24,12,5,7,44,35,9,29,19,41
25315,14792,14798,12,9,24,10,7,7,36,32,4,27,21,37
25316,14792,14798,49,3,24,12,8,4,55,27,28,32,16,44
25317,14792,14798,4,4,24,12,7,5,46,34,12,31,17,43
25318,14792,14798,21,13,24,7,4,13,26,35,-9,18,30,25
25319,14792,14798,47,15,24,5,2,17,28,66,-38,12,36,17
25320,14855,14861,47,17,32,7,4,21,33,74,-41,18,46,25
25321,14855,14861,4,5,32,15,8,9,56,46,10,38,26,53
25322,14855,14861,33,8,32,14,7,11,59,47,12,35,29,49
25323,14855,14861,28,14,32,8,7,17,36,52,-16,23,41,31
25324,14855,14861,21,12,32,11,5,16,37,44,-7,27,37,38
25325,14855,14861,22,11,32,10,9,13,43,45,-2,29,35,39
25326,14855,14861,40,15,32,6,11,15,29,51,-22,23,41,29
25327,14855,14861,34,16,32,7,7,18,32,60,-28,21,43,28
25328,14855,14861,24,18,32,4,9,19,39,70,-31,17,47,21
25329,14855,14861,1,2,32,21,9,2,75,24,51,51,13,72
25330,14855,14861,49,3,32,16,11,5,70,38,32,43,21,59
25331,14855,14861,37,13,32,9,8,15,27,57,-30,26,38,35
25332,14855,14861,35,4,32,17,3,12,61,48,13,37,27,54
25333,14855,14861,17,10,32,12,6,14,43,48,-5,30,34,42
25334,14855,14861,27,9,32,13,5,14,49,58,-9,31,33,44
25335,14855,14861,43,1,32,23,8,1,82,24,58,54,10,77
25336,14855,14861,12,6,32,14,9,9,50,41,9,37,27,51
25337,14855,14861,25,7,32,14,8,10,57,51,6,36,28,50
25338,14652,14658,27,4,9,6,0,3,18,16,2,12,6,18
25339,14652,14658,17,8,9,5,1,3,18,12,6,11,7,16
25340,14652,14658,25,5,9,5,2,2,18,15,3,12,6,17
25341,14652,14658,12,9,9,3,4,2,12,11,1,10,8,13
25342,14652,14658,49,3,9,6,1,2,27,12,15,13,5,19
25343,14652,14658,37,13,9,2,2,5,6,17,-11,6,12,8
25344,14652,14658,33,6,9,5,1,3,21,10,11,11,7,16
25345,14652,14658,28,15,9,1,3,5,9,15,-6,5,13,6
25346,14652,14658,4,7,9,5,1,3,23,17,6,11,7,16
25347,14652,14658,21,12,9,3,0,6,8,15,-7,6,12,9
25348,14652,14658,35,10,9,4,0,5,15,16,-1,8,10,12
25349,14652,14658,40,16,9,1,3,5,6,18,-12,5,13,6
25350,14652,14658,34,17,9,1,1,7,6,25,-19,3,15,4
25351,14652,14658,24,18,9,0,2,7,10,25,-15,2,16,2
25352,14652,14658,43,2,9,7,2,0,28,12,16,16,2,23
25353,14652,14658,22,11,9,2,4,3,10,11,-1,8,10,10
25354,14652,14658,47,14,9,2,1,6,13,27,-14,5,13,7
25355,14652,14658,1,1,9,9,0,0,34,8,26,18,0,27
25356,15072,15078,1,1,15,11,1,3,36,17,19,23,7,34
25357,15072,15078,4,2,15,10,3,2,29,16,13,23,7,33
25358,15072,15078,21,13,15,4,3,8,22,27,-5,11,19,15
25359,15072,15078,37,18,15,1,5,9,13,36,-23,7,23,8
25360,15072,15078,22,3,15,9,5,1,44,21,23,23,7,32
25361,15072,15078,43,4,15,9,4,2,32,17,15,22,8,31
25362,15072,15078,34,14,15,4,3,8,14,33,-19,11,19,15
25363,15072,15078,40,17,15,2,4,9,17,34,-17,8,22,10
25364,12979,12992,43,2,28,18,4,6,71,30,41,40,16,58
25365,12979,12992,57,7,28,10,10,8,42,39,3,30,26,40
25366,12979,12992,24,12,28,10,6,12,31,39,-8,26,30,36
25367,12979,12992,34,14,28,8,9,11,40,43,-3,25,31,33
25368,12979,12992,35,5,28,11,8,9,41,32,9,30,26,41
25369,12979,12992,6,8,28,11,5,12,31,39,-8,27,29,38
25370,12979,12992,52,4,28,11,11,6,35,27,8,33,23,44
25371,12979,12992,28,13,28,9,6,13,34,48,-14,24,32,33
25372,12979,12992,1,1,28,21,5,2,69,23,46,47,9,68
25373,12979,12992,13,16,28,7,5,16,32,57,-25,19,37,26
25374,12979,12992,20,18,28,3,8,17,25,61,-36,14,42,17
25375,12979,12992,17,3,28,12,10,6,44,33,11,34,22,46
25376,12979,12992,47,10,28,11,4,13,32,36,-4,26,30,37
25377,12776,12782,47,5,5,3,1,1,10,5,5,7,3,10
25378,12776,12782,17,8,5,2,1,2,6,5,1,5,5,7
25379,12776,12782,1,2,5,4,1,0,14,3,11,9,1,13
25380,12776,12782,27,4,5,4,0,1,11,7,4,8,2,12
25381,12776,12782,52,6,5,3,1,1,5,4,1,7,3,10
25382,12776,12782,28,14,5,1,1,3,6,11,-5,3,7,4
25383,12776,12782,13,9,5,2,1,2,8,9,-1,5,5,7
25384,12776,12782,20,11,5,1,2,2,6,10,-4,4,6,5
25385,12776,12782,35,15,5,0,3,2,7,9,-2,3,7,3
25386,12776,12782,6,18,5,0,0,5,2,10,-8,0,10,0
25387,12776,12782,34,1,5,5,0,0,12,2,10,10,0,15
25388,12776,12782,49,3,5,4,1,0,13,2,11,9,1,13
25389,12776,12782,37,10,5,2,0,3,6,8,-2,4,6,6
25390,12776,12782,21,13,5,1,1,3,5,7,-2,3,7,4
25391,12776,12782,4,16,5,0,2,3,4,9,-5,2,8,2
25392,12776,12782,57,7,5,2,2,1,5,7,-2,6,4,8
25393,12776,12782,43,12,5,1,1,3,8,9,-1,3,7,4
25394,12776,12782,24,17,5,0,2,3,6,17,-11,2,8,2
25395,13119,13125,57,7,1,0,1,0,0,0,0,1,1,1
25396,13119,13125,24,7,1,0,1,0,0,0,0,1,1,1
25397,13119,13125,43,7,1,0,1,0,0,0,0,1,1,1
25398,13119,13125,34,7,1,0,1,0,0,0,0,1,1,1
25399,13119,13125,22,14,1,0,0,1,0,1,-1,0,2,0
25400,13119,13125,4,4,1,1,0,0,2,1,1,2,0,3
25401,13119,13125,21,18,1,0,0,1,0,3,-3,0,2,0
25402,13119,13125,49,2,1,1,0,0,2,0,2,2,0,3
25403,13119,13125,33,2,1,1,0,0,2,0,2,2,0,3
25404,13119,13125,52,7,1,0,1,0,0,0,0,1,1,1
25405,13119,13125,28,16,1,0,0,1,0,2,-2,0,2,0
25406,13119,13125,35,13,1,0,0,1,1,2,-1,0,2,0
25407,13119,13125,6,16,1,0,0,1,0,2,-2,0,2,0
25408,13119,13125,27,1,1,1,0,0,3,0,3,2,0,3
25409,13119,13125,1,5,1,1,0,0,1,0,1,2,0,3
25410,13119,13125,17,7,1,0,1,0,0,0,0,1,1,1
25411,13119,13125,12,5,1,1,0,0,1,0,1,2,0,3
25412,13119,13125,47,14,1,0,0,1,0,1,-1,0,2,0
25413,13294,13300,47,4,20,11,4,5,35,21,14,26,14,37
25414,13294,13300,12,12,20,6,6,8,30,33,-3,18,22,24
25415,13294,13300,17,2,20,10,8,2,33,19,14,28,12,38
25416,13294,13300,1,3,20,11,4,5,39,25,14,26,14,37
25417,13294,13300,27,13,20,6,4,10,25,30,-5,16,24,22
25418,13294,13300,6,8,20,8,6,6,30,32,-2,22,18,30
25419,13294,13300,35,16,20,4,5,11,22,34,-12,13,27,17
25420,13294,13300,33,1,20,12,6,2,37,17,20,30,10,42
25421,13294,13300,52,10,20,7,4,9,22,27,-5,18,22,25
25422,13294,13300,28,15,20,4,6,10,27,40,-13,14,26,18
25423,13294,13300,43,7,20,8,9,3,31,15,16,25,15,33
25424,13294,13300,22,9,20,6,8,6,24,25,-1,20,20,26
25425,13294,13300,24,14,20,4,8,8,20,29,-9,16,24,20
25426,13294,13300,34,17,20,3,8,9,25,37,-12,14,26,17
25427,13294,13300,57,18,20,2,5,13,22,44,-22,9,31,11
25428,13294,13300,21,5,20,11,2,7,34,30,4,24,16,35
25429,13294,13300,4,11,20,7,4,9,32,38,-6,18,22,25
25430,13294,13300,49,6,20,11,1,8,35,27,8,23,17,34
25431,13336,13342,49,8,26,13,2,11,44,39,5,28,24,41
25432,13336,13342,21,5,26,13,4,9,40,35,5,30,22,43
25433,13336,13342,4,13,26,8,5,13,35,46,-11,21,31,29
25434,13336,13342,43,4,26,12,9,5,43,26,17,33,19,45
25435,13336,13342,22,9,26,8,8,10,31,32,-1,24,28,32
25436,13336,13342,24,14,26,7,8,11,29,39,-10,22,30,29
25437,13336,13342,34,17,26,4,9,13,28,46,-18,17,35,21
25438,13336,13342,57,18,26,4,7,15,28,52,-24,15,37,19
25439,13336,13342,33,3,26,14,9,3,47,25,22,37,15,51
25440,13336,13342,52,11,26,8,6,12,27,33,-6,22,30,30
25441,13336,13342,28,12,26,8,6,12,36,45,-9,22,30,30
25442,13336,13342,6,7,26,12,6,8,38,38,0,30,22,42
25443,13336,13342,35,10,26,8,6,12,32,38,-6,22,30,30
25444,11047,11053,57,9,16,5,4,7,19,25,-6,14,18,19
25445,11047,11053,22,13,16,4,4,8,14,35,-21,12,20,16
25446,11047,11053,4,1,16,12,4,0,39,14,25,28,4,40
25447,11047,11053,21,8,16,5,8,3,29,21,8,18,14,23
25448,11047,11053,1,3,16,9,5,2,25,13,12,23,9,32
25449,11110,11116,1,3,22,12,8,2,40,16,24,32,12,44
25450,11110,11116,17,14,22,4,8,10,12,27,-15,16,28,20
25451,11110,11116,49,5,22,11,8,3,34,22,12,30,14,41
25452,11110,11116,4,1,22,15,6,1,50,21,29,36,8,51
25453,11110,11116,21,9,22,6,10,6,36,30,6,22,22,28
25454,11110,11116,27,11,22,5,11,6,21,20,1,21,23,26
25455,11110,11116,35,6,22,10,5,7,39,29,10,25,19,35
25456,11110,11116,41,8,22,7,7,8,26,26,0,21,23,28
25457,11110,11116,20,12,22,4,9,9,19,31,-12,17,27,21
25458,11110,11116,56,16,22,5,3,14,26,39,-13,13,31,18
25459,11110,11116,43,2,22,15,5,2,54,15,39,35,9,50
25460,11110,11116,24,4,22,12,7,3,37,19,18,31,13,43
25461,11110,11116,57,10,22,7,5,10,24,44,-20,19,25,26
25462,11110,11116,22,13,22,5,5,12,20,52,-32,15,29,20
25463,11110,11116,28,15,22,4,7,11,17,31,-14,15,29,19
25464,11110,11116,52,17,22,4,6,12,19,33,-14,14,30,18
25465,11110,11116,12,7,22,8,6,8,29,26,3,22,22,30
25466,11110,11116,53,18,22,4,4,14,25,47,-22,12,32,16
25467,11124,11130,12,8,24,8,7,9,30,29,1,23,25,31
25468,11124,11130,53,17,24,5,4,15,27,50,-23,14,34,19
25469,11124,11130,43,1,24,16,6,2,58,16,42,38,10,54
25470,11124,11130,24,4,24,13,7,4,41,20,21,33,15,46
25471,11124,11130,57,9,24,8,5,11,29,47,-18,21,27,29
25472,11124,11130,22,13,24,5,7,12,21,53,-32,17,31,22
25473,11124,11130,28,15,24,4,8,12,17,33,-16,16,32,20
25474,11124,11130,52,18,24,4,7,13,19,37,-18,15,33,19
25475,11124,11130,35,6,24,11,6,7,42,30,12,28,20,39
25476,11124,11130,41,10,24,7,8,9,27,29,-2,22,26,29
25477,11124,11130,20,12,24,5,10,9,21,32,-11,20,28,25
25478,11124,11130,56,16,24,5,4,15,26,42,-16,14,34,19
25479,11124,11130,27,11,24,5,13,6,22,21,1,23,25,28
25480,11124,11130,4,2,24,16,6,2,56,25,31,38,10,54
25481,11124,11130,21,7,24,7,11,6,41,31,10,25,23,32
25482,11124,11130,49,5,24,12,8,4,37,28,9,32,16,44
25483,11124,11130,17,14,24,4,9,11,14,33,-19,17,31,21
25484,11124,11130,1,3,24,14,8,2,44,16,28,36,12,50
25485,11131,11137,1,3,25,14,8,3,44,17,27,36,14,50
25486,11131,11137,49,5,25,12,9,4,38,29,9,33,17,45
25487,11131,11137,28,15,25,4,9,12,18,34,-16,17,33,21
25488,11131,11137,52,18,25,4,7,14,19,39,-20,15,35,19
25489,11131,11137,4,1,25,17,6,2,57,25,32,40,10,57
25490,11131,11137,21,7,25,8,11,6,43,32,11,27,23,35
25491,11131,11137,27,9,25,6,13,6,24,21,3,25,25,31
25492,11131,11137,35,6,25,12,6,7,45,32,13,30,20,42
25493,11131,11137,41,11,25,7,8,10,27,31,-4,22,28,29
25494,11131,11137,20,12,25,6,10,9,24,33,-9,22,28,28
25495,11131,11137,56,13,25,6,4,15,27,42,-15,16,34,22
25496,11131,11137,22,14,25,5,7,13,22,55,-33,17,33,22
25497,11131,11137,43,2,25,16,6,3,60,19,41,38,12,54
25498,11131,11137,24,4,25,14,7,4,43,21,22,35,15,49
25499,11131,11137,57,10,25,8,5,12,30,50,-20,21,29,29
25500,11131,11137,12,8,25,9,7,9,32,29,3,25,25,34
25501,11131,11137,53,17,25,5,4,16,28,52,-24,14,36,19
25502,11131,11137,17,16,25,4,9,12,14,34,-20,17,33,21
25503,11187,11200,17,16,30,6,10,14,19,39,-20,22,38,28
25504,11187,11200,53,18,30,5,5,20,29,60,-31,15,45,20
25505,11187,11200,12,8,30,10,8,12,37,38,-1,28,32,38
25506,11187,11200,43,1,30,21,6,3,70,20,50,48,12,69
25507,11187,11200,24,2,30,18,8,4,53,23,30,44,16,62
25508,11187,11200,57,12,30,9,7,14,38,60,-22,25,35,34
25509,11187,11200,22,15,30,7,8,15,28,61,-33,22,38,29
25510,11187,11200,35,5,30,16,6,8,53,35,18,38,22,54
25511,11187,11200,41,9,30,9,9,12,34,39,-5,27,33,36
25512,11187,11200,20,10,30,8,11,11,32,39,-7,27,33,35
25513,11187,11200,56,14,30,8,5,17,36,48,-12,21,39,29
25514,11187,11200,27,11,30,7,14,9,28,31,-3,28,32,35
25515,11187,11200,4,3,30,18,7,5,60,33,27,43,17,61
25516,11187,11200,21,7,30,10,13,7,49,36,13,33,27,43
25517,11187,11200,52,13,30,8,8,14,28,41,-13,24,36,32
25518,11187,11200,28,17,30,4,10,16,20,46,-26,18,42,22
25519,11187,11200,49,6,30,14,9,7,45,37,8,37,23,51
25520,11187,11200,1,4,30,15,10,5,50,23,27,40,20,55
25521,10634,10640,57,4,9,5,1,3,12,11,1,11,7,16
25522,10634,10640,17,9,9,3,3,3,10,15,-5,9,9,12
25523,10634,10640,28,17,9,1,3,5,4,14,-10,5,13,6
25524,10634,10640,54,18,9,0,2,7,7,20,-13,2,16,2
25525,10634,10640,1,3,9,5,3,1,15,8,7,13,5,18
25526,10634,10640,12,6,9,4,2,3,13,14,-1,10,8,14
25527,10634,10640,53,13,9,2,4,3,7,11,-4,8,10,10
25528,10634,10640,27,11,9,3,1,5,10,10,0,7,11,10
25529,10634,10640,49,10,9,2,5,2,10,8,2,9,9,11
25530,10634,10640,37,14,9,2,3,4,7,15,-8,7,11,9
25531,10949,10951,4,1,2,2,0,0,7,3,4,4,0,6
25532,10949,10951,21,12,2,1,0,1,2,4,-2,2,2,3
25533,10949,10951,49,2,2,1,1,0,8,2,6,3,1,4
25534,10949,10951,28,11,2,1,0,1,4,6,-2,2,2,3
25535,10949,10951,52,15,2,0,1,1,1,3,-2,1,3,1
25536,10949,10951,24,3,2,1,1,0,5,1,4,3,1,4
25537,10949,10951,57,5,2,1,1,0,3,2,1,3,1,4
25538,10949,10951,22,6,2,1,1,0,2,1,1,3,1,4
25539,10949,10951,43,14,2,0,1,1,0,1,-1,1,3,1
25540,10949,10951,41,17,2,0,0,2,0,2,-2,0,4,0
25541,10949,10951,12,10,2,1,0,1,2,3,-1,2,2,3
25542,10949,10951,53,16,2,0,1,1,2,8,-6,1,3,1
25543,10949,10951,27,6,2,1,1,0,2,1,1,3,1,4
25544,10949,10951,17,18,2,0,0,2,0,6,-6,0,4,0
25545,10949,10951,35,8,2,1,0,1,5,3,2,2,2,3
25546,10949,10951,56,9,2,1,0,1,4,2,2,2,2,3
25547,10949,10951,20,13,2,0,1,1,1,2,-1,1,3,1
25548,10949,10951,1,4,2,1,1,0,3,1,2,3,1,4
25549,10952,10955,1,4,3,2,1,0,4,1,3,5,1,7
25550,10952,10955,17,12,3,1,0,2,4,6,-2,2,4,3
25551,10952,10955,24,7,3,1,1,1,6,6,0,3,3,4
25552,10952,10955,43,8,3,1,1,1,1,1,0,3,3,4
25553,10952,10955,22,10,3,1,1,1,2,4,-2,3,3,4
25554,10952,10955,57,11,3,1,1,1,3,6,-3,3,3,4
25555,10952,10955,49,2,3,2,1,0,9,2,7,5,1,7
25556,10952,10955,27,3,3,2,1,0,7,2,5,5,1,7
25557,10952,10955,12,13,3,1,0,2,2,4,-2,2,4,3
25558,10952,10955,53,16,3,0,2,1,3,9,-6,2,4,2
25559,10952,10955,56,5,3,2,0,1,6,2,4,4,2,6
25560,10952,10955,35,6,3,1,1,1,7,5,2,3,3,4
25561,10952,10955,20,15,3,0,2,1,2,3,-1,2,4,2
25562,10952,10955,41,18,3,0,0,3,0,4,-4,0,6,0
25563,10952,10955,28,14,3,1,0,2,4,7,-3,2,4,3
25564,10952,10955,52,17,3,0,1,2,1,4,-3,1,5,1
25565,10952,10955,4,1,3,3,0,0,10,3,7,6,0,9
25566,10952,10955,21,9,3,1,1,1,4,6,-2,3,3,4
25567,11474,11480,21,5,21,12,2,7,30,20,10,26,16,38
25568,11474,11480,4,6,21,9,6,6,33,29,4,24,18,33
25569,11474,11480,49,3,21,10,10,1,31,13,18,30,12,40
25570,11474,11480,37,12,21,5,8,8,27,27,0,18,24,23
25571,11474,11480,52,11,21,6,5,10,22,29,-7,17,25,23
25572,11474,11480,43,1,21,13,6,2,39,10,29,32,10,45
25573,11474,11480,24,2,21,12,5,4,34,16,18,29,13,41
25574,11474,11480,57,7,21,8,8,5,37,33,4,24,18,32
25575,11474,11480,22,13,21,5,6,10,17,27,-10,16,26,21
25576,11474,11480,34,18,21,2,5,14,8,36,-28,9,33,11
25577,11474,11480,12,14,21,4,9,8,26,32,-6,17,25,21
25578,11474,11480,27,16,21,4,8,9,16,25,-9,16,26,20
25579,11474,11480,17,8,21,8,6,7,27,29,-2,22,20,30
25580,11474,11480,20,9,21,7,4,10,26,29,-3,18,24,25
25581,11474,11480,35,10,21,5,10,6,19,27,-8,20,22,25
25582,11474,11480,41,15,21,4,9,8,19,25,-6,17,25,21
25583,11474,11480,56,17,21,4,6,11,20,46,-26,14,28,18
25584,11474,11480,1,4,21,10,9,2,38,16,22,29,13,39
25585,11544,11557,1,2,29,17,10,2,53,19,34,44,14,61
25586,11544,11557,17,7,29,12,7,10,44,40,4,31,27,43
25587,11544,11557,27,13,29,7,8,14,25,37,-12,22,36,29
25588,11544,11557,12,12,29,8,10,11,35,43,-8,26,32,34
25589,11544,11557,43,1,29,19,6,4,58,18,40,44,14,63
25590,11544,11557,24,4,29,14,10,5,39,18,21,38,20,52
25591,11544,11557,57,9,29,9,13,7,47,43,4,31,27,40
25592,11544,11557,22,15,29,6,9,14,26,38,-12,21,37,27
25593,11544,11557,34,18,29,3,6,20,13,54,-41,12,46,15
25594,11544,11557,41,16,29,5,12,12,27,41,-14,22,36,27
25595,11544,11557,56,17,29,5,8,16,28,62,-34,18,40,23
25596,11544,11557,35,8,29,10,10,9,43,39,4,30,28,40
25597,11544,11557,20,11,29,10,6,13,43,50,-7,26,32,36
25598,11544,11557,52,10,29,10,6,13,32,38,-6,26,32,36
25599,11544,11557,49,3,29,14,12,3,46,22,24,40,18,54
25600,11544,11557,37,14,29,6,11,12,35,43,-8,23,35,29
25601,11544,11557,21,5,29,15,4,10,40,36,4,34,24,49
25602,8086,8099,17,10,11,4,2,5,11,17,-6,10,12,14
25603,8086,8099,49,1,11,6,2,3,27,13,14,14,8,20
25604,8086,8099,12,7,11,5,3,3,13,11,2,13,9,18
25605,8086,8099,53,9,11,4,3,4,17,19,-2,11,11,15
25606,8086,8099,57,17,11,1,4,6,13,18,-5,6,16,7
25607,8086,8099,22,18,11,1,3,7,10,20,-10,5,17,6
25608,8086,8099,52,12,11,3,4,4,12,14,-2,10,12,13
25609,8086,8099,3,16,11,2,2,7,12,25,-13,6,16,8
25610,8086,8099,56,11,11,3,5,3,10,11,-1,11,11,14
25611,8086,8099,41,13,11,3,4,4,9,20,-11,10,12,13
25612,8086,8099,13,14,11,2,6,3,11,14,-3,10,12,12
25613,8086,8099,20,15,11,3,2,6,11,16,-5,8,14,11
25614,8086,8099,37,5,11,5,5,1,25,8,17,15,7,20
25615,8086,8099,1,3,11,6,2,3,16,12,4,14,8,20
25616,8142,8169,1,3,17,8,6,3,27,16,11,22,12,30
25617,8142,8169,17,10,17,6,4,7,18,24,-6,16,18,22
25618,8142,8169,52,9,17,6,6,5,19,17,2,18,16,24
25619,8142,8169,3,18,17,2,4,11,17,35,-18,8,26,10
25620,8142,8169,12,5,17,8,5,4,22,14,8,21,13,29
25621,8142,8169,53,12,17,5,5,7,23,33,-10,15,19,20
25622,8142,8169,56,11,17,5,7,5,20,23,-3,17,17,22
25623,8142,8169,20,14,17,4,5,8,16,23,-7,13,21,17
25624,8142,8169,41,15,17,3,6,8,14,34,-20,12,22,15
25625,8142,8169,13,17,17,2,8,7,18,35,-17,12,22,14
25626,8142,8169,43,2,17,9,5,3,35,20,15,23,11,32
25627,8142,8169,57,13,17,4,6,7,21,25,-4,14,20,18
25628,8142,8169,22,16,17,3,5,9,18,25,-7,11,23,14
25629,8142,8169,49,1,17,10,3,4,43,21,22,23,11,33
25630,8142,8169,37,8,17,6,7,4,37,19,18,19,15,25
25631,8142,8169,19,4,17,8,6,3,27,18,9,22,12,30
25632,8142,8169,21,6,17,8,4,5,20,20,0,20,14,28
25633,8142,8169,4,7,17,6,8,3,26,19,7,20,14,26
25634,8023,8025,21,5,2,1,0,1,3,2,1,2,2,3
25635,8023,8025,4,15,2,0,1,1,2,3,-1,1,3,1
25636,8023,8025,52,10,2,1,0,1,2,3,-1,2,2,3
25637,8023,8025,3,18,2,0,0,2,0,3,-3,0,4,0
25638,8023,8025,20,5,2,1,0,1,3,2,1,2,2,3
25639,8023,8025,56,10,2,1,0,1,2,3,-1,2,2,3
25640,8023,8025,13,14,2,0,2,0,1,1,0,2,2,2
25641,8023,8025,41,17,2,0,1,1,0,4,-4,1,3,1
25642,8023,8025,43,1,2,2,0,0,6,2,4,4,0,6
25643,8023,8025,22,8,2,1,0,1,2,1,1,2,2,3
25644,8023,8025,57,16,2,0,1,1,3,5,-2,1,3,1
25645,8023,8025,53,2,2,2,0,0,3,1,2,4,0,6
25646,8023,8025,12,9,2,1,0,1,2,2,0,2,2,3
25647,8023,8025,37,3,2,1,1,0,3,1,2,3,1,4
25648,8023,8025,49,10,2,1,0,1,2,3,-1,2,2,3
25649,8023,8025,19,4,2,1,0,1,4,2,2,2,2,3
25650,8023,8025,17,13,2,1,0,1,1,2,-1,2,2,3
25651,8023,8025,1,5,2,1,0,1,3,2,1,2,2,3
25652,8275,8281,1,4,30,15,8,7,50,40,10,38,22,53
25653,8275,8281,19,7,30,14,8,8,45,40,5,36,24,50
25654,8275,8281,17,10,30,9,7,14,30,45,-15,25,35,34
25655,8275,8281,12,8,30,12,7,11,38,32,6,31,29,43
25656,8275,8281,53,13,30,8,8,14,39,52,-13,24,36,32
25657,8275,8281,52,9,30,9,12,9,30,29,1,30,30,39
25658,8275,8281,3,18,30,4,7,19,28,58,-30,15,45,19
25659,8275,8281,43,1,30,19,7,4,71,31,40,45,15,64
25660,8275,8281,57,14,30,7,11,12,35,46,-11,25,35,32
25661,8275,8281,22,17,30,4,9,17,30,54,-24,17,43,21
25662,8275,8281,41,11,30,8,10,12,30,48,-18,26,34,34
25663,8275,8281,56,12,30,8,9,13,35,47,-12,25,35,33
25664,8275,8281,13,15,30,6,11,13,36,59,-23,23,37,29
25665,8275,8281,20,16,30,6,8,16,32,47,-15,20,40,26
25666,8275,8281,49,2,30,19,6,5,71,31,40,44,16,63
25667,8275,8281,37,6,30,14,9,7,64,33,31,37,23,51
25668,8275,8281,21,3,30,18,5,7,47,29,18,41,19,59
25669,8275,8281,4,5,30,14,10,6,47,37,10,38,22,52
25670,8450,8470,37,1,11,7,4,0,19,12,7,18,4,25
25671,8450,8470,52,18,11,1,4,6,10,18,-8,6,16,7
25672,8450,8470,19,7,11,4,4,3,18,14,4,12,10,16
25673,8450,8470,17,13,11,4,1,6,15,17,-2,9,13,13
25674,8450,8470,8,17,11,2,2,7,11,26,-15,6,16,8
25675,8450,8470,20,5,11,5,2,4,12,8,4,12,10,17
25676,8450,8470,56,15,11,2,4,5,10,15,-5,8,14,10
25677,8450,8470,41,16,11,2,2,7,9,21,-12,6,16,8
25678,8450,8470,12,10,11,4,2,5,11,13,-2,10,12,14
25679,8450,8470,49,6,11,4,4,3,15,10,5,12,10,16
25680,8450,8470,13,2,11,7,2,2,22,10,12,16,6,23
25681,8450,8470,57,3,11,6,2,3,12,8,4,14,8,20
25682,13336,13342,27,15,26,7,6,13,30,40,-10,20,32,27
25683,13336,13342,1,1,26,16,5,5,55,30,25,37,15,53
25684,13336,13342,12,16,26,7,6,13,34,48,-14,20,32,27
25685,13336,13342,17,2,26,14,10,2,50,28,22,38,14,52
25686,13336,13342,47,6,26,12,6,8,43,30,13,30,22,42
25687,13413,13489,47,9,34,12,11,11,50,42,8,35,33,47
25688,13413,13489,17,1,34,21,10,3,70,38,32,52,16,73
25689,13413,13489,12,12,34,10,8,16,41,57,-16,28,40,38
25690,13413,13489,1,2,34,22,5,7,69,34,35,49,19,71
25691,13413,13489,27,13,34,10,7,17,44,58,-14,27,41,37
25692,13413,13489,33,3,34,17,10,7,60,38,22,44,24,61
25693,13413,13489,28,11,34,10,9,15,46,56,-10,29,39,39
25694,13413,13489,52,16,34,8,11,15,32,43,-11,27,41,35
25695,13413,13489,6,5,34,16,9,9,50,48,2,41,27,57
25696,13413,13489,35,10,34,13,7,14,56,57,-1,33,35,46
25697,13413,13489,43,4,34,16,10,8,59,36,23,42,26,58
25698,13413,13489,22,8,34,13,9,12,49,43,6,35,33,48
25699,13413,13489,34,15,34,8,12,14,44,55,-11,28,40,36
25700,13413,13489,24,17,34,7,10,17,33,55,-22,24,44,31
25701,13413,13489,57,18,34,6,9,19,36,67,-31,21,47,27
25702,13413,13489,21,6,34,16,5,13,51,49,2,37,31,53
25703,13413,13489,4,14,34,10,6,18,44,58,-14,26,42,36
25704,13413,13489,49,7,34,16,2,16,55,55,0,34,34,50
25705,13161,13167,4,5,6,3,2,1,13,11,2,8,4,11
25706,13161,13167,21,11,6,2,1,3,8,14,-6,5,7,7
25707,13161,13167,49,2,6,4,0,2,9,7,2,8,4,12
25708,13161,13167,43,3,6,3,3,0,15,3,12,9,3,12
25709,13161,13167,34,7,6,2,2,2,7,7,0,6,6,8
25710,13161,13167,22,8,6,2,2,2,8,9,-1,6,6,8
25711,13161,13167,52,14,6,1,3,2,5,8,-3,5,7,6
25712,13161,13167,28,17,6,1,1,4,7,15,-8,3,9,4
25713,13161,13167,24,13,6,1,4,1,11,11,0,6,6,7
25714,13161,13167,57,18,6,0,3,3,6,15,-9,3,9,3
25715,13161,13167,27,10,6,2,1,3,9,10,-1,5,7,7
25716,13161,13167,33,4,6,3,3,0,13,8,5,9,3,12
25717,13161,13167,1,1,6,4,2,0,16,5,11,10,2,14
25718,13161,13167,35,16,6,1,1,4,7,11,-4,3,9,4
25719,13161,13167,17,12,6,1,4,1,9,6,3,6,6,7
25720,13161,13167,12,6,6,2,2,2,10,7,3,6,6,8
25721,13161,13167,6,9,6,2,2,2,9,12,-3,6,6,8
25722,13161,13167,47,15,6,1,2,3,7,10,-3,4,8,5
25723,13591,13594,47,3,12,6,5,1,22,10,12,17,7,23
25724,13591,13594,17,5,12,6,3,3,25,16,9,15,9,21
25725,13591,13594,6,2,12,7,2,3,25,17,8,16,8,23
25726,13591,13594,35,4,12,7,1,4,21,16,5,15,9,22
25727,13591,13594,1,1,12,11,1,0,33,6,27,23,1,34
25728,13591,13594,22,6,12,6,2,4,28,19,9,14,10,20
25729,13591,13594,43,9,12,5,2,5,17,16,1,12,12,17
25730,13591,13594,34,14,12,3,3,6,19,22,-3,9,15,12
25731,13591,13594,28,8,12,5,3,4,13,15,-2,13,11,18
25732,13591,13594,52,11,12,4,2,6,18,27,-9,10,14,14
25733,13591,13594,33,16,12,2,3,7,9,18,-9,7,17,9
25734,13591,13594,4,12,12,3,5,4,21,20,1,11,13,14
25735,13591,13594,21,17,12,2,1,9,13,25,-12,5,19,7
25736,13591,13594,49,15,12,3,3,6,12,17,-5,9,15,12
25737,13591,13594,37,18,12,1,4,7,13,23,-10,6,18,7
25738,13591,13594,27,13,12,3,4,5,14,25,-11,10,14,13
25739,13591,13594,25,7,12,5,4,3,25,24,1,14,10,19
25740,13591,13594,12,10,12,5,0,7,19,31,-12,10,14,15
25741,13651,13657,12,7,18,9,0,9,36,39,-3,18,18,27
25742,13651,13657,25,13,18,5,6,7,27,34,-7,16,20,21
25743,13651,13657,49,15,18,4,7,7,24,27,-3,15,21,19
25744,13651,13657,37,17,18,3,5,10,17,31,-14,11,25,14
25745,13651,13657,4,12,18,5,7,6,29,28,1,17,19,22
25746,13651,13657,21,18,18,2,3,13,20,37,-17,7,29,9
25747,13651,13657,22,2,18,11,3,4,40,23,17,25,11,36
25748,13651,13657,43,6,18,8,4,6,25,21,4,20,16,28
25749,13651,13657,34,9,18,7,3,8,31,31,0,17,19,24
25750,13651,13657,1,1,18,16,2,0,47,11,36,34,2,50
25751,13651,13657,27,11,18,6,5,7,25,33,-8,17,19,23
25752,13651,13657,28,10,18,6,6,6,17,20,-3,18,18,24
25753,13651,13657,33,14,18,5,4,9,19,26,-7,14,22,19
25754,13651,13657,52,16,18,4,2,12,20,49,-29,10,26,14
25755,13651,13657,35,3,18,10,3,5,31,21,10,23,13,33
25756,13651,13657,6,5,18,8,4,6,29,24,5,20,16,28
25757,13651,13657,17,8,18,7,4,7,30,26,4,18,18,25
25758,13651,13657,47,4,18,8,8,2,33,19,14,24,12,32
25759,13749,13751,47,6,31,13,10,8,45,28,17,36,26,49
25760,13749,13751,17,7,31,13,7,11,50,41,9,33,29,46
25761,10977,10983,1,2,6,5,1,0,9,1,8,11,1,16
25762,10977,10983,4,1,6,5,1,0,15,5,10,11,1,16
25763,10977,10983,21,8,6,2,2,2,7,9,-2,6,6,8
25764,10977,10983,20,6,6,2,2,2,8,4,4,6,6,8
25765,10977,10983,56,13,6,2,0,4,8,13,-5,4,8,6
25766,10977,10983,35,14,6,1,3,2,10,10,0,5,7,6
25767,10977,10983,41,15,6,1,2,3,6,8,-2,4,8,5
25768,10977,10983,52,10,6,2,1,3,7,7,0,5,7,7
25769,10977,10983,28,17,6,1,2,3,5,10,-5,4,8,5
25770,10977,10983,12,12,6,2,0,4,6,9,-3,4,8,6
25771,10977,10983,53,18,6,0,3,3,7,18,-11,3,9,3
25772,10977,10983,27,4,6,3,2,1,10,5,5,8,4,11
25773,10977,10983,17,16,6,1,2,3,4,8,-4,4,8,5
25774,10977,10983,43,5,6,2,2,2,11,7,4,6,6,8
25775,10977,10983,24,7,6,2,2,2,10,11,-1,6,6,8
25776,10977,10983,57,9,6,2,2,2,5,8,-3,6,6,8
25777,10977,10983,22,11,6,2,1,3,4,10,-6,5,7,7
25778,10977,10983,49,3,6,4,2,0,15,4,11,10,2,14
25779,10984,10990,49,3,7,5,2,0,17,5,12,12,2,17
25780,10984,10990,43,5,7,3,2,2,14,7,7,8,6,11
25781,10984,10990,24,6,7,3,2,2,11,11,0,8,6,11
25782,10984,10990,57,10,7,2,2,3,7,11,-4,6,8,8
25783,10984,10990,22,13,7,2,1,4,4,13,-9,5,9,7
25784,10984,10990,17,18,7,1,2,4,4,9,-5,4,10,5
25785,10984,10990,27,4,7,3,3,1,10,5,5,9,5,12
25786,10984,10990,12,12,7,2,1,4,7,10,-3,5,9,7
25787,10984,10990,53,16,7,1,3,3,10,20,-10,5,9,6
25788,10984,10990,52,11,7,2,1,4,7,8,-1,5,9,7
25789,10984,10990,28,15,7,1,3,3,5,10,-5,5,9,6
25790,10984,10990,35,7,7,2,3,2,15,11,4,7,7,9
25791,10984,10990,20,8,7,2,3,2,9,5,4,7,7,9
25792,10984,10990,56,14,7,2,0,5,9,18,-9,4,10,6
25793,10984,10990,41,17,7,1,2,4,7,11,-4,4,10,5
25794,10984,10990,4,1,7,6,1,0,16,5,11,13,1,19
25795,10984,10990,21,9,7,2,2,3,8,11,-3,6,8,8
25796,10984,10990,1,2,7,6,1,0,12,2,10,13,1,19
25797,11404,11410,21,5,14,7,1,6,17,16,1,15,13,22
25798,11404,11410,4,6,14,6,4,4,22,21,1,16,12,22
25799,11404,11410,49,4,14,8,5,1,24,10,14,21,7,29
25800,11404,11410,37,12,14,4,4,6,20,20,0,12,16,16
25801,11404,11410,52,16,14,3,2,9,13,25,-12,8,20,11
25802,11404,11410,43,1,14,9,4,1,24,7,17,22,6,31
25803,11404,11410,24,3,14,9,2,3,23,11,12,20,8,29
25804,11404,11410,57,8,14,5,5,4,24,26,-2,15,13,20
25805,11404,11410,22,15,14,3,3,8,10,17,-7,9,19,12
25806,11404,11410,34,17,14,2,3,9,6,23,-17,7,21,9
25807,11404,11410,12,13,14,3,6,5,19,19,0,12,16,15
25808,11404,11410,20,9,14,6,1,7,21,20,1,13,15,19
25809,11404,11410,41,10,14,4,6,4,15,14,1,14,14,18
25810,11404,11410,35,11,14,4,6,4,14,18,-4,14,14,18
25811,11404,11410,27,18,14,1,4,9,6,19,-13,6,22,7
25812,11404,11410,17,7,14,6,4,4,21,20,1,16,12,22
25813,11404,11410,1,2,14,9,3,2,32,13,19,21,7,30
25814,11404,11410,56,14,14,3,5,6,12,24,-12,11,17,14
25815,11411,11417,20,9,15,6,1,8,21,23,-2,13,17,19
25816,11411,11417,41,10,15,4,7,4,16,15,1,15,15,19
25817,11411,11417,35,11,15,4,7,4,14,18,-4,15,15,19
25818,11411,11417,56,14,15,3,5,7,14,28,-14,11,19,14
25819,11411,11417,17,8,15,6,4,5,21,23,-2,16,14,22
25820,11411,11417,27,18,15,1,5,9,7,20,-13,7,23,8
25821,11411,11417,12,12,15,4,6,5,22,19,3,14,16,18
25822,11411,11417,24,1,15,10,2,3,26,11,15,22,8,32
25823,11411,11417,43,2,15,9,5,1,24,7,17,23,7,32
25824,11411,11417,57,7,15,6,5,4,25,26,-1,17,13,23
25825,11411,11417,22,15,15,3,3,9,10,19,-9,9,21,12
25826,11411,11417,34,17,15,2,3,10,6,24,-18,7,23,9
25827,11411,11417,52,16,15,3,3,9,14,26,-12,9,21,12
25828,11411,11417,49,4,15,8,6,1,24,10,14,22,8,30
25829,11411,11417,37,13,15,4,5,6,20,20,0,13,17,17
25830,11411,11417,21,5,15,8,1,6,19,16,3,17,13,25
25831,11411,11417,4,6,15,7,4,4,26,23,3,18,12,25
25832,11411,11417,1,3,15,9,4,2,33,14,19,22,8,31
25833,11467,11473,1,4,20,9,9,2,35,16,19,27,13,36
25834,11467,11473,21,5,20,11,2,7,28,20,8,24,16,35
25835,11467,11473,4,6,20,9,5,6,33,29,4,23,17,32
25836,11467,11473,49,3,20,9,10,1,27,12,15,28,12,37
25837,11467,11473,37,12,20,5,7,8,25,25,0,17,23,22
25838,11467,11473,52,11,20,6,5,9,22,27,-5,17,23,23
25839,11467,11473,41,13,20,4,9,7,19,23,-4,17,23,21
25840,11467,11473,56,16,20,4,6,10,20,43,-23,14,26,18
25841,11544,11557,4,6,29,13,8,8,45,38,7,34,24,47
25842,11586,11662,21,4,34,18,5,11,47,39,8,41,27,59
25843,11586,11662,4,6,34,16,9,9,54,44,10,41,27,57
25844,11586,11662,52,11,34,11,7,16,37,48,-11,29,39,40
25845,11586,11662,35,8,34,13,11,10,55,45,10,37,31,50
25846,11586,11662,20,10,34,11,8,15,47,55,-8,30,38,41
25847,11586,11662,41,16,34,7,13,14,33,47,-14,27,41,34
25848,11586,11662,56,17,34,5,10,19,31,72,-41,20,48,25
25849,11586,11662,43,2,34,21,7,6,65,26,39,49,19,70
25850,11586,11662,24,5,34,15,13,6,47,23,24,43,25,58
25851,11586,11662,57,9,34,10,14,10,57,57,0,34,34,44
25852,11586,11662,22,15,34,8,10,16,32,44,-12,26,42,34
25853,11586,11662,34,18,34,4,8,22,18,62,-44,16,52,20
25854,11586,11662,12,14,34,8,11,15,38,51,-13,27,41,35
25855,11586,11662,17,7,34,14,9,11,53,50,3,37,31,51
25856,11586,11662,27,13,34,9,9,16,32,43,-11,27,41,36
25857,11586,11662,49,3,34,16,14,4,59,28,31,46,22,62
25858,11586,11662,37,12,34,9,11,14,42,52,-10,29,39,38
25859,11586,11662,1,1,34,21,11,2,68,29,39,53,15,74
25860,11663,11669,1,4,1,1,0,0,3,2,1,2,0,3
25861,11663,11669,14,4,1,1,0,0,3,2,1,2,0,3
25862,11663,11669,37,6,1,1,0,0,2,1,1,2,0,3
25863,11663,11669,49,16,1,0,0,1,1,3,-2,0,2,0
25864,11663,11669,27,8,1,1,0,0,1,0,1,2,0,3
25865,11663,11669,17,11,1,0,0,1,2,3,-1,0,2,0
25866,11663,11669,12,6,1,1,0,0,2,1,1,2,0,3
25867,11663,11669,24,1,1,1,0,0,6,2,4,2,0,3
25868,11663,11669,43,2,1,1,0,0,4,0,4,2,0,3
25869,11663,11669,22,9,1,0,1,0,1,1,0,1,1,1
25870,11663,11669,57,17,1,0,0,1,2,6,-4,0,2,0
25871,11663,11669,35,11,1,0,0,1,2,3,-1,0,2,0
25872,11663,11669,41,13,1,0,0,1,1,2,-1,0,2,0
25873,11663,11669,20,13,1,0,0,1,1,2,-1,0,2,0
25874,11663,11669,6,18,1,0,0,1,0,4,-4,0,2,0
25875,11663,11669,52,9,1,0,1,0,1,1,0,1,1,1
25876,11663,11669,21,3,1,1,0,0,3,1,2,2,0,3
25877,11663,11669,4,15,1,0,0,1,0,1,-1,0,2,0
25878,11845,11858,49,2,22,14,4,4,47,28,19,32,12,46
25879,11845,11858,37,11,22,9,5,8,27,28,-1,23,21,32
25880,11845,11858,14,16,22,5,3,14,33,71,-38,13,31,18
25881,11845,11858,4,6,22,10,6,6,34,24,10,26,18,36
25882,11845,11858,21,7,22,10,3,9,38,36,2,23,21,33
25883,11845,11858,27,10,22,9,5,8,35,32,3,23,21,32
25884,11845,11858,12,17,22,3,4,15,20,43,-23,10,34,13
25885,11845,11858,1,4,22,11,4,7,31,19,12,26,18,37
25886,11845,11858,43,1,22,17,4,1,51,17,34,38,6,55
25887,11845,11858,24,5,22,11,3,8,34,25,9,25,19,36
25888,11845,11858,22,12,22,6,8,8,23,21,2,20,24,26
25889,11845,11858,57,14,22,6,6,10,44,51,-7,18,26,24
25890,11845,11858,20,3,22,12,5,5,59,29,30,29,15,41
25891,11845,11858,35,13,22,7,3,12,36,44,-8,17,27,24
25892,11845,11858,41,15,22,6,6,10,28,48,-20,18,26,24
25893,11845,11858,6,18,22,2,3,17,21,56,-35,7,37,9
25894,11845,11858,17,9,22,9,5,8,35,31,4,23,21,32
25895,11845,11858,52,8,22,8,9,5,33,26,7,25,19,33
25896,11691,11697,17,12,5,1,2,2,9,6,3,4,6,5
25897,11691,11697,12,9,5,2,1,2,4,6,-2,5,5,7
25898,11691,11697,27,2,5,4,0,1,15,8,7,8,2,12
25899,11691,11697,20,10,5,2,0,3,10,11,-1,4,6,6
25900,11691,11697,35,14,5,1,1,3,9,13,-4,3,7,4
25901,11691,11697,41,15,5,1,1,3,8,13,-5,3,7,4
25902,11691,11697,6,18,5,0,1,4,3,17,-14,1,9,1
25903,11691,11697,43,1,5,5,0,0,16,3,13,10,0,15
25904,11691,11697,24,3,5,4,0,1,12,5,7,8,2,12
25905,11691,11697,22,13,5,1,1,3,5,7,-2,3,7,4
25906,11691,11697,57,17,5,0,1,4,9,16,-7,1,9,1
25907,11691,11697,52,16,5,0,4,1,5,6,-1,4,6,4
25908,11691,11697,37,4,5,4,0,1,8,6,2,8,2,12
25909,11691,11697,49,5,5,3,1,1,7,5,2,7,3,10
25910,11691,11697,14,11,5,2,0,3,12,15,-3,4,6,6
25911,11691,11697,4,8,5,2,1,2,6,5,1,5,5,7
25912,11691,11697,21,7,5,3,0,2,10,9,1,6,4,9
25913,11691,11697,1,6,5,3,0,2,9,6,3,6,4,9
25914,11698,11704,1,6,6,4,0,2,10,6,4,8,4,12
25915,11698,11704,4,7,6,3,1,2,11,5,6,7,5,10
25916,11698,11704,21,8,6,3,1,2,11,10,1,7,5,10
25917,11698,11704,49,2,6,4,1,1,9,6,3,9,3,13
25918,11698,11704,37,3,6,4,1,1,8,6,2,9,3,13
25919,11698,11704,14,13,6,2,0,4,12,18,-6,4,8,6
25920,11698,11704,43,1,6,5,1,0,16,3,13,11,1,16
25921,11698,11704,24,5,6,4,0,2,13,7,6,8,4,12
25922,15072,15078,28,8,15,5,4,6,23,24,-1,14,16,19
25923,15072,15078,33,9,15,6,0,9,29,24,5,12,18,18
25924,15072,15078,52,16,15,4,2,9,19,29,-10,10,20,14
25925,15072,15078,49,5,15,9,4,2,25,15,10,22,8,31
25926,15072,15078,35,7,15,6,5,4,33,23,10,17,13,23
25927,15072,15078,6,15,15,3,6,6,22,33,-11,12,18,15
25928,15072,15078,17,11,15,4,4,7,18,21,-3,12,18,16
25929,15072,15078,27,10,15,5,3,7,13,24,-11,13,17,18
25930,15072,15078,25,12,15,4,3,8,23,26,-3,11,19,15
25931,15072,15078,12,6,15,8,3,4,23,15,8,19,11,27
25932,15114,15120,27,10,19,7,3,9,18,36,-18,17,21,24
25933,15114,15120,17,13,19,4,6,9,29,34,-5,14,24,18
25934,15114,15120,35,7,19,7,7,5,38,27,11,21,17,28
25935,15114,15120,6,12,19,5,6,8,29,37,-8,16,22,21
25936,15114,15120,49,2,19,12,5,2,40,20,20,29,9,41
25937,15114,15120,37,18,19,1,6,12,20,52,-32,8,30,9
25938,15114,15120,33,8,19,8,2,9,41,29,12,18,20,26
25939,15114,15120,28,9,19,7,4,8,27,28,-1,18,20,25
25940,15114,15120,52,14,19,5,2,12,24,36,-12,12,26,17
25941,15114,15120,22,1,19,12,6,1,56,25,31,30,8,42
25942,15114,15120,43,5,19,11,6,2,43,22,21,28,10,39
25943,15114,15120,34,16,19,4,3,12,18,47,-29,11,27,15
25944,15114,15120,40,17,19,3,6,10,23,42,-19,12,26,15
25945,15114,15120,4,4,19,12,4,3,34,22,12,28,10,40
25946,15114,15120,21,15,19,4,5,10,25,33,-8,13,25,17
25947,15114,15120,1,3,19,13,1,5,44,24,20,27,11,40
25948,15114,15120,12,6,19,10,5,4,31,20,11,25,13,35
25949,15114,15120,25,11,19,6,3,10,30,36,-6,15,23,21
25950,15121,15127,12,6,20,11,5,4,32,20,12,27,13,38
25951,15121,15127,25,10,20,7,3,10,33,37,-4,17,23,24
25952,15121,15127,1,1,20,14,1,5,48,24,24,29,11,43
25953,15121,15127,4,5,20,12,4,4,35,25,10,28,12,40
25954,15121,15127,21,15,20,4,5,11,26,37,-11,13,27,17
25955,15121,15127,22,2,20,12,7,1,56,25,31,31,9,43
25956,15121,15127,43,3,20,12,6,2,44,22,22,30,10,42
25957,15121,15127,40,16,20,3,7,10,23,42,-19,13,27,16
25958,15121,15127,34,17,20,4,3,13,18,48,-30,11,29,15
25959,15121,15127,33,7,20,9,2,9,42,29,13,20,20,29
25960,15121,15127,28,8,20,8,4,8,29,29,0,20,20,28
25961,15121,15127,52,14,20,6,2,12,26,37,-11,14,26,20
25962,15121,15127,49,4,20,12,5,3,41,22,19,29,11,41
25963,15121,15127,37,18,20,1,6,13,20,56,-36,8,32,9
25964,15121,15127,35,9,20,7,7,6,38,28,10,21,19,28
25965,15121,15127,6,13,20,5,6,9,29,38,-9,16,24,21
25966,15121,15127,17,12,20,5,6,9,33,35,-2,16,24,21
25967,15121,15127,27,11,20,7,3,10,19,38,-19,17,23,24
25968,15156,15162,27,10,25,9,5,11,29,44,-15,23,27,32
25969,15156,15162,49,4,25,13,7,5,49,31,18,33,17,46
25970,15156,15162,37,18,25,2,8,15,26,66,-40,12,38,14
25971,15156,15162,17,15,25,5,7,13,37,49,-12,17,33,22
25972,15156,15162,12,6,25,12,7,6,35,24,11,31,19,43
25973,15156,15162,25,12,25,8,5,12,42,47,-5,21,29,29
25974,15156,15162,35,8,25,8,11,6,48,37,11,27,23,35
25975,15156,15162,6,11,25,8,7,10,41,43,-2,23,27,31
25976,15156,15162,1,1,25,18,1,6,60,30,30,37,13,55
25977,15156,15162,4,5,25,12,8,5,44,36,8,32,18,44
25978,15156,15162,22,2,25,14,10,1,66,33,33,38,12,52
25979,15156,15162,43,3,25,14,8,3,57,28,29,36,14,50
25980,15156,15162,40,14,25,5,8,12,28,48,-20,18,32,23
25981,15156,15162,34,17,25,4,5,16,19,54,-35,13,37,17
25982,15156,15162,33,7,25,12,4,9,52,32,20,28,22,40
25983,15156,15162,28,9,25,10,4,11,35,36,-1,24,26,34
25984,15156,15162,52,13,25,8,4,13,32,45,-13,20,30,28
25985,15156,15162,21,16,25,5,7,13,35,52,-17,17,33,22
25986,15205,15211,4,5,32,15,10,7,58,46,12,40,24,55
25987,15205,15211,21,16,32,7,10,15,45,61,-16,24,40,31
25988,15205,15211,12,6,32,15,9,8,40,29,11,39,25,54
25989,15205,15211,25,13,32,9,8,15,48,57,-9,26,38,35
25990,15205,15211,1,2,32,21,4,7,69,36,33,46,18,67
25991,15205,15211,33,7,32,16,5,11,66,38,28,37,27,53
25992,15205,15211,28,8,32,15,4,13,46,43,3,34,30,49
25993,15205,15211,52,11,32,11,5,16,41,53,-12,27,37,38
25994,15205,15211,35,9,32,9,16,7,61,48,13,34,30,43
25995,15205,15211,6,14,32,9,8,15,50,64,-14,26,38,35
25996,15205,15211,49,4,32,15,11,6,56,36,20,41,23,56
25997,15205,15211,37,18,32,2,8,22,30,85,-55,12,52,14
25998,15205,15211,22,1,32,20,10,2,82,40,42,50,14,70
25999,15205,15211,43,3,32,16,12,4,67,37,30,44,20,60
26000,13749,13751,35,3,31,17,6,8,56,41,15,40,22,57
26001,13749,13751,6,10,31,10,8,13,44,48,-4,28,34,38
26002,13749,13751,33,13,31,9,8,14,34,43,-9,26,36,35
26003,13749,13751,28,14,31,8,11,12,29,36,-7,27,35,35
26004,13749,13751,52,17,31,6,6,19,31,71,-40,18,44,24
26005,13749,13751,27,15,31,8,10,13,40,53,-13,26,36,34
26006,13749,13751,1,1,31,24,5,2,67,27,40,53,9,77
26007,13749,13751,22,2,31,19,6,6,63,34,29,44,18,63
26008,13749,13751,43,4,31,14,8,9,49,35,14,36,26,50
26009,13749,13751,34,11,31,9,9,13,47,57,-10,27,35,36
26010,13749,13751,4,8,31,10,13,8,42,38,4,33,29,43
26011,13749,13751,21,18,31,5,7,19,33,60,-27,17,45,22
26012,13749,13751,49,9,31,10,10,11,48,43,5,30,32,40
26013,13749,13751,37,16,31,6,10,15,26,46,-20,22,40,28
26014,13749,13751,12,5,31,15,4,12,62,60,2,34,28,49
26015,13749,13751,25,12,31,8,12,11,46,51,-5,28,34,36
26016,13987,14014,4,7,19,8,7,4,32,34,-2,23,15,31
26017,13987,14014,9,17,19,2,6,11,18,45,-27,10,28,12
26018,13987,14014,49,5,19,10,2,7,28,19,9,22,16,32
26019,13987,14014,37,16,19,4,4,11,19,30,-11,12,26,16
26020,13987,14014,22,2,19,11,5,3,41,23,18,27,11,38
26021,13987,14014,43,6,19,9,5,5,35,26,9,23,15,32
26022,13987,14014,34,12,19,7,5,7,30,34,-4,19,19,26
26023,13987,14014,1,1,19,12,4,3,34,18,16,28,10,40
26024,13987,14014,27,14,19,3,8,8,24,28,-4,14,24,17
26025,13987,14014,33,4,19,9,7,3,39,30,9,25,13,34
26026,13987,14014,28,8,19,8,6,5,25,21,4,22,16,30
26027,13987,14014,35,9,19,8,4,7,34,30,4,20,18,28
26028,13987,14014,6,15,19,4,4,11,20,31,-11,12,26,16
26029,13987,14014,56,18,19,1,5,13,24,50,-26,7,31,8
26030,13987,14014,12,3,19,10,4,5,40,25,15,24,14,34
26031,13987,14014,25,10,19,8,3,8,39,33,6,19,19,27
26032,13987,14014,17,11,19,8,3,8,33,31,2,19,19,27
26033,13987,14014,47,13,19,4,8,7,23,30,-7,16,22,20
26034,13882,13884,47,9,4,1,2,1,5,5,0,4,4,5
26035,13882,13884,17,15,4,1,0,3,7,11,-4,2,6,3
26036,13882,13884,6,8,4,2,0,2,3,4,-1,4,4,6
26037,13882,13884,35,16,4,1,0,3,2,10,-8,2,6,3
26038,13882,13884,56,17,4,1,0,3,3,12,-9,2,6,3
26039,13882,13884,27,4,4,2,1,1,9,5,4,5,3,7
26040,13882,13884,33,3,4,2,2,0,7,3,4,6,2,8
26041,13882,13884,28,13,4,1,1,2,5,5,0,3,5,4
26042,13882,13884,1,5,4,2,1,1,5,3,2,5,3,7
26043,13882,13884,4,10,4,1,2,1,5,6,-1,4,4,5
26044,13882,13884,9,11,4,1,2,1,4,5,-1,4,4,5
26045,13882,13884,12,1,4,4,0,0,13,2,11,8,0,12
26046,13882,13884,25,2,4,3,0,1,11,4,7,6,2,9
26047,13882,13884,49,7,4,2,0,2,7,4,3,4,4,6
26048,13882,13884,37,14,4,1,1,2,5,6,-1,3,5,4
26049,13882,13884,22,6,4,2,1,1,6,5,1,5,3,7
26050,13882,13884,34,12,4,1,1,2,7,7,0,3,5,4
26051,13882,13884,43,18,4,0,2,2,3,10,-7,2,6,2
26052,13910,13916,22,2,9,6,2,1,14,7,7,14,4,20
26053,13910,13916,34,11,9,3,2,4,15,16,-1,8,10,11
26054,13910,13916,43,15,9,1,5,3,11,16,-5,7,11,8
26055,13910,13916,49,5,9,5,0,4,17,9,8,10,8,15
26056,13910,13916,37,12,9,3,1,5,12,14,-2,7,11,10
26057,13910,13916,4,6,9,4,3,2,16,11,5,11,7,15
26058,13910,13916,9,17,9,1,3,5,7,25,-18,5,13,6
26059,13910,13916,1,3,9,6,1,2,16,9,7,13,5,19
26060,13910,13916,27,8,9,3,5,1,14,9,5,11,7,14
26061,13910,13916,28,7,9,4,2,3,13,10,3,10,8,14
26062,13910,13916,33,10,9,3,4,2,12,13,-1,10,8,13
26063,13910,13916,35,13,9,3,1,5,9,16,-7,7,11,10
26064,13910,13916,6,14,9,2,2,5,9,14,-5,6,12,8
26065,13910,13916,56,18,9,1,1,7,13,27,-14,3,15,4
26066,13910,13916,12,1,9,6,2,1,21,8,13,14,4,20
26067,13910,13916,25,4,9,6,0,3,25,15,10,12,6,18
26068,13910,13916,17,9,9,4,1,4,17,15,2,9,9,13
26069,13910,13916,47,16,9,1,3,5,7,14,-7,5,13,6
26070,14337,14343,47,15,16,3,4,9,23,30,-7,10,22,13
26071,14337,14343,6,16,16,1,8,7,14,30,-16,10,22,11
26072,14337,14343,35,6,16,8,3,5,28,24,4,19,13,27
26073,14337,14343,17,3,16,9,4,3,29,15,14,22,10,31
26074,14337,14343,33,10,16,6,4,6,29,24,5,16,16,22
26075,14337,14343,27,12,16,4,5,7,20,26,-6,13,19,17
26076,14337,14343,28,18,16,2,4,10,16,38,-22,8,24,10
26077,14337,14343,1,5,16,9,2,5,33,16,17,20,12,29
26078,14337,14343,37,14,16,3,5,8,21,33,-12,11,21,14
26079,14337,14343,4,4,16,10,0,6,46,30,16,20,12,30
26080,8450,8470,43,4,11,5,4,2,25,13,12,14,8,19
26081,8450,8470,24,8,11,3,7,1,16,13,3,13,9,16
26082,8450,8470,53,12,11,3,5,3,16,22,-6,11,11,14
26083,8450,8470,21,9,11,4,3,4,16,13,3,11,11,15
26084,8450,8470,4,14,11,3,3,5,13,15,-2,9,13,12
26085,8450,8470,1,11,11,3,5,3,16,18,-2,11,11,14
26086,8492,8498,1,7,15,5,7,3,23,18,5,17,13,22
26087,8492,8498,21,10,15,5,4,6,20,18,2,14,16,19
26088,8492,8498,4,16,15,3,3,9,16,26,-10,9,21,12
26089,8492,8498,12,11,15,5,3,7,17,22,-5,13,17,18
26090,8492,8498,53,14,15,3,7,5,18,28,-10,13,17,16
26091,8492,8498,43,2,15,8,5,2,36,20,16,21,9,29
26092,8492,8498,57,4,15,7,3,5,17,12,5,17,13,24
26093,8492,8498,24,13,15,3,9,3,18,21,-3,15,15,18
26094,8492,8498,37,1,15,11,4,0,30,15,15,26,4,37
26095,8492,8498,49,9,15,5,5,5,19,16,3,15,15,20
26096,8492,8498,13,3,15,8,4,3,30,17,13,20,10,28
26097,8492,8498,20,5,15,6,5,4,22,14,8,17,13,23
26098,8492,8498,41,12,15,5,3,7,16,23,-7,13,17,18
26099,8492,8498,56,15,15,3,6,6,16,21,-5,12,18,15
26100,8492,8498,19,6,15,6,4,5,23,20,3,16,14,22
26101,8492,8498,17,8,15,6,2,7,23,25,-2,14,16,20
26102,8492,8498,8,17,15,3,3,9,15,34,-19,9,21,12
26103,8492,8498,52,18,15,1,7,7,15,24,-9,9,21,10
26104,8499,8505,4,17,16,3,3,10,17,28,-11,9,23,12
26105,8499,8505,13,2,16,9,4,3,33,18,15,22,10,31
26106,8499,8505,20,6,16,6,5,5,23,17,6,17,15,23
26107,8499,8505,41,13,16,5,4,7,16,23,-7,14,18,19
26108,8499,8505,56,15,16,3,7,6,17,22,-5,13,19,16
26109,8499,8505,37,1,16,11,4,1,31,17,14,26,6,37
26110,8499,8505,49,7,16,6,5,5,21,17,4,17,15,23
26111,8499,8505,43,3,16,8,5,3,37,22,15,21,11,29
26112,8499,8505,57,4,16,8,3,5,19,13,6,19,13,27
26113,8499,8505,24,10,16,4,9,3,20,22,-2,17,15,21
26114,8499,8505,12,12,16,5,4,7,18,23,-5,14,18,19
26115,8499,8505,53,14,16,3,8,5,20,30,-10,14,18,17
26116,8499,8505,52,18,16,1,7,8,16,26,-10,9,23,10
26117,8499,8505,21,11,16,5,5,6,21,19,2,15,17,20
26118,8499,8505,8,16,16,3,4,9,16,35,-19,10,22,13
26119,8499,8505,1,5,16,6,7,3,25,19,6,19,13,25
26120,8499,8505,19,8,16,6,5,5,25,22,3,17,15,23
26121,8499,8505,17,9,16,6,3,7,23,25,-2,15,17,21
26122,8541,8547,1,5,19,8,7,4,34,22,12,23,15,31
26123,8541,8547,19,8,19,7,5,7,27,27,0,19,19,26
26124,8541,8547,17,13,19,6,3,10,24,33,-9,15,23,21
26125,8541,8547,8,17,19,4,4,11,18,41,-23,12,26,16
26126,8541,8547,21,12,19,5,8,6,26,24,2,18,20,23
26127,8541,8547,4,16,19,4,4,11,19,29,-10,12,26,16
26128,8541,8547,37,1,19,14,4,1,38,18,20,32,6,46
26129,8541,8547,49,4,19,9,5,5,30,21,9,23,15,32
26130,8541,8547,52,18,19,2,8,9,18,29,-11,12,26,14
26131,8541,8547,12,14,19,5,5,9,20,28,-8,15,23,20
26132,8541,8547,53,15,19,3,9,7,22,38,-16,15,23,18
26133,8541,8547,13,2,19,11,4,4,39,20,19,26,12,37
26134,8541,8547,20,7,19,7,5,7,28,25,3,19,19,26
26135,8541,8547,56,9,19,6,7,6,22,24,-2,19,19,25
26136,8541,8547,41,11,19,6,5,8,20,26,-6,17,21,23
26137,8541,8547,43,3,19,10,5,4,44,26,18,25,13,35
26138,8541,8547,57,6,19,8,4,7,22,18,4,20,18,28
26139,8541,8547,24,10,19,5,10,4,22,24,-2,20,18,25
26140,8555,8561,43,4,21,10,7,4,47,29,18,27,15,37
26141,8555,8561,57,6,21,9,4,8,24,20,4,22,20,31
26142,8555,8561,24,7,21,7,10,4,26,25,1,24,18,31
26143,8555,8561,13,2,21,13,4,4,43,21,22,30,12,43
26144,8555,8561,20,8,21,8,5,8,30,27,3,21,21,29
26145,8555,8561,56,11,21,6,7,8,22,27,-5,19,23,25
26146,8555,8561,41,12,21,6,5,10,21,30,-9,17,25,23
26147,8555,8561,12,12,21,6,5,10,21,30,-9,17,25,23
26148,8555,8561,53,15,21,4,9,8,28,41,-13,17,25,21
26149,8555,8561,52,17,21,3,8,10,20,31,-11,14,28,17
26150,8555,8561,37,1,21,15,5,1,43,22,21,35,7,50
26151,8555,8561,49,3,21,11,5,5,34,21,13,27,15,38
26152,8555,8561,21,9,21,7,8,6,33,27,6,22,20,29
26153,8555,8561,4,18,21,4,4,13,21,33,-12,12,30,16
26154,8555,8561,19,10,21,7,5,9,29,33,-4,19,23,26
26155,8555,8561,17,14,21,6,3,12,26,38,-12,15,27,21
26156,8555,8561,8,16,21,5,4,12,20,46,-26,14,28,19
26157,8555,8561,1,5,21,9,8,4,36,23,13,26,16,35
26158,11698,11704,22,14,6,1,2,3,6,8,-2,4,8,5
26159,11698,11704,57,18,6,0,2,4,10,17,-7,2,10,2
26160,11698,11704,20,10,6,2,1,3,11,12,-1,5,7,7
26161,11698,11704,35,11,6,2,1,3,12,14,-2,5,7,7
26162,11698,11704,41,15,6,1,1,4,8,18,-10,3,9,4
26163,11698,11704,6,16,6,1,1,4,6,17,-11,3,9,4
26164,11698,11704,27,4,6,4,0,2,15,9,6,8,4,12
26165,11698,11704,12,12,6,2,1,3,5,9,-4,5,7,7
26166,11698,11704,17,9,6,2,2,2,11,7,4,6,6,8
26167,11698,11704,52,17,6,0,4,2,6,8,-2,4,8,4
26168,12195,12201,27,3,21,13,3,5,44,28,16,29,13,42
26169,12195,12201,17,16,21,3,10,8,20,29,-9,16,26,19
26170,12195,12201,13,4,21,10,8,3,33,17,16,28,14,38
26171,12195,12201,6,8,21,7,7,7,28,28,0,21,21,28
26172,12195,12201,35,9,21,7,6,8,28,29,-1,20,22,27
26173,12195,12201,41,15,21,4,8,9,23,38,-15,16,26,20
26174,12195,12201,20,17,21,3,5,13,19,42,-23,11,31,14
26175,12195,12201,49,6,21,8,6,7,25,16,9,22,20,30
26176,12195,12201,37,12,21,5,9,7,25,26,-1,19,23,24
26177,12195,12201,43,1,21,15,4,2,53,23,30,34,8,49
26178,12195,12201,24,7,21,6,11,4,27,21,6,23,19,29
26179,12195,12201,57,13,21,5,7,9,32,44,-12,17,25,22
26180,12195,12201,22,18,21,1,6,14,23,52,-29,8,34,9
26181,12195,12201,52,14,21,5,5,11,22,33,-11,15,27,20
26182,12195,12201,21,5,21,9,8,4,30,23,7,26,16,35
26183,12195,12201,9,10,21,5,11,5,29,29,0,21,21,26
26184,12195,12201,4,11,21,5,10,6,31,32,-1,20,22,25
26185,12195,12201,1,2,21,12,8,1,32,14,18,32,10,44
26186,12041,12043,1,6,3,1,2,0,5,4,1,4,2,5
26187,12041,12043,9,14,3,0,3,0,3,3,0,3,3,3
26188,12041,12043,49,4,3,2,0,1,3,1,2,4,2,6
26189,12041,12043,37,15,3,0,3,0,2,2,0,3,3,3
26190,12041,12043,4,5,3,1,2,0,5,3,2,4,2,5
26191,12041,12043,21,8,3,1,1,1,5,5,0,3,3,4
26192,12041,12043,52,13,3,1,0,2,4,8,-4,2,4,3
26193,12041,12043,43,1,3,3,0,0,12,2,10,6,0,9
26194,12041,12043,35,7,3,1,1,1,5,4,1,3,3,4
26195,12041,12043,6,9,3,1,1,1,4,4,0,3,3,4
26196,12041,12043,41,10,3,1,1,1,2,7,-5,3,3,4
26197,12041,12043,20,17,3,0,1,2,4,9,-5,1,5,1
26198,12041,12043,27,2,3,3,0,0,7,3,4,6,0,9
26199,12041,12043,13,3,3,2,0,1,5,1,4,4,2,6
26200,12041,12043,17,12,3,1,0,2,3,4,-1,2,4,3
26201,12041,12043,24,11,3,1,0,2,4,4,0,2,4,3
26202,12041,12043,57,16,3,0,1,2,2,6,-4,1,5,1
26203,12041,12043,22,18,3,0,0,3,2,7,-5,0,6,0
26204,12300,12306,17,14,33,7,14,12,29,40,-11,28,38,35
26205,12300,12306,43,1,33,23,7,3,77,31,46,53,13,76
26206,12300,12306,24,8,33,10,14,9,39,39,0,34,32,44
26207,12300,12306,57,11,33,9,11,13,52,61,-9,29,37,38
26208,12300,12306,22,18,33,4,9,20,37,78,-41,17,49,21
26209,12300,12306,13,3,33,15,13,5,49,24,25,43,23,58
26210,12300,12306,35,10,33,11,9,13,48,47,1,31,35,42
26211,12300,12306,41,12,33,9,11,13,39,56,-17,29,37,38
26212,12300,12306,6,13,33,9,10,14,37,50,-13,28,38,37
26213,12300,12306,20,17,33,5,7,21,30,61,-31,17,49,22
26214,12300,12306,52,16,33,7,11,15,31,44,-13,25,41,32
26215,12300,12306,21,5,33,14,13,6,44,33,11,41,25,55
26216,12300,12306,9,7,33,10,15,8,43,39,4,35,31,45
26217,12300,12306,4,15,33,7,12,14,41,55,-14,26,40,33
26218,12300,12306,49,6,33,12,12,9,40,21,19,36,30,48
26219,12300,12306,37,9,33,11,10,12,41,39,2,32,34,43
26220,12300,12306,27,4,33,17,5,11,58,48,10,39,27,56
26221,12300,12306,1,2,33,19,13,1,49,18,31,51,15,70
26222,12048,12054,1,4,5,2,3,0,6,4,2,7,3,9
26223,12048,12054,17,13,5,1,2,2,3,4,-1,4,6,5
26224,12048,12054,49,5,5,2,2,1,4,2,2,6,4,8
26225,12048,12054,37,15,5,0,5,0,3,3,0,5,5,5
26226,12048,12054,21,7,5,2,1,2,7,9,-2,5,5,7
26227,12048,12054,9,8,5,1,4,0,9,5,4,6,4,7
26228,12048,12054,4,9,5,1,4,0,5,3,2,6,4,7
26229,12048,12054,52,16,5,1,1,3,5,11,-6,3,7,4
26230,12048,12054,6,2,5,3,1,1,10,6,4,7,3,10
26231,12048,12054,13,6,5,2,1,2,6,3,3,5,5,7
26232,12048,12054,35,10,5,1,3,1,7,6,1,5,5,6
26233,12048,12054,41,11,5,1,3,1,5,10,-5,5,5,6
26234,12048,12054,20,17,5,0,1,4,6,14,-8,1,9,1
26235,12048,12054,27,3,5,3,1,1,8,5,3,7,3,10
26236,12048,12054,43,1,5,5,0,0,20,5,15,10,0,15
26237,12048,12054,24,12,5,1,2,2,5,5,0,4,6,5
26238,12048,12054,57,14,5,1,2,2,8,11,-3,4,6,5
26239,12573,12579,24,7,21,8,4,9,24,28,-4,20,22,28
26240,12573,12579,57,16,21,6,5,10,26,36,-10,17,25,23
26241,12573,12579,52,9,21,7,7,7,23,25,-2,21,21,28
26242,12573,12579,28,11,21,6,8,7,21,25,-4,20,22,26
26243,12573,12579,27,14,21,6,7,8,20,29,-9,19,23,25
26244,12573,12579,1,2,21,14,4,3,53,21,32,32,10,46
26245,12573,12579,35,6,21,7,8,6,38,26,12,22,20,29
26246,12573,12579,13,8,21,7,7,7,33,27,6,21,21,28
26247,12573,12579,6,10,21,7,6,8,26,27,-1,20,22,27
26248,12573,12579,41,18,21,2,6,13,24,44,-20,10,32,12
26249,12573,12579,17,5,21,9,5,7,34,36,-2,23,19,32
26250,12825,12831,47,6,12,6,2,4,16,13,3,14,10,20
26251,12825,12831,6,17,12,1,3,8,12,23,-11,5,19,6
26252,12825,12831,20,18,12,1,3,8,9,26,-17,5,19,6
26253,12825,12831,35,11,12,3,5,4,17,15,2,11,13,14
26254,12825,12831,13,14,12,3,3,6,14,20,-6,9,15,12
26255,12825,12831,17,2,12,7,3,2,21,12,9,17,7,24
26256,12825,12831,1,1,12,8,2,2,27,9,18,18,6,26
26257,12825,12831,27,7,12,5,5,2,25,21,4,15,9,20
26258,12825,12831,49,4,12,5,6,1,19,9,10,16,8,21
26259,12825,12831,37,10,12,4,3,5,15,15,0,11,13,15
26260,12825,12831,43,3,12,6,3,3,23,14,9,15,9,21
26261,12825,12831,34,8,12,5,4,3,19,13,6,14,10,19
26262,12825,12831,24,9,12,4,4,4,16,22,-6,12,12,16
26263,12825,12831,57,12,12,2,8,2,14,17,-3,12,12,14
26264,12825,12831,21,13,12,3,3,6,15,19,-4,9,15,12
26265,12825,12831,4,16,12,2,4,6,14,21,-7,8,16,10
26266,12825,12831,28,15,12,3,3,6,14,24,-10,9,15,12
26267,12825,12831,52,5,12,5,6,1,13,10,3,16,8,21
26268,12937,12943,43,2,22,15,3,4,59,22,37,33,11,48
26269,12937,12943,57,5,22,8,9,5,35,30,5,25,19,33
26270,12937,12943,24,11,22,8,5,9,26,32,-6,21,23,29
26271,12937,12943,34,14,22,7,6,9,30,31,-1,20,24,27
26272,12937,12943,49,4,22,8,9,5,32,24,8,25,19,33
26273,12937,12943,37,17,22,4,7,11,20,33,-13,15,29,19
26274,12937,12943,21,9,22,8,5,9,29,29,0,21,23,29
26275,12937,12943,4,12,22,7,7,8,27,33,-6,21,23,28
26276,12937,12943,27,8,22,7,9,6,36,38,-2,23,21,30
26277,12937,12943,52,6,22,8,8,6,23,22,1,24,20,32
26278,12937,12943,28,15,22,6,5,11,26,42,-16,17,27,23
26279,12937,12943,1,1,22,15,5,2,53,19,34,35,9,50
26280,12937,12943,17,3,22,10,7,5,37,28,9,27,17,37
26281,12937,12943,35,7,22,8,7,7,34,28,6,23,21,31
26282,12937,12943,6,10,22,8,5,9,25,29,-4,21,23,29
26283,12937,12943,13,16,22,5,4,13,27,49,-22,14,30,19
26284,12937,12943,20,18,22,3,6,13,20,46,-26,12,32,15
26285,12937,12943,47,13,22,8,3,11,26,30,-4,19,25,27
26286,13259,13286,47,5,18,10,3,5,32,20,12,23,13,33
26287,13259,13286,6,8,18,8,5,5,28,28,0,21,15,29
26288,13259,13286,35,15,18,4,4,10,21,31,-10,12,24,16
26289,13259,13286,12,10,18,6,5,7,27,28,-1,17,19,23
26290,13259,13286,17,3,18,9,7,2,29,17,12,25,11,34
26291,13259,13286,1,2,18,11,4,3,36,19,17,26,10,37
26292,13259,13286,27,13,18,5,3,10,24,30,-6,13,23,18
26293,13259,13286,21,6,18,10,1,7,33,30,3,21,15,31
26294,13259,13286,4,9,18,7,3,8,30,35,-5,17,19,24
26295,13259,13286,33,1,18,11,5,2,34,16,18,27,9,38
26296,13259,13286,52,11,18,6,4,8,19,23,-4,16,20,22
26297,13259,13286,28,16,18,3,6,9,24,37,-13,12,24,15
26298,13259,13286,43,7,18,8,7,3,29,13,16,23,13,31
26299,13259,13286,22,12,18,4,8,6,19,24,-5,16,20,20
26300,13259,13286,24,14,18,4,6,8,18,27,-9,14,22,18
26301,13259,13286,34,17,18,2,8,8,21,34,-13,12,24,14
26302,13259,13286,57,18,18,1,5,12,17,39,-22,7,29,8
26303,13259,13286,49,4,18,11,0,7,32,22,10,22,14,33
26304,13301,13307,49,6,21,11,2,8,36,28,8,24,18,35
26305,13301,13307,33,1,21,12,7,2,38,18,20,31,11,43
26306,13301,13307,52,9,21,7,5,9,23,28,-5,19,23,26
26307,13301,13307,28,17,21,4,6,11,28,43,-15,14,28,18
26308,13301,13307,43,5,21,9,9,3,32,15,17,27,15,36
26309,13301,13307,22,10,21,6,8,7,25,27,-2,20,22,26
26310,13301,13307,24,14,21,5,8,8,22,30,-8,18,24,23
26311,13301,13307,34,16,21,4,8,9,26,37,-11,16,26,20
26312,13301,13307,57,18,21,2,6,13,23,45,-22,10,32,12
26313,13301,13307,21,7,21,11,2,8,34,31,3,24,18,35
26314,13301,13307,4,11,21,7,4,10,32,39,-7,18,24,25
26315,13301,13307,27,13,21,6,5,10,26,31,-5,17,25,23
26316,13301,13307,17,3,21,10,9,2,34,20,14,29,13,39
26317,13301,13307,12,12,21,6,6,9,30,34,-4,18,24,24
26318,15205,15211,40,12,32,10,8,14,35,52,-17,28,36,38
26319,15205,15211,34,17,32,4,8,20,28,68,-40,16,48,20
26320,15205,15211,17,15,32,8,8,16,51,62,-11,24,40,32
26321,15205,15211,27,10,32,11,6,15,38,56,-18,28,36,39
26322,15219,15316,27,12,34,11,6,17,40,63,-23,28,40,39
26323,15219,15316,17,15,34,9,8,17,55,65,-10,26,42,35
26324,15219,15316,22,1,34,20,12,2,85,43,42,52,16,72
26325,15219,15316,43,3,34,18,12,4,71,37,34,48,20,66
26326,15219,15316,40,11,34,12,8,14,41,52,-11,32,36,44
26327,15219,15316,34,17,34,4,9,21,32,73,-41,17,51,21
26328,15219,15316,49,5,34,15,12,7,57,38,19,42,26,57
26329,15219,15316,37,18,34,2,8,24,30,91,-61,12,56,14
26330,15219,15316,35,9,34,11,16,7,68,51,17,38,30,49
26331,15219,15316,6,13,34,10,9,15,54,66,-12,29,39,39
26332,15219,15316,33,6,34,17,5,12,68,40,28,39,29,56
26333,15219,15316,28,8,34,16,5,13,52,47,5,37,31,53
26334,15219,15316,52,10,34,13,5,16,50,59,-9,31,37,44
26335,15219,15316,1,2,34,22,4,8,74,41,33,48,20,70
26336,15219,15316,12,7,34,15,10,9,43,33,10,40,28,55
26337,15219,15316,25,14,34,9,9,16,49,61,-12,27,41,36
26338,15219,15316,4,4,34,16,10,8,62,51,11,42,26,58
26339,15219,15316,21,16,34,7,10,17,47,67,-20,24,44,31
26340,15387,15393,21,10,9,2,3,4,12,18,-6,7,11,9
26341,15387,15393,4,11,9,2,2,5,14,19,-5,6,12,8
26342,15387,15393,49,14,9,1,3,5,11,19,-8,5,13,6
26343,15387,15393,37,16,8,1,0,7,6,23,-17,2,14,3
26344,15387,15393,28,4,8,6,1,1,29,13,16,13,3,19
26345,15387,15393,33,8,9,3,2,4,19,24,-5,8,10,11
26346,15387,15393,12,3,8,6,2,0,21,11,10,14,2,20
26347,15387,15393,25,13,8,2,0,6,4,17,-13,4,12,6
26348,15387,15393,1,1,9,8,1,0,24,6,18,17,1,25
26349,15387,15393,17,5,8,5,2,1,17,5,12,12,4,17
26350,15387,15393,42,6,9,5,1,3,17,9,8,11,7,16
26351,15387,15393,35,12,8,2,2,4,13,18,-5,6,10,8
26352,15387,15393,43,2,9,6,2,1,23,11,12,14,4,20
26353,15387,15393,22,7,8,4,3,1,20,11,9,11,5,15
26354,15387,15393,40,9,8,2,3,3,10,9,1,7,9,9
26355,15387,15393,24,15,8,1,2,5,7,20,-13,4,12,5
26356,15387,15393,27,17,9,0,3,6,9,23,-14,3,15,3
26357,15681,15687,27,14,1,0,0,1,0,1,-1,0,2,0
26358,15681,15687,17,3,1,1,0,0,1,0,1,2,0,3
26359,15681,15687,42,14,1,0,0,1,0,1,-1,0,2,0
26360,15681,15687,12,8,1,0,1,0,0,0,0,1,1,1
26361,15681,15687,25,8,1,0,1,0,0,0,0,1,1,1
26362,15681,15687,33,6,1,0,1,0,2,2,0,1,1,1
26363,15681,15687,28,8,1,0,1,0,0,0,0,1,1,1
26364,15681,15687,49,6,1,0,1,0,2,2,0,1,1,1
26365,15681,15687,37,17,1,0,0,1,2,4,-2,0,2,0
26366,15681,15687,35,3,1,1,0,0,1,0,1,2,0,3
26367,15681,15687,43,2,1,1,0,0,3,1,2,2,0,3
26368,15681,15687,57,8,1,0,1,0,0,0,0,1,1,1
26369,15681,15687,40,8,1,0,1,0,0,0,0,1,1,1
26370,15681,15687,22,14,1,0,0,1,0,1,-1,0,2,0
26371,15681,15687,1,3,1,1,0,0,1,0,1,2,0,3
26372,15681,15687,4,1,1,1,0,0,4,2,2,2,0,3
26373,15681,15687,31,8,1,0,1,0,0,0,0,1,1,1
26374,15681,15687,21,18,1,0,0,1,1,3,-2,0,2,0
26375,15772,15785,4,9,12,3,7,2,14,12,2,13,11,16
26376,15772,15785,21,14,12,3,2,7,10,25,-15,8,16,11
26377,15772,15785,31,17,12,2,2,8,9,20,-11,6,18,8
26378,15772,15785,33,5,12,5,5,2,20,12,8,15,9,20
26379,15772,15785,28,6,12,5,4,3,18,16,2,14,10,19
26380,15772,15785,43,1,12,10,1,1,33,10,23,21,3,31
26381,15772,15785,22,3,12,7,3,2,25,15,10,17,7,24
26382,15772,15785,40,8,12,4,6,2,19,13,6,14,10,18
26383,15772,15785,57,10,12,3,6,3,10,14,-4,12,12,15
26384,15772,15785,35,12,12,3,4,5,9,14,-5,10,14,13
26385,15772,15785,49,2,12,8,1,3,24,10,14,17,7,25
26386,15772,15785,37,13,12,4,0,8,13,25,-12,8,16,12
26387,15772,15785,1,4,12,6,3,3,24,14,10,15,9,21
26388,15772,15785,25,7,12,5,4,3,17,18,-1,14,10,19
26389,15772,15785,12,15,12,2,3,7,14,23,-9,7,17,9
26390,15772,15785,17,11,12,3,5,4,14,16,-2,11,13,14
26391,15772,15785,42,16,12,1,6,5,10,19,-9,8,16,9
26392,15772,15785,27,18,12,1,4,7,5,12,-7,6,18,7
26393,15800,15806,27,18,15,2,4,9,7,16,-9,8,22,10
26394,15800,15806,17,13,15,4,5,6,16,19,-3,13,17,17
26395,15800,15806,42,17,15,2,6,7,12,23,-11,10,20,12
26396,15800,15806,25,7,15,6,4,5,18,22,-4,16,14,22
26397,15800,15806,12,14,15,3,3,9,17,26,-9,9,21,12
26398,11467,11473,43,1,20,13,5,2,39,10,29,31,9,44
26399,11467,11473,24,2,20,12,4,4,34,16,18,28,12,40
26400,11467,11473,57,7,20,8,7,5,35,31,4,23,17,31
26401,11467,11473,22,14,20,5,5,10,17,27,-10,15,25,20
26402,11467,11473,34,18,20,2,4,14,8,36,-28,8,32,10
26403,11467,11473,12,15,20,4,8,8,26,32,-6,16,24,20
26404,11467,11473,27,17,20,3,8,9,14,25,-11,14,26,17
26405,11467,11473,17,8,20,8,5,7,27,29,-2,21,19,29
26406,11467,11473,35,9,20,5,10,5,18,23,-5,20,20,25
26407,11467,11473,20,10,20,7,3,10,26,29,-3,17,23,24
26408,11488,11501,27,14,23,5,8,10,19,27,-8,18,28,23
26409,11488,11501,17,7,23,10,6,7,35,30,5,26,20,36
26410,11488,11501,12,10,23,6,9,8,29,32,-3,21,25,27
26411,11488,11501,43,1,23,14,6,3,44,13,31,34,12,48
26412,11488,11501,24,2,23,14,5,4,38,16,22,33,13,47
26413,11488,11501,57,8,23,8,10,5,41,37,4,26,20,34
26414,11488,11501,22,16,23,5,6,12,18,32,-14,16,30,21
26415,11488,11501,34,18,23,2,5,16,8,43,-35,9,37,11
26416,11488,11501,35,9,23,7,10,6,30,29,1,24,22,31
26417,11488,11501,20,11,23,7,5,11,31,37,-6,19,27,26
26418,11488,11501,52,12,23,6,6,11,24,33,-9,18,28,24
26419,11488,11501,41,15,23,4,10,9,21,31,-10,18,28,22
26420,11488,11501,56,17,23,4,7,12,21,48,-27,15,31,19
26421,11488,11501,49,4,23,11,11,1,38,17,21,33,13,44
26422,11488,11501,37,13,23,5,9,9,28,32,-4,19,27,24
26423,11488,11501,21,5,23,12,2,9,32,30,2,26,20,38
26424,11488,11501,4,6,23,10,6,7,37,32,5,26,20,36
26425,11488,11501,1,3,23,12,9,2,41,16,25,33,13,45
26426,11530,11536,1,2,27,15,10,2,49,18,31,40,14,55
26427,11530,11536,21,5,27,14,3,10,37,34,3,31,23,45
26428,11530,11536,4,6,27,12,7,8,43,37,6,31,23,43
26429,11530,11536,37,14,27,5,11,11,31,38,-7,21,33,26
26430,11530,11536,52,10,27,9,6,12,30,36,-6,24,30,33
26431,11530,11536,35,9,27,9,10,8,36,36,0,28,26,37
26432,11530,11536,20,12,27,9,5,13,41,49,-8,23,31,32
26433,11530,11536,41,15,27,5,11,11,25,34,-9,21,33,26
26434,11530,11536,56,17,27,5,7,15,27,59,-32,17,37,22
26435,11530,11536,43,1,27,18,6,3,55,16,39,42,12,60
26436,11530,11536,24,4,27,14,8,5,39,18,21,36,18,50
26437,11530,11536,57,8,27,9,12,6,44,39,5,30,24,39
26438,11530,11536,22,16,27,5,9,13,19,35,-16,19,35,24
26439,11530,11536,34,18,27,2,6,19,11,52,-41,10,44,12
26440,11530,11536,12,11,27,8,9,10,35,38,-3,25,29,33
26441,11530,11536,27,13,27,6,8,13,22,34,-12,20,34,26
26442,11530,11536,17,7,27,12,6,9,42,37,5,30,24,42
26443,11530,11536,49,3,27,13,12,2,43,19,24,38,16,51
26444,11572,11578,27,15,32,8,8,16,30,42,-12,24,40,32
26445,11572,11578,17,7,32,13,9,10,49,42,7,35,29,48
26446,11572,11578,12,13,32,8,10,14,36,48,-12,26,38,34
26447,11572,11578,43,1,32,21,7,4,64,22,42,49,15,70
26448,11572,11578,24,4,32,14,13,5,40,19,21,41,23,55
26449,11572,11578,57,9,32,10,13,9,52,50,2,33,31,43
26450,11572,11578,22,16,32,6,10,16,26,44,-18,22,42,28
26451,11572,11578,34,18,32,4,7,21,17,60,-43,15,49,19
26452,11572,11578,52,11,32,10,7,15,35,44,-9,27,37,37
26453,11572,11578,35,8,32,12,10,10,51,44,7,34,30,46
26454,11572,11578,20,10,32,11,7,14,45,52,-7,29,35,40
26455,11572,11578,41,14,32,7,13,12,32,41,-9,27,37,34
26456,11572,11578,56,17,32,5,10,17,31,66,-35,20,44,25
26457,11572,11578,49,3,32,15,13,4,50,25,25,43,21,58
26458,11572,11578,37,12,32,8,11,13,40,48,-8,27,37,35
26459,11572,11578,21,5,32,16,5,11,43,39,4,37,27,53
26460,11572,11578,4,6,32,14,9,9,50,43,7,37,27,51
26461,11572,11578,1,2,32,20,10,2,60,22,38,50,14,70
26462,11754,11767,1,3,12,7,2,3,15,7,8,16,8,23
26463,11754,11767,4,7,12,6,2,4,19,13,6,14,10,20
26464,11754,11767,21,9,12,5,1,6,19,25,-6,11,13,16
26465,11754,11767,27,4,12,7,1,4,27,20,7,15,9,22
26466,11754,11767,49,2,12,9,1,2,28,16,12,19,5,28
26467,11754,11767,37,8,12,6,2,4,14,14,0,14,10,20
26468,11754,11767,14,13,12,4,0,8,22,30,-8,8,16,12
26469,11754,11767,20,6,12,6,2,4,31,20,11,14,10,20
26470,11754,11767,35,16,12,3,2,7,20,31,-11,8,16,11
26471,11754,11767,41,17,12,3,2,7,17,29,-12,8,16,11
26472,11754,11767,6,18,12,1,1,10,10,33,-23,3,21,4
26473,11754,11767,52,10,12,3,7,2,18,13,5,13,11,16
26474,11754,11767,12,15,12,3,2,7,11,20,-9,8,16,11
26475,11754,11767,43,1,12,10,1,1,29,10,19,21,3,31
26476,15800,15806,1,5,15,7,3,5,29,21,8,17,13,24
26477,15800,15806,49,2,15,10,2,3,31,12,19,22,8,32
26478,15800,15806,37,12,15,6,0,9,20,27,-7,12,18,18
26479,15800,15806,35,6,15,6,4,5,13,14,-1,16,14,22
26480,15800,15806,43,1,15,13,1,1,38,11,27,27,3,40
26481,15800,15806,22,3,15,8,3,4,30,19,11,19,11,27
26482,15800,15806,40,10,15,4,8,3,20,17,3,16,14,20
26483,15800,15806,57,11,15,4,7,4,11,18,-7,15,15,19
26484,15800,15806,33,4,15,7,5,3,27,17,10,19,11,26
26485,15800,15806,28,9,15,5,6,4,18,20,-2,16,14,21
26486,15800,15806,4,8,15,5,7,3,18,13,5,17,13,22
26487,15800,15806,31,15,15,3,3,9,13,24,-11,9,21,12
26488,15800,15806,21,16,15,3,3,9,11,30,-19,9,21,12
26489,15730,15736,4,5,7,3,3,1,13,9,4,9,5,12
26490,15730,15736,21,13,7,2,1,4,4,14,-10,5,9,7
26491,15730,15736,31,17,7,0,2,5,2,11,-9,2,12,2
26492,15730,15736,25,11,7,2,3,2,10,12,-2,7,7,9
26493,15730,15736,12,18,7,0,2,5,4,15,-11,2,12,2
26494,15730,15736,1,2,7,4,2,1,16,7,9,10,4,14
26495,15730,15736,43,1,7,7,0,0,25,5,20,14,0,21
26496,15730,15736,22,3,7,4,2,1,13,6,7,10,4,14
26497,15730,15736,40,9,7,2,4,1,8,5,3,8,6,10
26498,15730,15736,57,12,7,2,3,2,3,6,-3,7,7,9
26499,15730,15736,35,10,7,2,3,2,7,5,2,7,7,9
26500,15730,15736,49,8,7,3,1,3,8,8,0,7,7,10
26501,15730,15736,37,14,7,2,0,5,9,16,-7,4,10,6
26502,15730,15736,33,4,7,3,3,1,14,9,5,9,5,12
26503,15730,15736,28,6,7,3,3,1,9,7,2,9,5,12
26504,15730,15736,17,7,7,3,2,2,10,9,1,8,6,11
26505,15730,15736,42,16,7,0,4,3,5,12,-7,4,10,4
26506,15730,15736,27,15,7,0,4,3,2,6,-4,4,10,4
26507,15751,15757,27,17,9,0,4,5,2,8,-6,4,14,4
26508,15751,15757,17,8,9,3,4,2,11,10,1,10,8,13
26509,15751,15757,42,14,9,1,5,3,7,13,-6,7,11,8
26510,15751,15757,33,5,9,4,4,1,16,10,6,12,6,16
26511,15751,15757,28,9,9,3,4,2,10,9,1,10,8,13
26512,15751,15757,49,4,9,5,1,3,14,8,6,11,7,16
26513,15751,15757,37,13,9,3,0,6,11,18,-7,6,12,9
26514,15751,15757,35,6,9,3,4,2,9,6,3,10,8,13
26515,15751,15757,43,1,9,8,1,0,27,6,21,17,1,25
26516,15751,15757,22,2,9,6,2,1,19,8,11,14,4,20
26517,15751,15757,40,11,9,2,6,1,10,7,3,10,8,12
26518,15751,15757,57,12,9,2,4,3,4,9,-5,8,10,10
26519,15751,15757,1,3,9,5,3,1,21,8,13,13,5,18
26520,15751,15757,25,10,9,3,3,3,12,16,-4,9,9,12
26521,15751,15757,12,16,9,1,2,6,8,18,-10,4,14,5
26522,15751,15757,4,7,9,3,4,2,13,11,2,10,8,13
26523,15751,15757,21,15,9,2,1,6,4,19,-15,5,13,7
26524,15751,15757,31,18,9,0,2,7,2,16,-14,2,16,2
26525,16129,16135,4,3,11,7,0,4,21,17,4,14,8,21
26526,16129,16135,9,18,11,0,4,7,10,22,-12,4,18,4
26527,16129,16135,33,12,11,4,3,4,12,12,0,11,11,15
26528,16129,16135,28,15,11,2,3,6,8,17,-9,7,15,9
26529,16129,16135,27,5,11,6,1,4,14,15,-1,13,9,19
26530,16129,16135,49,7,11,5,2,4,14,13,1,12,10,17
26531,16129,16135,37,11,11,4,3,4,17,13,4,11,11,15
26532,16129,16135,46,16,11,2,1,8,8,20,-12,5,17,7
26533,16129,16135,1,1,11,9,2,0,30,5,25,20,2,29
26534,16129,16135,35,14,11,3,1,7,11,16,-5,7,15,10
26535,16129,16135,17,9,11,5,1,5,19,18,1,11,11,16
26536,16129,16135,42,17,11,1,3,7,9,20,-11,5,17,6
26537,16129,16135,12,6,11,5,3,3,14,12,2,13,9,18
26538,16129,16135,25,13,11,4,2,5,10,14,-4,10,12,14
26539,16129,16135,43,2,11,8,1,2,26,13,13,17,5,25
26540,16129,16135,40,4,11,6,2,3,20,10,10,14,8,20
26541,16129,16135,22,8,11,4,5,2,12,12,0,13,9,17
26542,16129,16135,57,10,11,5,1,5,20,26,-6,11,11,16
26543,16234,16240,25,8,22,10,3,9,22,31,-9,23,21,33
26544,16234,16240,12,9,22,8,7,7,26,26,0,23,21,31
26545,16234,16240,17,10,22,8,4,10,38,40,-2,20,24,28
26546,16234,16240,42,16,22,5,3,14,28,39,-11,13,31,18
26547,16234,16240,27,5,22,11,6,5,29,22,7,28,16,39
26548,16234,16240,33,13,22,6,5,11,31,32,-1,17,27,23
26549,16234,16240,28,15,22,5,5,12,24,40,-16,15,29,20
26550,16234,16240,49,3,22,13,4,5,38,21,17,30,14,43
26551,16234,16240,37,11,22,7,5,10,31,37,-6,19,25,26
26552,16234,16240,46,18,22,4,2,16,18,42,-24,10,34,14
26553,16234,16240,35,14,22,5,5,12,20,27,-7,15,29,20
26554,16234,16240,43,2,22,15,3,4,46,22,24,33,11,48
26555,16234,16240,22,4,22,12,6,4,32,21,11,30,14,42
26556,12048,12054,22,18,5,0,0,5,5,16,-11,0,10,0
26557,12055,12061,43,1,6,6,0,0,24,8,16,12,0,18
26558,12055,12061,24,12,6,1,3,2,6,6,0,5,7,6
26559,12055,12061,57,14,6,1,3,2,9,12,-3,5,7,6
26560,12055,12061,22,18,6,0,1,5,8,19,-11,1,11,1
26561,12055,12061,27,4,6,3,1,2,8,6,2,7,5,10
26562,12055,12061,6,3,6,3,2,1,11,7,4,8,4,11
26563,12055,12061,35,5,6,2,3,1,8,6,2,7,5,9
26564,12055,12061,13,6,6,2,2,2,7,4,3,6,6,8
26565,12055,12061,41,11,6,1,4,1,5,10,-5,6,6,7
26566,12055,12061,20,17,6,0,2,4,6,14,-8,2,10,2
26567,12055,12061,52,16,6,1,1,4,8,15,-7,3,9,4
26568,12055,12061,21,8,6,2,2,2,7,9,-2,6,6,8
26569,12055,12061,9,9,6,1,5,0,9,5,4,7,5,8
26570,12055,12061,4,10,6,1,5,0,8,6,2,7,5,8
26571,12055,12061,49,7,6,2,2,2,4,3,1,6,6,8
26572,12055,12061,37,15,6,0,6,0,4,4,0,6,6,6
26573,12055,12061,17,13,6,1,3,2,4,5,-1,5,7,6
26574,12055,12061,1,2,6,3,3,0,7,4,3,9,3,12
26575,12405,12411,1,8,1,0,1,0,1,1,0,1,1,1
26576,12405,12411,49,1,1,1,0,0,3,1,2,2,0,3
26577,12405,12411,27,17,1,0,0,1,0,1,-1,0,2,0
26578,12405,12411,4,4,1,1,0,0,2,1,1,2,0,3
26579,12405,12411,13,4,1,1,0,0,2,1,1,2,0,3
26580,12405,12411,41,8,1,0,1,0,1,1,0,1,1,1
26581,12405,12411,6,12,1,0,0,1,2,3,-1,0,2,0
26582,12405,12411,35,12,1,0,0,1,2,3,-1,0,2,0
26583,12405,12411,34,2,1,1,0,0,3,2,1,2,0,3
26584,12405,12411,57,4,1,1,0,0,2,1,1,2,0,3
26585,12405,12411,24,7,1,1,0,0,1,0,1,2,0,3
26586,12405,12411,43,14,1,0,0,1,1,2,-1,0,2,0
26587,12405,12411,17,2,1,1,0,0,3,2,1,2,0,3
26588,12405,12411,37,14,1,0,0,1,1,2,-1,0,2,0
26589,12405,12411,52,8,1,0,1,0,1,1,0,1,1,1
26590,12405,12411,28,8,1,0,1,0,1,1,0,1,1,1
26591,12405,12411,9,14,1,0,0,1,1,2,-1,0,2,0
26592,12405,12411,21,18,1,0,0,1,1,3,-2,0,2,0
26593,12468,12474,28,12,9,3,2,4,8,12,-4,8,10,11
26594,12468,12474,52,13,9,2,5,2,11,12,-1,9,9,11
26595,12468,12474,17,3,9,5,1,3,21,14,7,11,7,16
26596,12468,12474,43,2,9,6,2,1,21,12,9,14,4,20
26597,12468,12474,24,4,9,5,1,3,12,9,3,11,7,16
26598,12468,12474,34,8,9,4,1,4,17,20,-3,9,9,13
26599,12468,12474,57,14,9,3,1,5,8,13,-5,7,11,10
26600,12468,12474,13,7,9,4,2,3,16,11,5,10,8,14
26601,12468,12474,35,9,9,3,3,3,20,13,7,9,9,12
26602,12468,12474,6,17,9,2,1,6,8,16,-8,5,13,7
26603,12468,12474,41,18,9,0,4,5,11,22,-11,4,14,4
26604,12468,12474,1,6,9,4,2,3,19,11,8,10,8,14
26605,12468,12474,49,1,9,6,2,1,16,6,10,14,4,20
26606,12468,12474,37,5,9,5,0,4,15,14,1,10,8,15
26607,12468,12474,4,10,9,3,3,3,11,13,-2,9,9,12
26608,12468,12474,21,11,9,3,2,4,13,15,-2,8,10,11
26609,12468,12474,9,15,9,3,1,5,10,17,-7,7,11,10
26610,12468,12474,27,16,9,2,3,4,7,14,-7,7,11,9
26611,12888,12894,27,5,19,7,7,5,35,36,-1,21,17,28
26612,12888,12894,49,9,19,6,8,5,26,21,5,20,18,26
26613,12888,12894,37,16,19,4,6,9,19,29,-10,14,24,18
26614,12888,12894,21,11,19,7,3,9,27,28,-1,17,21,24
26615,12888,12894,4,14,19,5,7,7,21,26,-5,17,21,22
26616,12888,12894,52,4,19,8,7,4,22,17,5,23,15,31
26617,12888,12894,28,15,19,5,5,9,24,35,-11,15,23,20
26618,12888,12894,35,10,19,6,7,6,29,23,6,19,19,25
26619,12888,12894,6,13,19,6,4,9,22,29,-7,16,22,22
26620,12888,12894,13,17,19,4,4,11,24,38,-14,12,26,16
26621,12888,12894,20,18,19,3,5,11,16,36,-20,11,27,14
26622,12888,12894,43,2,19,12,3,4,43,20,23,27,11,39
26623,12888,12894,57,6,19,6,9,4,24,25,-1,21,17,27
26624,12888,12894,34,7,19,7,5,7,29,28,1,19,19,26
26625,12888,12894,24,8,19,7,5,7,23,28,-5,19,19,26
26626,12888,12894,17,3,19,10,6,3,35,23,12,26,12,36
26627,12888,12894,1,1,19,12,5,2,43,16,27,29,9,41
26628,12888,12894,47,12,19,7,2,10,23,27,-4,16,22,23
26629,12762,12764,47,3,2,2,0,0,5,2,3,4,0,6
26630,12762,12764,1,5,2,2,0,0,4,1,3,4,0,6
26631,12762,12764,21,8,2,1,0,1,5,4,1,2,2,3
26632,12762,12764,4,12,2,0,1,1,4,6,-2,1,3,1
26633,12762,12764,17,15,2,0,0,2,1,4,-3,0,4,0
26634,12762,12764,27,1,2,2,0,0,6,2,4,4,0,6
26635,12762,12764,20,7,2,1,1,0,4,2,2,3,1,4
26636,12762,12764,35,11,2,0,1,1,2,3,-1,1,3,1
26637,12762,12764,6,14,2,0,0,2,0,2,-2,0,4,0
26638,14337,14343,43,1,16,12,3,1,44,19,25,27,5,39
26639,14337,14343,22,2,16,10,5,1,43,20,23,25,7,35
26640,14337,14343,34,8,16,7,2,7,30,25,5,16,16,23
26641,14337,14343,24,11,16,6,2,8,23,40,-17,14,18,20
26642,14337,14343,58,17,16,1,8,7,11,29,-18,10,22,11
26643,14337,14343,49,9,16,7,2,7,24,28,-4,16,16,23
26644,14337,14343,25,7,16,7,4,5,34,34,0,18,14,25
26645,14337,14343,12,13,16,4,5,7,26,33,-7,13,19,17
26646,14806,14819,43,1,26,20,5,1,70,21,49,45,7,65
26647,14806,14819,22,11,26,8,7,11,31,36,-5,23,29,31
26648,14806,14819,34,14,26,6,6,14,26,53,-27,18,34,24
26649,14806,14819,40,17,26,3,9,14,22,46,-24,15,37,18
26650,14806,14819,24,18,26,3,7,16,31,58,-27,13,39,16
26651,14806,14819,49,3,26,13,9,4,61,31,30,35,17,48
26652,14806,14819,37,12,26,8,7,11,24,49,-25,23,29,31
26653,14806,14819,1,2,26,17,8,1,67,20,47,42,10,59
26654,14806,14819,4,4,26,13,7,6,48,36,12,33,19,46
26655,14806,14819,21,13,26,8,4,14,29,38,-9,20,32,28
26656,14806,14819,27,9,26,11,4,11,40,46,-6,26,26,37
26657,14806,14819,33,5,26,13,5,8,51,34,17,31,21,44
26658,14806,14819,28,16,26,4,6,16,24,44,-20,14,38,18
26659,14806,14819,17,10,26,10,6,10,35,32,3,26,26,36
26660,14806,14819,35,7,26,13,3,10,47,37,10,29,23,42
26661,14806,14819,12,6,26,12,7,7,39,32,7,31,21,43
26662,14806,14819,25,8,26,12,6,8,47,40,7,30,22,42
26663,14806,14819,47,15,26,6,2,18,29,68,-39,14,38,20
26664,15037,15057,17,12,12,3,4,5,14,17,-3,10,14,13
26665,15037,15057,35,9,12,4,4,4,26,20,6,12,12,16
26666,15037,15057,6,13,12,3,4,5,21,29,-8,10,14,13
26667,15037,15057,12,4,12,7,1,4,19,12,7,15,9,22
26668,15037,15057,25,14,12,3,2,7,17,20,-3,8,16,11
26669,15037,15057,28,7,12,5,3,4,21,18,3,13,11,18
26670,15037,15057,33,10,12,5,0,7,23,16,7,10,14,15
26671,15037,15057,52,16,12,3,2,7,13,20,-7,8,16,11
26672,15037,15057,27,8,12,5,2,5,12,16,-4,12,12,17
26673,15037,15057,1,2,12,9,1,2,28,12,16,19,5,28
26674,15037,15057,49,6,12,6,4,2,18,13,5,16,8,22
26675,15037,15057,37,18,12,1,4,7,10,31,-21,6,18,7
26676,15037,15057,4,1,12,9,2,1,24,13,11,20,4,29
26677,15037,15057,21,15,12,3,2,7,17,22,-5,8,16,11
26678,15037,15057,22,3,12,7,4,1,33,15,18,18,6,25
26679,15037,15057,43,5,12,6,4,2,24,14,10,16,8,22
26680,15037,15057,34,11,12,4,1,7,12,29,-17,9,15,13
26681,15037,15057,40,17,12,2,2,8,12,27,-15,6,18,8
26682,15177,15183,22,1,28,17,10,1,76,37,39,44,12,61
26683,15177,15183,43,3,28,15,10,3,60,29,31,40,16,55
26684,15177,15183,40,12,28,8,8,12,33,50,-17,24,32,32
26685,15177,15183,34,17,28,4,7,17,24,61,-37,15,41,19
26686,15177,15183,49,5,28,13,9,6,50,33,17,35,21,48
26687,15177,15183,35,9,28,8,13,7,54,44,10,29,27,37
26688,15177,15183,6,14,28,8,7,13,45,56,-11,23,33,31
26689,15177,15183,37,18,28,2,8,18,29,74,-45,12,44,14
26690,15177,15183,4,6,28,13,8,7,48,41,7,34,22,47
26691,15177,15183,21,16,28,6,8,14,39,55,-16,20,36,26
26692,15177,15183,27,11,28,9,6,13,33,50,-17,24,32,33
26693,15177,15183,33,4,28,15,4,9,59,32,27,34,22,49
26694,15177,15183,28,8,28,12,4,12,41,42,-1,28,28,40
26695,15177,15183,52,10,28,10,4,14,37,47,-10,24,32,34
26696,15177,15183,12,7,28,13,7,8,37,29,8,33,23,46
26697,15177,15183,25,15,28,8,6,14,43,52,-9,22,34,30
26698,15177,15183,17,13,28,8,7,13,49,55,-6,23,33,31
26699,15177,15183,1,2,28,19,2,7,64,34,30,40,16,59
26700,15016,15022,17,11,9,3,3,3,10,11,-1,9,9,12
26701,15016,15022,12,8,9,4,1,4,13,9,4,9,9,13
26702,15016,15022,25,13,9,3,1,5,15,16,-1,7,11,10
26703,15016,15022,6,12,9,3,3,3,16,20,-4,9,9,12
26704,15016,15022,35,14,9,2,4,3,18,16,2,8,10,10
26705,15016,15022,28,6,9,4,3,2,16,13,3,11,7,15
26706,15016,15022,33,10,9,4,0,5,18,12,6,8,10,12
26707,15016,15022,52,16,9,1,1,7,8,17,-9,3,15,4
26708,15016,15022,27,7,9,4,2,3,9,10,-1,10,8,14
26709,15016,15022,1,2,9,7,0,2,20,9,11,14,4,21
26710,15016,15022,49,5,9,5,3,1,15,9,6,13,5,18
26711,15016,15022,37,17,9,0,3,6,6,25,-19,3,15,3
26712,15016,15022,22,3,9,5,3,1,25,12,13,13,5,18
26713,15016,15022,43,4,9,5,3,1,20,10,10,13,5,18
26714,15016,15022,34,9,9,4,1,4,11,19,-8,9,9,13
26715,15016,15022,40,18,9,0,2,7,8,25,-17,2,16,2
26716,15016,15022,4,1,9,7,1,1,17,9,8,15,3,22
26717,13301,13307,6,8,21,9,6,6,31,32,-1,24,18,33
26718,13301,13307,47,4,21,11,4,6,36,23,13,26,16,37
26719,13301,13307,35,15,21,5,5,11,25,35,-10,15,27,20
26720,13301,13307,1,2,21,12,4,5,41,26,15,28,14,40
26721,13406,13412,47,9,33,12,10,11,48,40,8,34,32,46
26722,13406,13412,6,4,33,16,8,9,47,45,2,40,26,56
26723,13406,13412,35,10,33,12,7,14,50,54,-4,31,35,43
26724,13406,13412,12,13,33,10,7,16,38,54,-16,27,39,37
26725,13406,13412,17,1,33,20,10,3,67,38,29,50,16,70
26726,13406,13412,27,12,33,10,7,16,43,55,-12,27,39,37
26727,13406,13412,1,2,33,21,5,7,68,34,34,47,19,68
26728,13406,13412,49,7,33,16,2,15,55,52,3,34,32,50
26729,13406,13412,43,5,33,15,10,8,57,36,21,40,26,55
26730,13406,13412,33,3,33,17,9,7,60,38,22,43,23,60
26731,13406,13412,28,11,33,10,8,15,45,55,-10,28,38,38
26732,13406,13412,52,16,33,8,10,15,30,41,-11,26,40,34
26733,13406,13412,22,8,33,13,8,12,48,42,6,34,32,47
26734,13406,13412,34,15,33,8,11,14,44,55,-11,27,39,35
26735,13406,13412,24,17,33,7,10,16,33,53,-20,24,42,31
26736,13406,13412,57,18,33,5,9,19,33,66,-33,19,47,24
26737,13406,13412,21,6,33,16,5,12,48,43,5,37,29,53
26738,13406,13412,4,14,33,10,6,17,44,57,-13,26,40,36
26739,13679,13685,4,9,22,7,8,7,33,32,1,22,22,29
26740,13679,13685,21,18,22,3,4,15,25,46,-21,10,34,13
26741,13679,13685,49,14,22,6,7,9,29,32,-3,19,25,25
26742,13679,13685,37,17,22,3,7,12,20,38,-18,13,31,16
26743,13679,13685,33,15,22,5,6,11,22,34,-12,16,28,21
26744,13679,13685,52,16,22,5,4,13,26,54,-28,14,30,19
26745,13679,13685,28,10,22,7,8,7,23,24,-1,22,22,29
26746,13679,13685,12,6,22,11,0,11,43,46,-3,22,22,33
26747,13679,13685,25,13,22,6,8,8,32,37,-5,20,24,26
26748,13679,13685,1,1,22,19,3,0,56,17,39,41,3,60
26749,13679,13685,27,12,22,7,5,10,31,41,-10,19,25,26
26750,13679,13685,17,8,22,8,6,8,34,31,3,22,22,30
26751,13679,13685,22,2,22,13,4,5,47,29,18,30,14,43
26752,13679,13685,43,5,22,10,5,7,32,25,7,25,19,35
26753,13679,13685,34,11,22,7,6,9,34,36,-2,20,24,27
26754,13679,13685,47,4,22,10,9,3,40,22,18,29,15,39
26755,13679,13685,35,3,22,12,5,5,40,27,13,29,15,41
26756,13679,13685,6,7,22,9,5,8,35,31,4,23,21,32
26757,13686,13692,35,3,23,12,5,6,42,30,12,29,17,41
26758,13686,13692,6,8,23,9,5,9,35,34,1,23,23,32
26759,13686,13692,33,15,23,5,7,11,24,36,-12,17,29,22
26760,13686,13692,52,16,23,5,4,14,26,56,-30,14,32,19
26761,13686,13692,47,4,23,10,9,4,40,23,17,29,17,39
26762,13686,13692,1,1,23,20,3,0,58,17,41,43,3,63
26763,13686,13692,12,6,23,11,1,11,44,47,-3,23,23,34
26764,13686,13692,25,14,23,6,9,8,32,37,-5,21,25,27
26765,13686,13692,17,7,23,9,6,8,35,31,4,24,22,33
26766,13686,13692,27,10,23,8,5,10,34,43,-9,21,25,29
26767,13686,13692,28,11,23,7,8,8,23,25,-2,22,24,29
26768,13686,13692,49,12,23,7,7,9,32,32,0,21,25,28
26769,13686,13692,37,17,23,4,7,12,21,38,-17,15,31,19
26770,13686,13692,22,2,23,14,4,5,50,29,21,32,14,46
26771,13686,13692,43,5,23,10,6,7,34,27,7,26,20,36
26772,13686,13692,34,13,23,7,6,10,34,39,-5,20,26,27
26773,13686,13692,4,9,23,7,9,7,34,33,1,23,23,30
26774,13686,13692,21,18,23,3,5,15,25,46,-21,11,35,14
26775,13728,13734,4,9,28,8,12,8,38,37,1,28,28,36
26776,13728,13734,21,18,28,5,6,17,29,52,-23,16,40,21
26777,13728,13734,49,10,28,8,10,10,38,38,0,26,30,34
26778,13728,13734,37,16,28,5,8,15,23,44,-21,18,38,23
26779,13728,13734,22,2,28,19,4,5,60,29,31,42,14,61
26780,13728,13734,43,5,28,13,7,8,46,33,13,33,23,46
26781,13728,13734,34,13,28,8,7,13,42,53,-11,23,33,31
26782,13728,13734,28,12,28,8,10,10,26,31,-5,26,30,34
26783,13728,13734,33,15,28,7,7,14,30,42,-12,21,35,28
26784,13728,13734,52,17,28,6,4,18,29,65,-36,16,40,22
26785,13728,13734,12,6,28,14,2,12,57,56,1,30,26,44
26786,13728,13734,25,11,28,8,10,10,42,46,-4,26,30,34
26787,13728,13734,27,14,28,8,7,13,39,52,-13,23,33,31
26788,13728,13734,6,8,28,10,7,11,42,42,0,27,29,37
26789,13728,13734,1,1,28,23,4,1,64,23,41,50,6,73
26790,13728,13734,47,4,28,13,9,6,45,26,19,35,21,48
26791,13728,13734,17,7,28,12,6,10,45,37,8,30,26,42
26792,13728,13734,35,3,28,14,6,8,51,40,11,34,22,48
26793,13735,13741,17,7,29,12,7,10,46,38,8,31,27,43
26794,13735,13741,47,5,29,13,9,7,45,27,18,35,23,48
26795,11754,11767,24,5,12,7,0,5,21,16,5,14,10,21
26796,11754,11767,22,12,12,3,4,5,13,12,1,10,14,13
26797,11754,11767,57,14,12,3,3,6,29,33,-4,9,15,12
26798,11754,11767,17,11,12,4,3,5,18,19,-1,11,13,15
26799,11922,11928,49,2,31,15,9,7,55,37,18,39,23,54
26800,11922,11928,37,7,31,14,6,11,43,37,6,34,28,48
26801,11922,11928,27,8,31,13,8,10,50,44,6,34,28,47
26802,11922,11928,41,12,31,10,7,14,44,61,-17,27,35,37
26803,11922,11928,35,14,31,9,7,15,50,61,-11,25,37,34
26804,11922,11928,6,16,31,7,4,20,36,72,-36,18,44,25
26805,11922,11928,22,13,31,8,11,12,35,39,-4,27,35,35
26806,11922,11928,57,15,31,8,9,14,60,70,-10,25,37,33
26807,11922,11928,24,3,31,16,5,10,46,32,14,37,25,53
26808,11922,11928,12,18,31,4,9,18,27,53,-26,17,45,21
26809,11922,11928,52,11,31,10,11,10,39,37,2,31,31,41
26810,11922,11928,20,4,31,15,8,8,70,42,28,38,24,53
26811,11922,11928,43,1,31,24,6,1,73,21,52,54,8,78
26812,11922,11928,14,17,31,6,5,20,37,88,-51,17,45,23
26813,11922,11928,21,5,31,15,6,10,55,41,14,36,26,51
26814,11922,11928,4,9,31,12,9,10,45,39,6,33,29,45
26815,11922,11928,17,10,31,12,6,13,41,44,-3,30,32,42
26816,11922,11928,1,6,31,14,8,9,43,31,12,36,26,50
26817,11705,11711,1,3,7,5,0,2,12,6,6,10,4,15
26818,11705,11711,4,4,7,4,1,2,13,5,8,9,5,13
26819,11705,11711,21,5,7,4,1,2,16,13,3,9,5,13
26820,11705,11711,49,2,7,5,1,1,13,7,6,11,3,16
26821,11705,11711,37,6,7,4,1,2,8,8,0,9,5,13
26822,11705,11711,14,14,7,2,0,5,13,20,-7,4,10,6
26823,11705,11711,35,9,7,3,1,3,14,14,0,7,7,10
26824,11705,11711,20,11,7,2,2,3,11,12,-1,6,8,8
26825,11705,11711,41,16,7,1,2,4,9,19,-10,4,10,5
26826,11705,11711,52,13,7,1,4,2,8,9,-1,6,8,7
26827,11705,11711,43,1,7,6,1,0,21,5,16,13,1,19
26828,11705,11711,24,8,7,4,0,3,13,9,4,8,6,12
26829,11705,11711,22,15,7,1,3,3,6,8,-2,5,9,6
26830,11705,11711,57,18,7,0,2,5,12,22,-10,2,12,2
26831,11705,11711,6,17,7,1,1,5,6,19,-13,3,11,4
26832,11705,11711,12,12,7,2,1,4,6,13,-7,5,9,7
26833,11705,11711,17,10,7,2,3,2,12,8,4,7,7,9
26834,11705,11711,27,7,7,4,0,3,18,14,4,8,6,12
26835,12069,12075,27,6,8,4,1,3,9,7,2,9,7,13
26836,12069,12075,17,13,8,1,4,3,5,8,-3,6,10,7
26837,12069,12075,43,1,8,7,1,0,27,9,18,15,1,22
26838,12069,12075,24,10,8,2,4,2,11,8,3,8,8,10
26839,12069,12075,57,11,8,2,4,2,13,14,-1,8,8,10
26840,12069,12075,22,18,8,0,2,6,9,22,-13,2,14,2
26841,12069,12075,6,3,8,4,2,2,14,11,3,10,6,14
26842,12069,12075,35,7,8,3,3,2,10,9,1,9,7,12
26843,12069,12075,13,8,8,3,2,3,13,8,5,8,8,11
26844,12069,12075,41,14,8,1,4,3,7,14,-7,6,10,7
26845,12069,12075,20,17,8,1,2,5,10,20,-10,4,12,5
26846,12069,12075,52,16,8,1,2,5,10,19,-9,4,12,5
26847,12069,12075,49,9,8,3,2,3,7,4,3,8,8,11
26848,12069,12075,37,15,8,0,6,2,4,8,-4,6,10,6
26849,12069,12075,21,4,8,4,2,2,11,10,1,10,6,14
26850,12069,12075,9,5,8,3,5,0,12,6,6,11,5,14
26851,12069,12075,4,12,8,1,6,1,10,11,-1,8,8,9
26852,12069,12075,1,2,8,4,4,0,12,6,6,12,4,16
26853,12503,12509,1,3,13,7,3,3,28,14,14,17,9,24
26854,12503,12509,4,7,13,5,3,5,21,23,-2,13,13,18
26855,12503,12509,21,12,13,4,3,6,23,24,-1,11,15,15
26856,12503,12509,9,17,13,3,2,8,15,28,-13,8,18,11
26857,12503,12509,43,1,13,9,2,2,31,15,16,20,6,29
26858,12503,12509,49,2,13,9,2,2,23,10,13,20,6,29
26859,12503,12509,13,5,13,6,4,3,23,15,8,16,10,22
26860,12503,12509,35,9,13,4,4,5,25,18,7,12,14,16
26861,12503,12509,6,14,13,4,2,7,14,19,-5,10,16,14
26862,12503,12509,41,18,13,1,5,7,16,27,-11,7,19,8
26863,12503,12509,24,6,13,6,3,4,17,15,2,15,11,21
26864,12503,12509,34,10,13,4,4,5,22,27,-5,12,14,16
26865,12503,12509,57,13,13,4,3,6,12,19,-7,11,15,15
26866,12503,12509,17,4,13,7,2,4,26,18,8,16,10,23
26867,12503,12509,27,16,13,3,4,6,9,19,-10,10,16,13
26868,12503,12509,37,8,13,5,2,6,17,23,-6,12,14,17
26869,12503,12509,52,11,13,3,7,3,13,15,-2,13,13,16
26870,12503,12509,28,15,13,3,5,5,12,18,-6,11,15,14
26871,12594,12600,35,4,24,9,9,6,42,26,16,27,21,36
26872,12594,12600,13,7,24,8,8,8,38,30,8,24,24,32
26873,12594,12600,6,9,24,8,7,9,28,31,-3,23,25,31
26874,12594,12600,41,18,24,2,6,16,24,53,-29,10,38,12
26875,12762,12764,13,18,2,0,0,2,1,6,-5,0,4,0
26876,12762,12764,34,2,2,2,0,0,5,1,4,4,0,6
26877,12762,12764,57,6,2,2,0,0,4,2,2,4,0,6
26878,12762,12764,24,13,2,0,1,1,3,5,-2,1,3,1
26879,12762,12764,43,17,2,0,0,2,1,5,-4,0,4,0
26880,12762,12764,28,9,2,1,0,1,4,3,1,2,2,3
26881,12762,12764,52,10,2,1,0,1,3,4,-1,2,2,3
26882,12762,12764,49,3,2,2,0,0,5,2,3,4,0,6
26883,12762,12764,37,16,2,0,0,2,0,3,-3,0,4,0
26884,12930,12936,21,12,21,7,5,9,28,29,-1,19,23,26
26885,12930,12936,4,14,21,6,7,8,25,33,-8,19,23,25
26886,12930,12936,49,5,21,7,9,5,30,24,6,23,19,30
26887,12930,12936,37,17,21,4,7,10,20,31,-11,15,27,19
26888,12930,12936,24,8,21,8,5,8,26,30,-4,21,21,29
26889,12930,12936,34,11,21,7,6,8,30,30,0,20,22,27
26890,12930,12936,27,7,21,7,9,5,36,37,-1,23,19,30
26891,12930,12936,52,4,21,8,8,5,23,20,3,24,18,32
26892,12930,12936,28,15,21,5,5,11,24,42,-18,15,27,20
26893,12930,12936,35,9,21,7,7,7,32,27,5,21,21,28
26894,12930,12936,6,13,21,7,5,9,24,29,-5,19,23,26
26895,12930,12936,13,16,21,5,4,12,27,42,-15,14,28,19
26896,12930,12936,20,18,21,3,6,12,19,42,-23,12,30,15
26897,12930,12936,43,2,21,14,3,4,52,22,30,31,11,45
26898,12930,12936,57,6,21,7,9,5,31,29,2,23,19,30
26899,12930,12936,17,3,21,10,7,4,37,26,11,27,15,37
26900,12930,12936,1,1,21,14,5,2,51,19,32,33,9,47
26901,12930,12936,47,10,21,8,3,10,25,28,-3,19,23,27
26902,12993,12999,47,8,29,12,4,13,34,37,-3,28,30,40
26903,12993,12999,1,1,29,22,5,2,75,24,51,49,9,71
26904,12993,12999,17,3,29,12,10,7,45,36,9,34,24,46
26905,12993,12999,28,13,29,10,6,13,37,49,-12,26,32,36
26906,12993,12999,52,5,29,11,11,7,35,28,7,33,25,44
26907,12993,12999,57,9,29,10,10,9,42,40,2,30,28,40
26908,12993,12999,24,12,29,10,7,12,31,39,-8,27,31,37
26909,12993,12999,34,15,29,8,9,12,40,45,-5,25,33,33
26910,12993,12999,43,2,29,19,4,6,74,32,42,42,16,61
26911,12993,12999,6,10,29,11,5,13,33,42,-9,27,31,38
26912,12993,12999,13,16,29,8,5,16,33,57,-24,21,37,29
26913,12993,12999,20,18,29,3,8,18,26,63,-37,14,44,17
26914,12993,12999,35,4,29,12,8,9,42,32,10,32,26,44
26915,12993,12999,27,6,29,10,11,8,49,45,4,31,27,41
26916,12993,12999,21,11,29,10,7,12,33,40,-7,27,31,37
26917,12993,12999,4,14,29,8,10,11,32,42,-10,26,32,34
26918,12993,12999,49,7,29,10,11,8,42,39,3,31,27,41
26919,12993,12999,37,17,29,6,7,16,32,45,-13,19,39,25
26920,12769,12775,49,1,4,4,0,0,13,2,11,8,0,12
26921,12769,12775,37,14,4,1,0,3,4,8,-4,2,6,3
26922,12769,12775,24,17,4,0,2,2,6,11,-5,2,6,2
26923,12769,12775,13,11,4,1,1,2,6,8,-2,3,5,4
26924,12769,12775,20,13,4,1,1,2,5,9,-4,3,5,4
26925,12769,12775,35,15,4,0,2,2,6,8,-2,2,6,2
26926,12769,12775,6,18,4,0,0,4,1,6,-5,0,8,0
26927,12769,12775,34,2,4,4,0,0,8,1,7,8,0,12
26928,12769,12775,57,7,4,2,1,1,4,6,-2,5,3,7
26929,12769,12775,43,9,4,1,1,2,7,7,0,3,5,4
26930,12769,12775,52,6,4,2,1,1,4,4,0,5,3,7
26931,12769,12775,28,12,4,1,1,2,6,9,-3,3,5,4
26932,12769,12775,17,8,4,2,0,2,6,5,1,4,4,6
26933,12769,12775,27,5,4,3,0,1,9,7,2,6,2,9
26934,12769,12775,1,3,4,3,1,0,8,3,5,7,1,10
26935,12769,12775,21,10,4,1,1,2,5,5,0,3,5,4
26936,12769,12775,4,16,4,0,2,2,4,8,-4,2,6,2
26937,12769,12775,47,4,4,3,0,1,9,4,5,6,2,9
26938,13196,13202,47,9,11,4,3,4,15,14,1,11,11,15
26939,13196,13202,17,5,11,4,6,1,16,9,7,14,8,18
26940,13196,13202,1,2,11,6,4,1,22,10,12,16,6,22
26941,13196,13202,6,7,11,4,4,3,17,18,-1,12,10,16
26942,13196,13202,35,14,11,3,2,6,9,16,-7,8,14,11
26943,13196,13202,27,11,11,4,1,6,18,18,0,9,13,13
26944,13196,13202,43,4,11,5,5,1,20,9,11,15,7,20
26945,13196,13202,22,13,11,2,6,3,10,13,-3,10,12,12
26946,13196,13202,24,15,11,2,5,4,15,18,-3,9,13,11
26947,13196,13202,34,16,11,2,5,4,13,16,-3,9,13,11
26948,13196,13202,57,18,11,0,4,7,11,25,-14,4,18,4
26949,13196,13202,33,3,11,6,4,1,21,10,11,16,6,22
26950,13196,13202,52,12,11,3,4,4,10,13,-3,10,12,13
26951,13196,13202,28,17,11,2,3,6,17,28,-11,7,15,9
26952,13196,13202,21,6,11,5,1,5,17,19,-2,11,11,16
26953,13196,13202,4,10,11,4,2,5,19,23,-4,10,12,14
26954,13196,13202,49,1,11,8,0,3,20,13,7,16,6,24
26955,16234,16240,40,7,22,10,5,7,31,20,11,25,19,35
26956,16234,16240,57,12,22,7,4,11,31,55,-24,18,26,25
26957,16234,16240,4,6,22,11,4,7,33,24,9,26,18,37
26958,16234,16240,9,17,22,3,6,13,20,44,-24,12,32,15
26959,16234,16240,1,1,22,18,3,1,59,14,45,39,5,57
26960,16542,16576,4,9,18,7,4,7,22,23,-1,18,18,25
26961,16542,16576,25,4,18,9,5,4,27,14,13,23,13,32
26962,16542,16576,12,7,18,8,5,5,27,25,2,21,15,29
26963,16542,16576,33,13,18,6,1,11,25,32,-7,13,23,19
26964,16542,16576,28,17,18,4,3,11,18,29,-11,11,25,15
26965,16542,16576,49,1,18,12,2,4,30,17,13,26,10,38
26966,16542,16576,46,8,18,7,7,4,23,17,6,21,15,28
26967,16542,16576,37,14,18,6,1,11,23,30,-7,13,23,19
26968,16542,16576,1,3,18,10,5,3,28,17,11,25,11,35
26969,16542,16576,35,15,18,5,3,10,22,33,-11,13,23,18
26970,16542,16576,45,6,18,9,3,6,34,28,6,21,15,30
26971,16542,16576,27,12,18,5,6,7,18,24,-6,16,20,21
26972,16542,16576,17,18,18,1,6,11,7,33,-26,8,28,9
26973,16542,16576,43,2,18,10,6,2,40,17,23,26,10,36
26974,16542,16576,22,5,18,8,7,3,31,21,10,23,13,31
26975,16542,16576,51,10,18,6,5,7,29,23,6,17,19,23
26976,16542,16576,57,11,18,6,3,9,23,29,-6,15,21,21
26977,16542,16576,40,16,18,4,6,8,17,32,-15,14,22,18
26978,16619,16625,43,1,25,15,7,3,54,22,32,37,13,52
26979,16619,16625,22,5,25,11,8,6,39,30,9,30,20,41
26980,16619,16625,51,11,25,8,8,9,39,33,6,24,26,32
26981,16619,16625,57,13,25,7,6,12,30,44,-14,20,30,27
26982,16619,16625,40,17,25,4,10,11,21,41,-20,18,32,22
26983,16619,16625,1,3,25,13,8,4,39,24,15,34,16,47
26984,16619,16625,49,2,25,15,5,5,45,23,22,35,15,50
26985,16619,16625,46,10,25,8,9,8,25,25,0,25,25,33
26986,16619,16625,37,18,25,6,3,16,26,44,-18,15,35,21
26987,16619,16625,35,12,25,8,5,12,32,40,-8,21,29,29
26988,16619,16625,25,6,25,11,5,9,34,30,4,27,23,38
26989,16619,16625,12,8,25,10,8,7,37,34,3,28,22,38
26990,16619,16625,4,7,25,11,5,9,32,29,3,27,23,38
26991,16619,16625,33,14,25,7,4,14,31,36,-5,18,32,25
26992,16619,16625,28,15,25,5,8,12,26,37,-11,18,32,23
26993,16619,16625,45,4,25,13,5,7,43,34,9,31,19,44
26994,16619,16625,27,9,25,9,7,9,27,29,-2,25,25,34
26995,16619,16625,17,16,25,5,7,13,16,41,-25,17,33,22
26996,16640,16646,17,16,28,6,8,14,18,44,-26,20,36,26
26997,16640,16646,33,13,28,9,4,15,38,37,1,22,34,31
26998,16640,16646,28,14,28,7,8,13,31,38,-7,22,34,29
26999,16640,16646,45,4,28,14,5,9,46,37,9,33,23,47
27000,16640,16646,27,9,28,10,8,10,31,32,-1,28,28,38
27001,16640,16646,4,5,28,14,5,9,37,30,7,33,23,47
27002,16640,16646,49,2,28,16,7,5,46,23,23,39,17,55
27003,16640,16646,46,10,28,9,10,9,26,26,0,28,28,37
27004,16640,16646,37,18,28,7,3,18,30,50,-20,17,39,24
27005,16640,16646,1,3,28,14,9,5,41,27,14,37,19,51
27006,16640,16646,35,12,28,10,5,13,34,41,-7,25,31,35
27007,16640,16646,43,1,28,17,7,4,60,25,35,41,15,58
27008,16640,16646,51,11,28,9,9,10,40,36,4,27,29,36
27009,16640,16646,57,15,28,7,6,15,30,52,-22,20,36,27
27010,16640,16646,40,17,28,4,13,11,21,41,-20,21,35,25
27011,16640,16646,22,6,28,12,8,8,40,32,8,32,24,44
27012,16640,16646,12,7,28,11,9,8,41,39,2,31,25,42
27013,16640,16646,25,8,28,11,6,11,37,37,0,28,28,39
27014,16661,16667,12,7,31,11,11,9,44,43,1,33,29,44
27015,16661,16667,25,10,31,11,7,13,38,45,-7,29,33,40
27016,16661,16667,43,2,31,18,9,4,67,27,40,45,17,63
27017,16661,16667,35,8,31,12,6,13,42,43,-1,30,32,42
27018,16661,16667,1,3,31,16,9,6,45,32,13,41,21,57
27019,16661,16667,49,1,31,19,7,5,51,24,27,45,17,64
27020,16661,16667,46,12,31,9,10,12,26,29,-3,28,34,37
27021,16661,16667,37,16,31,8,5,18,34,53,-19,21,41,29
27022,16661,16667,22,5,31,15,8,8,44,33,11,38,24,53
27023,16661,16667,51,11,31,10,10,11,44,40,4,30,32,40
27024,16661,16667,57,15,31,8,8,15,35,54,-19,24,38,32
27025,16661,16667,40,18,31,4,13,14,21,45,-24,21,41,25
27026,16661,16667,4,4,31,16,6,9,45,34,11,38,24,54
27027,16661,16667,45,6,31,14,7,10,50,42,8,35,27,49
27028,16661,16667,27,9,31,10,11,10,35,36,-1,31,31,41
27029,16661,16667,33,13,31,10,4,17,40,40,0,24,38,34
27030,16661,16667,28,14,31,8,9,14,34,43,-9,25,37,33
27031,16661,16667,17,17,31,6,8,17,18,50,-32,20,42,26
27032,16454,16457,1,4,7,4,2,1,8,5,3,10,4,14
27033,13735,13741,35,3,29,15,6,8,52,40,12,36,22,51
27034,13735,13741,6,8,29,10,7,12,42,44,-2,27,31,37
27035,13735,13741,27,14,29,8,8,13,40,53,-13,24,34,32
27036,13735,13741,1,1,29,23,5,1,65,24,41,51,7,74
27037,13735,13741,12,6,29,14,3,12,58,57,1,31,27,45
27038,13735,13741,25,10,29,8,11,10,43,47,-4,27,31,35
27039,13735,13741,28,12,29,8,10,11,26,32,-6,26,32,34
27040,13735,13741,33,15,29,8,7,14,31,42,-11,23,35,31
27041,13735,13741,52,17,29,6,5,18,30,66,-36,17,41,23
27042,13735,13741,22,2,29,19,5,5,61,30,31,43,15,62
27043,13735,13741,43,4,29,14,7,8,48,33,15,35,23,49
27044,13735,13741,34,13,29,8,8,13,42,53,-11,24,34,32
27045,13735,13741,49,11,29,8,10,11,39,40,-1,26,32,34
27046,13735,13741,37,16,29,6,8,15,25,45,-20,20,38,26
27047,13735,13741,4,9,29,8,13,8,38,37,1,29,29,37
27048,13735,13741,21,18,29,5,7,17,30,53,-23,17,41,22
27049,13539,13545,49,13,7,2,2,3,9,9,0,6,8,8
27050,13539,13545,37,15,7,1,3,3,8,11,-3,5,9,6
27051,13539,13545,4,11,7,2,3,2,13,11,2,7,7,9
27052,13539,13545,21,18,7,0,0,7,5,18,-13,0,14,0
27053,13539,13545,27,5,7,3,2,2,8,11,-3,8,6,11
27054,13539,13545,22,2,7,5,1,1,19,8,11,11,3,16
27055,13539,13545,43,9,7,3,0,4,5,10,-5,6,8,9
27056,13539,13545,34,16,7,1,3,3,7,10,-3,5,9,6
27057,13539,13545,33,12,7,2,3,2,7,6,1,7,7,9
27058,13539,13545,52,14,7,2,1,4,8,13,-5,5,9,7
27059,13539,13545,28,17,7,1,2,4,4,14,-10,4,10,5
27060,13539,13545,25,7,7,3,1,3,14,17,-3,7,7,10
27061,13539,13545,12,10,7,3,0,4,10,17,-7,6,8,9
27062,13539,13545,1,1,7,7,0,0,20,4,16,14,0,21
27063,13539,13545,17,6,7,3,1,3,15,11,4,7,7,10
27064,13539,13545,47,8,7,2,4,1,9,7,2,8,6,10
27065,13539,13545,6,2,7,5,1,1,19,8,11,11,3,16
27066,13539,13545,35,4,7,4,1,2,15,10,5,9,5,13
27067,13952,13958,35,12,14,5,2,7,23,24,-1,12,16,17
27068,13952,13958,6,16,14,3,2,9,14,20,-6,8,20,11
27069,13952,13958,56,18,14,1,3,10,20,39,-19,5,23,6
27070,13952,13958,47,15,14,3,4,7,16,25,-9,10,18,13
27071,13952,13958,1,1,14,10,2,2,30,14,16,22,6,32
27072,13952,13958,17,10,14,6,1,7,22,24,-2,13,15,19
27073,13952,13958,12,4,14,8,3,3,32,18,14,19,9,27
27074,13952,13958,25,5,14,8,2,4,33,22,11,18,10,26
27075,13952,13958,27,14,14,3,5,6,20,21,-1,11,17,14
27076,13952,13958,4,9,14,5,5,4,22,27,-5,15,13,20
27077,13952,13958,9,17,14,1,4,9,10,35,-25,6,22,7
27078,13952,13958,22,2,14,9,3,2,27,16,11,21,7,30
27079,13952,13958,43,8,14,5,5,4,21,20,1,15,13,20
27080,13952,13958,34,11,14,5,4,5,24,24,0,14,14,19
27081,13952,13958,49,3,14,9,1,4,22,10,12,19,9,28
27082,13952,13958,37,13,14,4,3,7,17,23,-6,11,17,15
27083,13952,13958,33,6,14,6,5,3,27,24,3,17,11,23
27084,13952,13958,28,7,14,6,4,4,20,14,6,16,12,22
27085,13959,13965,33,6,15,7,5,3,29,25,4,19,11,26
27086,13959,13965,28,7,15,6,5,4,22,16,6,17,13,23
27087,13959,13965,49,3,15,9,1,5,22,12,10,19,11,28
27088,13959,13965,37,14,15,4,3,8,18,25,-7,11,19,15
27089,13959,13965,22,2,15,10,3,2,33,16,17,23,7,33
27090,13959,13965,43,10,15,5,5,5,23,23,0,15,15,20
27091,13959,13965,34,11,15,5,4,6,25,28,-3,14,16,19
27092,13959,13965,4,8,15,6,5,4,25,29,-4,17,13,23
27093,13959,13965,9,17,15,1,5,9,10,35,-25,7,23,8
27094,13959,13965,27,15,15,3,6,6,22,23,-1,12,18,15
27095,13959,13965,12,4,15,8,4,3,32,18,14,20,10,28
27096,13959,13965,25,5,15,8,2,5,34,24,10,18,12,26
27097,13959,13965,17,9,15,7,1,7,26,25,1,15,15,22
27098,13959,13965,1,1,15,11,2,2,32,15,17,24,6,35
27099,13959,13965,47,13,15,4,4,7,18,25,-7,12,18,16
27100,13959,13965,35,12,15,5,3,7,25,26,-1,13,17,18
27101,13959,13965,6,16,15,3,2,10,14,26,-12,8,22,11
27102,13959,13965,56,18,15,1,4,10,22,41,-19,6,24,7
27103,14123,14126,35,9,32,14,6,12,46,43,3,34,30,48
27104,14123,14126,6,16,32,6,7,19,30,51,-21,19,45,25
27105,14123,14126,56,17,32,5,7,20,44,77,-33,17,47,22
27106,14123,14126,47,11,32,10,10,12,43,44,-1,30,34,40
27107,14123,14126,17,8,32,14,6,12,63,47,16,34,30,48
27108,14123,14126,27,14,32,6,11,15,37,51,-14,23,41,29
27109,14123,14126,1,2,32,21,5,6,60,33,27,47,17,68
27110,14123,14126,4,10,32,13,9,10,51,58,-7,35,29,48
27111,14123,14126,9,18,32,4,10,18,27,69,-42,18,46,22
27112,12594,12600,27,13,24,7,9,8,23,30,-7,23,25,30
27113,12594,12600,34,5,24,10,5,9,50,50,0,25,23,35
27114,12594,12600,24,11,24,8,6,10,26,32,-6,22,26,30
27115,12594,12600,57,16,24,6,6,12,31,43,-12,18,30,24
27116,12594,12600,43,1,24,17,5,2,62,24,38,39,9,56
27117,12594,12600,52,8,24,8,7,9,28,29,-1,23,25,31
27118,12594,12600,28,10,24,7,10,7,25,28,-3,24,24,31
27119,12594,12600,37,12,24,7,9,8,30,34,-4,23,25,30
27120,12594,12600,49,2,24,16,5,3,39,18,21,37,11,53
27121,12594,12600,21,14,24,8,5,11,35,37,-2,21,27,29
27122,12594,12600,1,3,24,15,5,4,54,22,32,35,13,50
27123,12594,12600,4,15,24,7,6,11,28,41,-13,20,28,27
27124,12594,12600,9,17,24,3,7,14,23,55,-32,13,35,16
27125,12594,12600,17,6,24,9,7,8,36,39,-3,25,23,34
27126,12636,12642,17,7,29,11,8,10,40,44,-4,30,28,41
27127,12636,12642,4,10,29,10,7,12,36,43,-7,27,31,37
27128,12636,12642,1,3,29,17,7,5,61,27,34,41,17,58
27129,12636,12642,21,15,29,8,6,15,38,48,-10,22,36,30
27130,12636,12642,9,18,29,3,8,18,27,71,-44,14,44,17
27131,12636,12642,34,4,29,12,8,9,55,53,2,32,26,44
27132,12636,12642,49,1,29,19,7,3,44,19,25,45,13,64
27133,12636,12642,37,11,29,9,10,10,35,38,-3,28,30,37
27134,12636,12642,28,9,29,9,12,8,29,31,-2,30,28,39
27135,12636,12642,52,14,29,8,10,11,30,35,-5,26,32,34
27136,12636,12642,41,17,29,4,7,18,29,57,-28,15,43,19
27137,12636,12642,43,2,29,19,6,4,70,28,42,44,14,63
27138,12636,12642,24,13,29,9,8,12,32,39,-7,26,32,35
27139,12636,12642,57,16,29,7,8,14,34,47,-13,22,36,29
27140,12636,12642,27,12,29,9,10,10,26,34,-8,28,30,37
27141,12636,12642,35,5,29,11,11,7,50,31,19,33,25,44
27142,12636,12642,6,6,29,11,8,10,36,33,3,30,28,41
27143,12636,12642,13,8,29,10,9,10,45,39,6,29,29,39
27144,12657,12663,27,11,31,10,10,11,29,37,-8,30,32,40
27145,12657,12663,17,7,31,12,8,11,44,47,-3,32,30,44
27146,12657,12663,43,1,31,20,6,5,73,31,42,46,16,66
27147,12657,12663,34,4,31,13,9,9,57,53,4,35,27,48
27148,12657,12663,24,13,31,10,8,13,34,42,-8,28,34,38
27149,12657,12663,57,15,31,8,9,14,38,48,-10,25,37,33
27150,12657,12663,35,5,31,11,12,8,51,33,18,34,28,45
27151,12657,12663,6,6,31,12,8,11,40,36,4,32,30,44
27152,12657,12663,13,8,31,11,9,11,49,41,8,31,31,42
27153,12657,12663,41,17,31,5,7,19,32,61,-29,17,45,22
27154,12657,12663,28,12,31,9,13,9,29,34,-5,31,31,40
27155,12657,12663,52,14,31,9,10,12,32,38,-6,28,34,37
27156,12657,12663,49,2,31,19,8,4,45,21,24,46,16,65
27157,12657,12663,37,9,31,10,11,10,37,39,-2,31,31,41
27158,12657,12663,4,10,31,11,7,13,38,46,-8,29,33,40
27159,12657,12663,21,16,31,8,6,17,39,52,-13,22,40,30
27160,12657,12663,9,18,31,4,8,19,30,75,-45,16,46,20
27161,12657,12663,1,3,31,19,7,5,64,27,37,45,17,64
27162,12867,12873,1,1,17,10,5,2,36,13,23,25,9,35
27163,12867,12873,47,9,17,7,2,8,20,21,-1,16,18,23
27164,12867,12873,24,5,17,7,5,5,22,25,-3,19,15,26
27165,12867,12873,57,8,17,5,9,3,23,24,-1,19,15,24
27166,12867,12873,34,10,17,6,5,6,24,23,1,17,17,23
27167,12867,12873,21,12,17,6,3,8,25,26,-1,15,19,21
27168,12867,12873,4,13,17,5,5,7,20,25,-5,15,19,20
27169,12867,12873,52,4,17,7,6,4,18,15,3,20,14,27
27170,12867,12873,28,15,17,4,5,8,20,30,-10,13,21,17
27171,12867,12873,43,2,17,10,3,4,36,19,17,23,11,33
27172,12867,12873,17,3,17,9,6,2,31,19,12,24,10,33
27173,12867,12873,27,7,17,6,7,4,32,32,0,19,15,25
27174,12867,12873,49,6,17,6,7,4,25,19,6,19,15,25
27175,12867,12873,37,14,17,4,5,8,17,23,-6,13,21,17
27176,12867,12873,35,11,17,5,7,5,27,20,7,17,17,22
27177,12867,12873,6,16,17,4,4,9,20,29,-9,12,22,16
27178,12867,12873,13,17,17,3,4,10,20,36,-16,10,24,13
27179,12867,12873,20,18,17,3,4,10,16,33,-17,10,24,13
27180,12895,12929,17,3,20,10,7,3,35,23,12,27,13,37
27181,12895,12929,43,2,20,13,3,4,47,22,25,29,11,42
27182,12895,12929,57,5,20,7,9,4,29,26,3,23,17,30
27183,12895,12929,24,6,20,8,5,7,25,28,-3,21,19,29
27184,12895,12929,34,10,20,7,5,8,30,30,0,19,21,26
27185,12895,12929,52,4,20,8,8,4,23,18,5,24,16,32
27186,12895,12929,28,15,20,5,5,10,24,37,-13,15,25,20
27187,12895,12929,35,12,20,6,7,7,31,27,4,19,21,25
27188,12895,12929,6,13,20,6,5,9,22,29,-7,17,23,23
27189,12895,12929,13,17,20,4,4,12,25,41,-16,12,28,16
27190,13196,13202,12,8,11,4,3,4,18,16,2,11,11,15
27191,13238,13258,12,11,17,5,5,7,26,28,-2,15,19,20
27192,13238,13258,21,7,17,9,1,7,30,29,1,19,15,28
27193,13238,13258,4,10,17,6,3,8,28,35,-7,15,19,21
27194,13238,13258,49,3,17,11,0,6,32,20,12,22,12,33
27195,13238,13258,28,17,17,2,6,9,22,37,-15,10,24,12
27196,13238,13258,43,8,17,7,7,3,26,13,13,21,13,28
27197,13238,13258,22,12,17,4,8,5,19,23,-4,16,18,20
27198,13238,13258,24,15,17,3,6,8,16,26,-10,12,22,15
27199,13238,13258,34,16,17,2,8,7,21,31,-10,12,22,14
27200,13238,13258,57,18,17,1,5,11,16,37,-21,7,27,8
27201,13238,13258,33,2,17,10,5,2,31,16,15,25,9,35
27202,13238,13258,52,9,17,6,4,7,18,21,-3,16,18,22
27203,13238,13258,27,13,17,5,3,9,23,27,-4,13,21,18
27204,13238,13258,6,6,17,8,5,4,28,25,3,21,13,29
27205,13238,13258,35,14,17,4,4,9,21,29,-8,12,22,16
27206,13238,13258,17,4,17,8,7,2,27,16,11,23,11,31
27207,13238,13258,47,5,17,9,3,5,30,20,10,21,13,30
27208,13238,13258,1,1,17,11,4,2,36,17,19,26,8,37
27209,13287,13293,47,4,19,11,3,5,35,21,14,25,13,36
27210,13287,13293,1,2,19,11,4,4,38,23,15,26,12,37
27211,13287,13293,21,6,19,10,2,7,33,30,3,22,16,32
27212,13287,13293,4,10,19,7,3,9,30,36,-6,17,21,24
27213,13287,13293,27,13,19,6,3,10,25,30,-5,15,23,21
27214,13287,13293,17,3,19,10,7,2,33,19,14,27,11,37
27215,13287,13293,12,11,19,6,5,8,27,30,-3,17,21,23
27216,13287,13293,6,8,19,8,6,5,29,29,0,22,16,30
27217,13287,13293,35,16,19,4,4,11,22,34,-12,12,26,16
27218,13287,13293,33,1,19,12,5,2,36,16,20,29,9,41
27219,13287,13293,52,9,19,7,4,8,21,24,-3,18,20,25
27220,13287,13293,28,17,19,3,6,10,25,39,-14,12,26,15
27221,13287,13293,49,5,19,11,0,8,32,24,8,22,16,33
27222,13287,13293,43,7,19,8,8,3,30,14,16,24,14,32
27223,13287,13293,22,12,19,5,8,6,21,24,-3,18,20,23
27224,13287,13293,24,14,19,4,7,8,18,27,-9,15,23,19
27225,13287,13293,34,15,19,3,8,8,25,36,-11,14,24,17
27226,13287,13293,57,18,19,1,5,13,19,43,-24,7,31,8
27227,13126,13132,43,3,2,1,1,0,6,0,6,3,1,4
27228,13126,13132,34,6,2,1,1,0,2,1,1,3,1,4
27229,13126,13132,22,8,2,1,0,1,3,2,1,2,2,3
27230,13126,13132,24,14,2,0,1,1,2,3,-1,1,3,1
27231,13126,13132,57,15,2,0,1,1,1,2,-1,1,3,1
27232,13126,13132,4,1,2,2,0,0,5,2,3,4,0,6
27233,13126,13132,21,12,2,1,0,1,3,5,-2,2,2,3
27234,13126,13132,35,9,2,1,0,1,4,4,0,2,2,3
27235,13126,13132,6,18,2,0,0,2,0,8,-8,0,4,0
27236,13126,13132,12,11,2,1,0,1,2,2,0,2,2,3
27237,13126,13132,17,13,2,0,2,0,2,2,0,2,2,2
27238,13126,13132,33,2,2,2,0,0,4,1,3,4,0,6
27239,13126,13132,52,4,2,1,1,0,2,0,2,3,1,4
27240,13126,13132,28,17,2,0,0,2,0,4,-4,0,4,0
27241,13126,13132,27,7,2,1,0,1,4,3,1,2,2,3
27242,13126,13132,49,10,2,1,0,1,3,3,0,2,2,3
27243,13126,13132,47,16,2,0,0,2,2,4,-2,0,4,0
27244,13126,13132,1,5,2,1,1,0,3,2,1,3,1,4
27245,13329,13335,1,2,25,15,5,5,53,29,24,35,15,50
27246,13329,13335,47,6,25,11,6,8,40,29,11,28,22,39
27247,13329,13335,21,5,25,13,3,9,40,35,5,29,21,42
27248,13329,13335,4,11,25,8,4,13,35,46,-11,20,30,28
27249,13329,13335,27,14,25,7,6,12,29,38,-9,20,30,27
27250,13329,13335,17,3,25,13,10,2,45,27,18,36,14,49
27251,13329,13335,12,16,25,7,6,12,34,47,-13,20,30,27
27252,13329,13335,6,7,25,11,6,8,37,38,-1,28,22,39
27253,13329,13335,35,12,25,7,6,12,31,38,-7,20,30,27
27254,13329,13335,33,1,25,14,9,2,47,23,24,37,13,51
27255,13329,13335,52,13,25,7,6,12,24,32,-8,20,30,27
27256,13329,13335,28,15,25,7,6,12,34,45,-11,20,30,27
27257,13329,13335,43,4,25,12,9,4,42,21,21,33,17,45
27258,13329,13335,22,9,25,8,8,9,31,31,0,24,26,32
27259,13329,13335,24,10,25,7,8,10,28,36,-8,22,28,29
27260,13329,13335,34,17,25,4,9,12,28,43,-15,17,33,21
27261,13329,13335,57,18,25,4,7,14,27,49,-22,15,35,19
27262,13329,13335,49,8,25,12,2,11,41,39,2,26,24,38
27263,13378,13398,43,5,31,14,10,7,50,32,18,38,24,52
27264,13378,13398,22,9,31,12,8,11,42,36,6,32,30,44
27265,13378,13398,34,16,31,7,10,14,40,53,-13,24,38,31
27266,13378,13398,24,17,31,7,10,14,33,48,-15,24,38,31
27267,13378,13398,57,18,31,5,9,17,31,60,-29,19,43,24
27268,13378,13398,21,6,31,14,5,12,44,41,3,33,29,47
27269,8618,8624,1,3,29,14,9,6,58,34,24,37,21,51
27270,8618,8624,19,7,29,12,6,11,39,40,-1,30,28,42
27271,8618,8624,17,15,29,8,6,15,35,54,-19,22,36,30
27272,8618,8624,8,17,29,7,6,16,27,57,-30,20,38,27
27273,8618,8624,37,1,29,18,7,4,51,30,21,43,15,61
27274,8618,8624,49,4,29,14,6,9,50,38,12,34,24,48
27275,8618,8624,52,18,29,5,10,14,28,42,-14,20,38,25
27276,8618,8624,12,10,29,10,7,12,37,40,-3,27,31,37
27277,8618,8624,53,16,29,6,10,13,38,62,-24,22,36,28
27278,8618,8624,13,5,29,14,5,10,54,43,11,33,25,47
27279,8618,8624,20,6,29,13,6,10,48,39,9,32,26,45
27280,8618,8624,56,12,29,9,8,12,30,36,-6,26,32,35
27281,8618,8624,41,14,29,8,7,14,31,44,-13,23,35,31
27282,8618,8624,21,8,29,11,9,9,46,38,8,31,27,42
27283,8618,8624,4,13,29,9,6,14,34,40,-6,24,34,33
27284,8618,8624,43,2,29,17,7,5,70,33,37,41,17,58
27285,8618,8624,24,9,29,9,12,8,38,39,-1,30,28,39
27286,8618,8624,57,11,29,10,7,12,29,34,-5,27,31,37
27287,8821,8827,43,1,11,8,3,0,38,11,27,19,3,27
27288,8821,8827,4,5,11,5,3,3,29,17,12,13,9,18
27289,8821,8827,21,8,11,4,4,3,13,15,-2,12,10,16
27290,8821,8827,1,6,11,5,3,3,17,17,0,13,9,18
27291,8821,8827,20,2,11,7,1,3,23,14,9,15,7,22
27292,8821,8827,41,3,11,5,5,1,21,12,9,15,7,20
27293,8821,8827,13,12,11,3,4,4,14,19,-5,10,12,13
27294,8821,8827,56,13,11,3,3,5,15,19,-4,9,13,12
27295,8821,8827,57,10,11,3,5,3,13,12,1,11,11,14
27296,8821,8827,24,11,11,3,5,3,14,15,-1,11,11,14
27297,8821,8827,2,17,11,2,1,8,12,31,-19,5,17,7
27298,8821,8827,12,7,11,5,2,4,17,22,-5,12,10,17
27299,8821,8827,11,14,11,3,3,5,12,19,-7,9,13,12
27300,8821,8827,53,15,11,3,2,6,16,21,-5,8,14,11
27301,8821,8827,37,4,11,6,1,4,25,11,14,13,9,19
27302,8821,8827,49,9,11,4,3,4,17,16,1,11,11,15
27303,8821,8827,17,16,11,2,2,7,6,22,-16,6,16,8
27304,8821,8827,19,18,11,0,6,5,4,13,-9,6,16,6
27305,8828,8834,17,16,12,2,3,7,7,23,-16,7,17,9
27306,8828,8834,19,18,12,0,6,6,4,16,-12,6,18,6
27307,8828,8834,37,5,12,6,2,4,27,13,14,14,10,20
27308,8828,8834,49,8,12,5,3,4,19,16,3,13,11,18
27309,8828,8834,12,6,12,6,2,4,20,22,-2,14,10,20
27310,8828,8834,53,11,12,4,2,6,17,21,-4,10,14,14
27311,8828,8834,11,15,12,3,3,6,13,24,-11,9,15,12
27312,8828,8834,43,1,12,9,3,0,43,12,31,21,3,30
27313,8828,8834,57,12,12,3,5,4,13,13,0,11,13,14
27314,8828,8834,24,13,12,3,5,4,15,17,-2,11,13,14
27315,8828,8834,2,17,12,2,1,9,12,32,-20,5,19,7
27316,8828,8834,20,2,12,7,2,3,23,14,9,16,8,23
27317,8828,8834,41,4,12,5,6,1,21,12,9,16,8,21
27318,8828,8834,56,10,12,4,3,5,16,19,-3,11,13,15
27319,8828,8834,13,14,12,3,5,4,16,21,-5,11,13,14
27320,8828,8834,1,3,12,6,3,3,19,18,1,15,9,21
27321,8828,8834,4,7,12,5,3,4,29,19,10,13,11,18
27322,8828,8834,21,9,12,4,5,3,14,16,-2,13,11,17
27323,8975,8977,1,4,24,12,8,4,43,29,14,32,16,44
27324,8975,8977,2,18,24,3,5,16,25,56,-31,11,37,14
27325,8975,8977,20,2,24,15,4,5,51,28,23,34,14,49
27326,8975,8977,41,3,24,12,8,4,44,24,20,32,16,44
27327,8975,8977,13,12,24,7,6,11,30,44,-14,20,28,27
27328,8975,8977,56,13,24,7,6,11,29,46,-17,20,28,27
27329,8975,8977,37,5,24,12,6,6,46,18,28,30,18,42
27330,8975,8977,49,9,24,7,8,9,28,30,-2,22,26,29
27331,8975,8977,43,1,24,19,5,0,72,17,55,43,5,62
27332,8975,8977,57,10,24,7,8,9,25,30,-5,22,26,29
27333,8975,8977,24,11,24,7,8,9,29,36,-7,22,26,29
27334,8975,8977,4,6,24,10,7,7,45,28,17,27,21,37
27335,8975,8977,21,7,24,8,10,6,27,33,-6,26,22,34
27336,8975,8977,12,8,24,8,6,10,36,40,-4,22,26,30
27337,8975,8977,53,16,24,6,5,13,31,48,-17,17,31,23
27338,8975,8977,11,17,24,4,7,13,27,47,-20,15,33,19
27339,8975,8977,17,14,24,6,6,12,19,40,-21,18,30,24
27340,8975,8977,19,15,24,5,9,10,18,31,-13,19,29,24
27341,9262,9268,17,16,21,4,6,11,19,35,-16,14,28,18
27342,9262,9268,37,6,21,10,4,7,33,29,4,24,18,34
27343,9262,9268,49,9,21,7,8,6,27,22,5,22,20,29
27344,9262,9268,21,10,21,7,7,7,23,28,-5,21,21,28
27345,9262,9268,53,4,21,9,8,4,33,26,7,26,16,35
27346,9262,9268,12,11,21,7,5,9,28,36,-8,19,23,26
27347,15016,15022,21,15,9,2,2,5,13,16,-3,6,12,8
27348,15422,15428,43,5,13,7,2,4,28,18,10,16,10,23
27349,15422,15428,22,6,12,6,4,2,32,17,15,16,8,22
27350,15422,15428,40,14,12,2,4,6,12,14,-2,8,16,10
27351,15422,15428,24,16,12,1,3,8,8,34,-26,5,19,6
27352,15422,15428,49,9,12,4,3,5,18,20,-2,11,13,15
27353,15422,15428,37,15,12,3,0,9,12,29,-17,6,18,9
27354,15422,15428,21,10,12,4,3,5,20,24,-4,11,13,15
27355,15422,15428,4,12,12,4,2,6,18,22,-4,10,14,14
27356,15422,15428,1,1,13,12,1,0,35,8,27,25,1,37
27357,15422,15428,27,17,13,0,4,9,14,37,-23,4,22,4
27358,15422,15428,28,3,12,7,3,2,36,21,15,17,7,24
27359,15422,15428,33,8,12,4,4,4,24,27,-3,12,12,16
27360,15422,15428,35,11,12,4,2,6,24,27,-3,10,14,14
27361,15422,15428,12,2,12,8,3,1,28,16,12,19,5,27
27362,15422,15428,25,13,12,3,1,8,8,23,-15,7,17,10
27363,15422,15428,17,4,12,7,3,2,22,11,11,17,7,24
27364,15422,15428,42,7,13,6,2,5,23,14,9,14,12,20
27365,15590,15596,17,6,30,14,8,8,47,39,8,36,24,50
27366,15590,15596,42,9,31,13,4,14,45,44,1,30,32,43
27367,15590,15596,35,13,30,8,6,16,47,54,-7,22,38,30
27368,15590,15596,12,3,30,18,5,7,68,49,19,41,19,59
27369,15590,15596,25,10,30,11,3,16,34,45,-11,25,35,36
27370,15590,15596,28,4,30,16,6,8,61,42,19,38,22,54
27371,15590,15596,33,12,30,9,5,16,40,65,-25,23,37,32
27372,15590,15596,27,16,30,6,7,17,38,65,-27,19,41,25
27373,15590,15596,1,1,31,25,3,3,95,32,63,53,9,78
27374,15590,15596,4,7,30,15,2,13,48,47,1,32,28,47
27375,15590,15596,21,14,30,7,7,16,39,54,-15,21,39,28
27376,15590,15596,49,8,30,13,8,9,47,36,11,34,26,47
27377,15590,15596,37,11,30,11,1,18,47,69,-22,23,37,34
27378,15590,15596,43,2,30,22,2,6,71,28,43,46,14,68
27379,15590,15596,22,5,30,15,6,9,68,49,19,36,24,51
27380,15590,15596,40,15,30,6,9,15,33,43,-10,21,39,27
27381,15590,15596,24,17,30,3,6,21,15,82,-67,12,48,15
27382,15842,15848,43,1,18,16,1,1,47,14,33,33,3,49
27383,15842,15848,22,3,18,10,4,4,36,21,15,24,12,34
27384,15842,15848,40,11,18,4,9,5,22,23,-1,17,19,21
27385,15842,15848,57,13,18,4,8,6,15,24,-9,16,20,20
27386,15842,15848,49,2,18,12,3,3,37,16,21,27,9,39
27387,15842,15848,37,9,18,8,0,10,25,29,-4,16,20,24
27388,15842,15848,4,7,18,6,8,4,21,16,5,20,16,26
27389,15842,15848,31,15,18,4,4,10,17,30,-13,12,24,16
27390,15842,15848,21,17,18,3,3,12,12,37,-25,9,27,12
27391,15842,15848,35,10,18,6,5,7,16,21,-5,17,19,23
27392,15842,15848,27,18,18,2,6,10,10,20,-10,10,26,12
27393,15842,15848,33,4,18,8,7,3,35,22,13,23,13,31
27394,15842,15848,28,6,18,7,6,5,22,23,-1,20,16,27
27395,15842,15848,25,8,18,6,7,5,20,24,-4,19,17,25
27396,15842,15848,12,14,18,4,4,10,20,31,-11,12,24,16
27397,15842,15848,17,12,18,4,8,6,18,21,-3,16,20,20
27398,15842,15848,42,16,18,3,7,8,17,27,-10,13,23,16
27399,15842,15848,1,5,18,8,4,6,32,23,9,20,16,28
27400,15863,15869,1,4,21,11,4,6,45,23,22,26,16,37
27401,15863,15869,17,13,21,4,11,6,22,25,-3,19,23,23
27402,15863,15869,42,16,21,3,9,9,20,31,-11,15,27,18
27403,15863,15869,25,6,21,9,7,5,27,25,2,25,17,34
27404,15863,15869,12,14,21,4,7,10,22,33,-11,15,27,19
27405,15863,15869,33,3,21,10,8,3,43,27,16,28,14,38
27406,15863,15869,28,8,21,7,7,7,24,30,-6,21,21,28
27407,15863,15869,27,17,21,3,7,11,18,28,-10,13,29,16
27408,15863,15869,35,7,21,7,7,7,20,24,-4,21,21,28
27409,15863,15869,4,9,21,6,9,6,22,21,1,21,21,27
27410,15863,15869,31,15,21,4,6,11,20,35,-15,14,28,18
27411,15863,15869,21,18,21,3,4,14,14,44,-30,10,32,13
27412,15863,15869,49,2,21,12,6,3,40,19,21,30,12,42
27413,15863,15869,37,10,21,8,2,11,29,34,-5,18,24,26
27414,15863,15869,43,1,21,19,1,1,55,17,38,39,3,58
27415,15863,15869,22,5,21,10,5,6,41,29,12,25,17,35
27416,15863,15869,40,11,21,5,10,6,27,30,-3,20,22,25
27417,15863,15869,57,12,21,5,8,8,19,33,-14,18,24,23
27418,16304,16310,43,2,30,21,5,4,66,29,37,47,13,68
27419,16304,16310,22,4,30,18,6,6,47,33,14,42,18,60
27420,16304,16310,49,3,30,18,6,6,53,26,27,42,18,60
27421,16304,16310,37,13,30,8,7,15,39,49,-10,23,37,31
27422,16304,16310,46,18,30,7,3,20,25,54,-29,17,43,24
27423,16304,16310,4,6,30,15,5,10,42,32,10,35,25,50
27424,16304,16310,9,17,30,6,7,17,28,55,-27,19,41,25
27425,12895,12929,20,18,20,3,6,11,17,37,-20,12,28,15
27426,12895,12929,21,11,20,7,4,9,28,29,-1,18,22,25
27427,12895,12929,4,14,20,5,7,8,22,31,-9,17,23,22
27428,12895,12929,27,7,20,7,8,5,36,37,-1,22,18,29
27429,12895,12929,49,8,20,6,9,5,27,22,5,21,19,27
27430,12895,12929,37,16,20,4,7,9,20,30,-10,15,25,19
27431,12895,12929,47,9,20,8,2,10,25,28,-3,18,22,26
27432,12895,12929,1,1,20,13,5,2,46,17,29,31,9,44
27433,12965,12971,1,1,26,19,5,2,65,23,42,43,9,62
27434,12965,12971,21,11,26,9,6,11,31,35,-4,24,28,33
27435,12965,12971,4,12,26,8,8,10,30,38,-8,24,28,32
27436,12965,12971,47,13,26,9,4,13,28,35,-7,22,30,31
27437,12965,12971,49,6,26,9,11,6,37,30,7,29,23,38
27438,12965,12971,37,17,26,4,7,15,24,43,-19,15,37,19
27439,12965,12971,52,4,26,10,10,6,31,25,6,30,22,40
27440,12965,12971,28,15,26,8,6,12,30,45,-15,22,30,30
27441,12965,12971,27,7,26,9,10,7,45,41,4,28,24,37
27442,12965,12971,43,2,26,18,3,5,69,26,43,39,13,57
27443,12965,12971,57,8,26,9,10,7,40,37,3,28,24,37
27444,12965,12971,24,9,26,10,6,10,30,36,-6,26,26,36
27445,12965,12971,34,14,26,8,7,11,38,41,-3,23,29,31
27446,12965,12971,17,3,26,11,9,6,41,31,10,31,21,42
27447,12965,12971,35,5,26,10,8,8,39,30,9,28,24,38
27448,12965,12971,6,10,26,10,5,11,29,36,-7,25,27,35
27449,12965,12971,13,16,26,7,4,15,30,52,-22,18,34,25
27450,12965,12971,20,18,26,3,7,16,23,56,-33,13,39,16
27451,12972,12978,35,4,27,11,8,8,40,30,10,30,24,41
27452,12972,12978,6,11,27,10,5,12,29,38,-9,25,29,35
27453,12972,12978,13,16,27,7,5,15,32,54,-22,19,35,26
27454,12972,12978,20,18,27,3,7,17,24,60,-36,13,41,16
27455,12972,12978,17,3,27,11,10,6,42,32,10,32,22,43
27456,12972,12978,27,7,27,9,11,7,46,42,4,29,25,38
27457,12972,12978,52,5,27,10,11,6,32,26,6,31,23,41
27458,12972,12978,28,13,27,9,6,12,33,46,-13,24,30,33
27459,12972,12978,49,6,27,9,11,7,38,33,5,29,25,38
27460,12972,12978,37,17,27,5,7,15,28,44,-16,17,37,22
27461,12972,12978,43,2,27,18,3,6,70,29,41,39,15,57
27462,12972,12978,57,8,27,9,10,8,40,38,2,28,26,37
27463,12972,12978,24,10,27,10,6,11,30,37,-7,26,28,36
27464,12972,12978,34,15,27,8,8,11,39,42,-3,24,30,32
27465,12972,12978,47,12,27,10,4,13,31,36,-5,24,30,34
27466,12972,12978,21,9,27,10,6,11,32,35,-3,26,28,36
27467,12972,12978,4,14,27,8,9,10,32,40,-8,25,29,33
27468,12972,12978,1,1,27,20,5,2,67,23,44,45,9,65
27469,13014,13027,47,9,32,13,4,15,37,43,-6,30,34,43
27470,13014,13027,1,1,32,24,6,2,79,26,53,54,10,78
27471,13014,13027,49,8,32,11,12,9,47,44,3,34,30,45
27472,13014,13027,37,17,32,6,9,17,36,51,-15,21,43,27
27473,13014,13027,52,3,32,13,12,7,42,28,14,38,26,51
27474,13014,13027,28,15,32,10,7,15,39,57,-18,27,37,37
27475,13014,13027,43,2,32,21,4,7,80,36,44,46,18,67
27476,13014,13027,24,10,32,12,7,13,37,42,-5,31,33,43
27477,13014,13027,57,11,32,11,10,11,46,45,1,32,32,43
27478,13014,13027,34,12,32,10,10,12,49,47,2,30,34,40
27479,13014,13027,27,6,32,12,11,9,55,48,7,35,29,47
27480,13014,13027,21,13,32,10,9,13,36,44,-8,29,35,39
27481,13014,13027,4,14,32,9,11,12,36,47,-11,29,35,38
27482,13014,13027,17,5,32,13,10,9,50,41,9,36,28,49
27483,13014,13027,35,4,32,14,8,10,47,35,12,36,28,50
27484,13014,13027,6,7,32,13,6,13,38,42,-4,32,32,45
27485,13014,13027,13,16,32,8,5,19,33,71,-38,21,43,29
27486,13014,13027,20,18,32,3,9,20,27,67,-40,15,49,18
27487,13224,13230,12,10,15,5,4,6,25,26,-1,14,16,19
27488,13224,13230,6,8,15,7,4,4,26,24,2,18,12,25
27489,13224,13230,35,14,15,4,3,8,19,25,-6,11,19,15
27490,13224,13230,33,3,15,8,5,2,26,14,12,21,9,29
27491,13224,13230,52,9,15,6,4,5,17,16,1,16,14,22
27492,13224,13230,28,17,15,2,4,9,20,35,-15,8,22,10
27493,13224,13230,27,13,15,5,2,8,23,26,-3,12,18,17
27494,13224,13230,43,6,15,7,5,3,26,13,13,19,11,26
27495,13224,13230,22,12,15,4,6,5,17,21,-4,14,16,18
27496,13224,13230,24,15,15,3,5,7,16,24,-8,11,19,14
27497,13224,13230,34,16,15,2,7,6,18,27,-9,11,19,13
27498,13224,13230,57,18,15,0,4,11,13,35,-22,4,26,4
27499,13224,13230,49,2,15,10,0,5,29,18,11,20,10,30
27500,13224,13230,1,1,15,9,4,2,29,14,15,22,8,31
27501,13224,13230,17,5,15,7,6,2,24,14,10,20,10,27
27502,13224,13230,47,4,15,8,3,4,27,18,9,19,11,27
27503,9262,9268,27,13,21,6,3,12,25,34,-9,15,27,21
27504,9262,9268,1,1,21,16,3,2,48,18,30,35,7,51
27505,9262,9268,52,18,21,3,7,11,17,40,-23,13,29,16
27506,9262,9268,20,5,21,10,4,7,34,22,12,24,18,34
27507,9262,9268,41,7,21,9,4,8,29,28,1,22,20,31
27508,9262,9268,56,14,21,5,5,11,20,32,-12,15,27,20
27509,9262,9268,13,15,21,4,8,9,14,22,-8,16,26,20
27510,9262,9268,19,17,21,4,6,11,18,41,-23,14,28,18
27511,9262,9268,4,3,21,11,5,5,35,19,16,27,15,38
27512,9262,9268,43,2,21,13,6,2,55,21,34,32,10,45
27513,9262,9268,57,8,21,8,5,8,37,32,5,21,21,29
27514,9262,9268,24,12,21,4,10,7,20,30,-10,18,24,22
27515,9290,9296,4,3,25,12,7,6,39,25,14,31,19,43
27516,9290,9296,21,10,25,8,8,9,27,36,-9,24,26,32
27517,9290,9296,19,17,25,4,8,13,19,47,-28,16,34,20
27518,9290,9296,17,18,25,4,7,14,24,48,-24,15,35,19
27519,9290,9296,13,15,25,5,10,10,18,27,-9,20,30,25
27520,9290,9296,53,8,25,9,10,6,35,32,3,28,22,37
27521,9290,9296,43,2,25,16,7,2,64,24,40,39,11,55
27522,9290,9296,57,9,25,10,6,9,44,37,7,26,24,36
27523,9290,9296,24,12,25,5,12,8,25,35,-10,22,28,27
27524,9290,9296,20,4,25,12,5,8,41,25,16,29,21,41
27525,9290,9296,41,5,25,11,6,8,37,31,6,28,22,39
27526,9290,9296,56,13,25,7,5,13,29,37,-8,19,31,26
27527,9290,9296,1,1,25,17,5,3,54,23,31,39,11,56
27528,9290,9296,12,11,25,7,7,11,31,45,-14,21,29,28
27529,9290,9296,27,14,25,7,4,14,31,43,-12,18,32,25
27530,9290,9296,52,16,25,5,9,11,24,44,-20,19,31,24
27531,9290,9296,49,6,25,10,9,6,38,24,14,29,21,39
27532,9290,9296,37,7,25,10,7,8,36,33,3,27,23,37
27533,9353,9359,49,4,33,14,12,7,55,29,26,40,26,54
27534,9353,9359,37,5,33,14,10,9,49,37,12,38,28,52
27535,9353,9359,27,11,33,11,6,16,41,58,-17,28,38,39
27536,9353,9359,53,7,33,12,13,8,43,40,3,37,29,49
27537,9353,9359,12,14,33,9,8,16,45,67,-22,26,40,35
27538,9353,9359,19,17,33,6,9,18,23,56,-33,21,45,27
27539,9353,9359,17,18,33,5,10,18,32,65,-33,20,46,25
27540,9353,9359,43,1,33,21,8,4,79,33,46,50,16,71
27541,9353,9359,57,9,33,12,10,11,54,45,9,34,32,46
27542,9353,9359,24,12,33,7,17,9,35,44,-9,31,35,38
27543,9353,9359,52,13,33,9,9,15,36,55,-19,27,39,36
27544,9353,9359,41,6,33,14,9,10,42,35,7,37,29,51
27545,9353,9359,20,8,33,14,6,13,48,37,11,34,32,48
27546,9353,9359,56,15,33,8,8,17,39,51,-12,24,42,32
27547,9353,9359,13,16,33,6,12,15,21,37,-16,24,42,30
27548,9353,9359,1,2,33,21,8,4,74,34,40,50,16,71
27549,9353,9359,4,3,33,15,10,8,51,38,13,40,26,55
27550,9353,9359,21,10,33,10,13,10,36,42,-6,33,33,43
27551,9640,9646,37,6,18,8,10,0,27,10,17,26,10,34
27552,9640,9646,49,8,18,7,5,6,25,16,9,19,17,26
27553,9640,9646,43,1,18,14,3,1,51,11,40,31,5,45
27554,9640,9646,24,2,18,12,4,2,29,8,21,28,8,40
27555,9640,9646,2,10,18,6,5,7,21,26,-5,17,19,23
27556,9640,9646,57,12,18,5,5,8,23,21,2,15,21,20
27557,9640,9646,12,4,18,10,6,2,28,18,10,26,10,36
27558,9640,9646,53,11,18,5,6,7,16,23,-7,16,20,21
27559,9640,9646,41,5,18,10,4,4,27,15,12,24,12,34
27560,9640,9646,27,7,18,9,2,7,23,25,-2,20,16,29
27561,9640,9646,1,3,18,11,4,3,39,19,20,26,10,37
27562,9640,9646,52,16,18,3,4,11,18,34,-16,10,26,13
27563,9640,9646,48,18,18,1,4,13,7,49,-42,6,30,7
27564,9640,9646,20,9,18,7,2,9,24,29,-5,16,20,23
27565,9640,9646,13,14,18,4,4,10,20,32,-12,12,24,16
27566,9640,9646,56,17,18,3,3,12,17,31,-14,9,27,12
27567,9640,9646,21,13,18,4,4,10,22,31,-9,12,24,16
27568,9640,9646,4,15,18,4,3,11,12,31,-19,11,25,15
27569,9514,9520,49,3,4,3,1,0,9,1,8,7,1,10
27570,9514,9520,37,4,4,2,2,0,5,1,4,6,2,8
27571,9514,9520,48,16,4,0,2,2,2,6,-4,2,6,2
27572,9514,9520,52,18,4,0,1,3,2,10,-8,1,7,1
27573,9514,9520,53,6,4,1,3,0,4,2,2,5,3,6
27574,9514,9520,12,7,4,1,3,0,3,2,1,5,3,6
27575,9514,9520,27,12,4,1,1,2,4,8,-4,3,5,4
27576,9514,9520,56,9,4,1,2,1,4,4,0,4,4,5
27577,9514,9520,41,10,4,1,2,1,5,6,-1,4,4,5
27578,9514,9520,13,11,4,1,1,2,4,6,-2,3,5,4
27579,9514,9520,20,13,4,1,1,2,5,12,-7,3,5,4
27580,9514,9520,57,14,4,1,0,3,7,7,0,2,6,3
27581,16454,16457,28,11,7,3,0,4,5,7,-2,6,8,9
27582,16454,16457,33,18,7,1,0,6,4,14,-10,2,12,3
27583,16454,16457,4,6,7,4,1,2,10,8,2,9,5,13
27584,16454,16457,49,1,7,6,0,1,16,7,9,12,2,18
27585,16454,16457,37,10,7,3,0,4,9,8,1,6,8,9
27586,16454,16457,46,13,7,1,3,3,7,10,-3,5,9,6
27587,16454,16457,35,16,7,1,1,5,5,13,-8,3,11,4
27588,16454,16457,40,17,7,0,4,3,6,14,-8,4,10,4
27589,16454,16457,25,3,7,4,2,1,9,2,7,10,4,14
27590,16454,16457,12,7,7,4,1,2,8,8,0,9,5,13
27591,16454,16457,17,14,7,1,3,3,4,9,-5,5,9,6
27592,16454,16457,45,5,7,4,1,2,15,10,5,9,5,13
27593,16454,16457,27,8,7,2,4,1,6,4,2,8,6,10
27594,16454,16457,43,2,7,5,2,0,23,7,16,12,2,17
27595,16454,16457,22,9,7,2,4,1,11,10,1,8,6,10
27596,16454,16457,51,12,7,2,1,4,7,10,-3,5,9,7
27597,16454,16457,57,15,7,1,1,5,5,12,-7,3,11,4
27598,16878,16884,42,17,13,3,4,6,11,17,-6,10,16,13
27599,16878,16884,17,18,13,0,2,11,6,27,-21,2,24,2
27600,16878,16884,35,8,13,5,4,4,16,16,0,14,12,19
27601,16878,16884,22,1,13,10,3,0,31,9,22,23,3,33
27602,16878,16884,43,2,13,8,3,2,24,13,11,19,7,27
27603,16878,16884,51,9,13,4,4,5,21,23,-2,12,14,16
27604,16878,16884,57,13,13,4,2,7,12,14,-2,10,16,14
27605,16878,16884,49,5,13,6,3,4,20,15,5,15,11,21
27606,16878,16884,46,11,13,3,6,4,13,14,-1,12,14,15
27607,16878,16884,37,14,13,4,2,7,11,19,-8,10,16,14
27608,16878,16884,4,7,13,6,3,4,20,21,-1,15,11,21
27609,16878,16884,27,4,13,6,4,3,17,15,2,16,10,22
27610,16878,16884,45,15,13,3,5,5,16,19,-3,11,15,14
27611,16878,16884,33,10,13,4,4,5,19,23,-4,12,14,16
27612,16878,16884,28,16,13,4,1,8,17,21,-4,9,17,13
27613,16878,16884,25,6,13,6,3,4,20,17,3,15,11,21
27614,16878,16884,12,12,13,3,6,4,12,16,-4,12,14,15
27615,16878,16884,1,3,13,7,3,3,25,12,13,17,9,24
27616,16885,16891,1,3,14,8,3,3,29,13,16,19,9,27
27617,16885,16891,25,5,14,7,3,4,22,17,5,17,11,24
27618,16885,16891,12,13,14,3,7,4,12,16,-4,13,15,16
27619,16885,16891,33,9,14,4,5,5,21,25,-4,13,15,17
27620,16885,16891,28,10,14,5,1,8,19,21,-2,11,17,16
27621,16885,16891,27,7,14,6,5,3,17,15,2,17,11,23
27622,16885,16891,45,16,14,3,5,6,17,23,-6,11,17,14
27623,16885,16891,4,6,14,7,3,4,21,21,0,17,11,24
27624,16885,16891,49,4,14,7,3,4,23,16,7,17,11,24
27625,16885,16891,46,12,14,3,7,4,15,16,-1,13,15,16
27626,16885,16891,37,14,14,4,3,7,13,21,-8,11,17,15
27627,16885,16891,22,1,14,10,4,0,33,11,22,24,4,34
27628,16885,16891,43,2,14,9,3,2,27,15,12,21,7,30
27629,16885,16891,51,11,14,4,4,6,23,26,-3,12,16,16
27630,16885,16891,57,15,14,4,2,8,12,16,-4,10,18,14
27631,16885,16891,35,8,14,5,4,5,17,19,-2,14,14,19
27632,16885,16891,42,17,14,3,4,7,11,18,-7,10,18,13
27633,16885,16891,17,18,14,0,2,12,6,29,-23,2,26,2
27634,16983,16989,42,12,24,7,6,11,22,31,-9,20,28,27
27635,16983,16989,17,18,24,3,3,18,16,48,-32,9,39,12
27636,16983,16989,27,6,24,11,6,7,34,29,5,28,20,39
27637,16983,16989,45,11,24,7,7,10,29,36,-7,21,27,28
27638,16983,16989,25,7,24,10,6,8,30,28,2,26,22,36
27639,16983,16989,12,16,24,4,9,11,20,32,-12,17,31,21
27640,16983,16989,22,1,24,17,5,2,58,21,37,39,9,56
27641,16983,16989,43,2,24,16,6,2,47,24,23,38,10,54
27642,16983,16989,51,9,24,9,7,8,37,38,-1,25,23,34
27643,16983,16989,57,10,24,8,4,12,20,26,-6,20,28,28
27644,16983,16989,35,8,24,9,7,8,34,33,1,25,23,34
27645,16983,16989,49,3,24,15,4,5,51,29,22,34,14,49
27646,16983,16989,46,14,24,5,10,9,24,33,-9,20,28,25
27647,16983,16989,37,17,24,5,5,14,22,43,-21,15,33,20
27648,16983,16989,4,4,24,13,4,7,42,30,12,30,18,43
27649,16983,16989,28,13,24,7,4,13,29,37,-8,18,30,25
27650,16983,16989,33,15,24,5,9,10,33,43,-10,19,29,24
27651,16983,16989,1,5,24,11,6,7,40,27,13,28,20,39
27652,16990,16996,1,5,25,12,6,7,42,27,15,30,20,42
27653,16990,16996,33,13,25,6,9,10,34,43,-9,21,29,27
27654,16990,16996,28,14,25,7,5,13,30,38,-8,19,31,26
27655,16990,16996,4,4,25,14,4,7,43,30,13,32,18,46
27656,16990,16996,49,3,25,15,4,6,51,30,21,34,16,49
27657,16990,16996,46,15,25,5,11,9,24,33,-9,21,29,26
27658,16990,16996,37,17,25,5,5,15,23,45,-22,15,35,20
27659,16990,16996,35,8,25,9,7,9,34,34,0,25,25,34
27660,13378,13398,4,15,31,9,6,16,42,55,-13,24,38,33
27661,13378,13398,12,13,31,9,7,15,37,52,-15,25,37,34
27662,13378,13398,33,3,31,16,9,6,55,36,19,41,21,57
27663,13378,13398,28,11,31,9,8,14,41,52,-11,26,36,35
27664,13378,13398,52,14,31,8,10,13,29,37,-8,26,36,34
27665,13378,13398,6,4,31,15,7,9,44,43,1,37,25,52
27666,13378,13398,35,10,31,10,7,14,43,51,-8,27,35,37
27667,13378,13398,17,1,31,19,10,2,60,32,28,48,14,67
27668,13378,13398,27,12,31,9,7,15,41,48,-7,25,37,34
27669,13378,13398,49,8,31,14,2,15,50,50,0,30,32,44
27670,13378,13398,1,2,31,20,5,6,64,32,32,45,17,65
27671,13378,13398,47,7,31,12,10,9,45,33,12,34,28,46
27672,13154,13160,47,10,5,1,2,2,7,8,-1,4,6,5
27673,13154,13160,1,1,5,3,2,0,13,4,9,8,2,11
27674,13154,13160,49,3,5,3,0,2,7,6,1,6,4,9
27675,13154,13160,27,15,5,1,1,3,5,9,-4,3,7,4
27676,13154,13160,6,13,5,1,2,2,7,12,-5,4,6,5
27677,13154,13160,35,14,5,1,1,3,6,9,-3,3,7,4
27678,13154,13160,33,5,5,2,3,0,9,6,3,7,3,9
27679,13154,13160,52,9,5,1,3,1,4,5,-1,5,5,6
27680,13154,13160,28,16,5,1,1,3,5,12,-7,3,7,4
27681,13154,13160,12,12,5,1,2,2,4,5,-1,4,6,5
27682,13154,13160,17,8,5,1,4,0,9,5,4,6,4,7
27683,13154,13160,4,2,5,3,2,0,11,7,4,8,2,11
27684,13154,13160,21,7,5,2,1,2,8,12,-4,5,5,7
27685,13154,13160,43,4,5,2,3,0,13,3,10,7,3,9
27686,13154,13160,22,6,5,2,2,1,7,5,2,6,4,8
27687,13154,13160,34,11,5,1,2,2,6,7,-1,4,6,5
27688,13154,13160,24,17,5,0,4,1,8,9,-1,4,6,4
27689,13154,13160,57,18,5,0,3,2,4,9,-5,3,7,3
27690,13609,13615,27,13,15,4,5,6,19,30,-11,13,17,17
27691,13609,13615,25,10,15,5,5,5,26,29,-3,15,15,20
27692,13609,13615,12,11,15,6,0,9,25,36,-11,12,18,18
27693,13609,13615,22,3,15,9,2,4,35,21,14,20,10,29
27694,13609,13615,43,6,15,7,2,6,20,18,2,16,14,23
27695,13609,13615,17,7,15,6,4,5,26,19,7,16,14,22
27696,13609,13615,4,9,15,5,5,5,24,22,2,15,15,20
27697,13609,13615,34,15,15,4,3,8,22,29,-7,11,19,15
27698,13609,13615,28,8,15,6,4,5,16,17,-1,16,14,22
27699,13609,13615,33,14,15,4,4,7,16,20,-4,12,18,16
27700,13609,13615,52,16,15,4,2,9,19,38,-19,10,20,14
27701,13609,13615,6,4,15,7,3,5,27,21,6,17,13,24
27702,13609,13615,35,5,15,7,3,5,24,21,3,17,13,24
27703,13609,13615,49,12,15,4,5,6,18,20,-2,13,17,17
27704,13609,13615,37,17,15,3,5,7,17,25,-8,11,19,14
27705,13609,13615,47,2,15,8,6,1,30,15,15,22,8,30
27706,13609,13615,21,18,15,2,2,11,17,31,-14,6,24,8
27707,13609,13615,1,1,15,13,2,0,41,10,31,28,2,41
27708,13756,13762,1,1,33,25,6,2,72,29,43,56,10,81
27709,13756,13762,47,6,33,14,10,9,48,30,18,38,28,52
27710,13756,13762,17,7,33,14,7,12,53,44,9,35,31,49
27711,13756,13762,35,3,33,17,7,9,58,45,13,41,25,58
27712,13756,13762,6,10,33,10,10,13,45,49,-4,30,36,40
27713,13756,13762,27,13,33,9,11,13,45,56,-11,29,37,38
27714,13756,13762,22,2,33,20,6,7,65,38,27,46,20,66
27715,13756,13762,43,4,33,15,9,9,52,37,15,39,27,54
27716,13756,13762,33,12,33,10,8,15,37,45,-8,28,38,38
27717,13756,13762,28,14,33,8,13,12,32,39,-7,29,37,37
27718,13756,13762,52,17,33,7,7,19,34,73,-39,21,45,28
27719,13756,13762,34,15,33,9,9,15,50,64,-14,27,39,36
27720,13756,13762,25,11,33,9,13,11,51,55,-4,31,35,40
27721,13756,13762,12,5,33,16,4,13,67,63,4,36,30,52
27722,13756,13762,49,9,33,11,10,12,52,46,6,32,34,43
27723,13756,13762,37,16,33,7,11,15,30,47,-17,25,41,32
27724,13756,13762,4,8,33,10,14,9,46,43,3,34,32,44
27725,13756,13762,21,18,33,5,7,21,35,69,-34,17,49,22
27726,13546,13559,22,3,8,5,1,2,19,10,9,11,5,16
27727,13546,13559,43,6,8,4,0,4,10,10,0,8,8,12
27728,13546,13559,34,12,8,2,3,3,14,12,2,7,9,9
27729,13546,13559,49,13,8,2,3,3,9,9,0,7,9,9
27730,13546,13559,37,16,8,1,3,4,8,13,-5,5,11,6
27731,13546,13559,4,7,8,3,3,2,16,12,4,9,7,12
27732,13546,13559,21,18,8,1,0,7,7,18,-11,2,14,3
27733,13546,13559,25,9,8,3,2,3,15,18,-3,8,8,11
27734,13546,13559,12,11,8,3,0,5,10,22,-12,6,10,9
27735,13546,13559,33,14,8,2,3,3,7,7,0,7,9,9
27736,13546,13559,52,15,8,2,1,5,9,17,-8,5,11,7
27737,13546,13559,28,17,8,1,3,4,4,14,-10,5,11,6
27738,13546,13559,6,2,8,6,1,1,20,8,12,13,3,19
27739,13546,13559,35,4,8,4,1,3,16,13,3,9,7,13
27740,14123,14126,12,6,32,16,6,10,64,55,9,38,26,54
27741,14123,14126,25,12,32,11,6,15,52,56,-4,28,36,39
27742,14123,14126,33,4,32,18,8,6,73,46,27,44,20,62
27743,14123,14126,28,7,32,14,8,10,50,43,7,36,28,50
27744,14123,14126,22,1,32,21,7,4,70,32,38,49,15,70
27745,14123,14126,43,3,32,19,7,6,68,36,32,45,19,64
27746,14123,14126,34,13,32,8,7,17,43,65,-22,23,41,31
27747,14123,14126,49,5,32,17,3,12,53,40,13,37,27,54
27748,14123,14126,37,15,32,7,5,20,30,58,-28,19,45,26
27749,14344,14374,49,8,17,8,2,7,28,31,-3,18,16,26
27750,14344,14374,37,14,17,3,5,9,21,35,-14,11,23,14
27751,14344,14374,4,5,17,10,0,7,48,34,14,20,14,30
27752,14344,14374,33,9,17,7,4,6,34,26,8,18,16,25
27753,14344,14374,28,16,17,3,4,10,18,38,-20,10,24,13
27754,14344,14374,43,1,17,13,3,1,47,19,28,29,5,42
27755,14344,14374,22,2,17,10,5,2,43,22,21,25,9,35
27756,14344,14374,34,10,17,7,2,8,32,30,2,16,18,23
27757,14344,14374,24,11,17,7,2,8,25,40,-15,16,18,23
27758,14344,14374,27,13,17,4,5,8,20,29,-9,13,21,17
27759,14344,14374,25,7,17,8,4,5,38,36,2,20,14,28
27760,14344,14374,12,12,17,5,5,7,31,34,-3,15,19,20
27761,14344,14374,58,18,17,1,8,8,11,33,-22,10,24,11
27762,14344,14374,47,15,17,3,4,10,26,34,-8,10,24,13
27763,14344,14374,17,4,17,9,4,4,30,20,10,22,12,31
27764,14344,14374,35,6,17,9,3,5,30,24,6,21,13,30
27765,14344,14374,6,17,17,1,8,8,14,32,-18,10,24,11
27766,14344,14374,1,3,17,10,2,5,37,16,21,22,12,32
27767,14386,14392,1,3,20,12,2,6,47,22,25,26,14,38
27768,14386,14392,35,6,20,10,5,5,38,30,8,25,15,35
27769,14386,14392,6,17,20,1,9,10,18,39,-21,11,29,12
27770,14386,14392,17,5,20,10,5,5,36,25,11,25,15,35
27771,14386,14392,47,15,20,4,4,12,32,44,-12,12,28,16
27772,14386,14392,25,9,20,8,6,6,40,42,-2,22,18,30
27773,14386,14392,12,12,20,7,5,8,37,41,-4,19,21,26
27774,14386,14392,58,18,20,1,9,10,13,37,-24,11,29,12
27775,14386,14392,27,14,20,4,6,10,23,38,-15,14,26,18
27776,14386,14392,43,1,20,15,4,1,51,19,32,34,6,49
27777,14386,14392,22,2,20,11,6,3,45,24,21,28,12,39
27778,14386,14392,34,10,20,8,2,10,39,40,-1,18,22,26
27779,14386,14392,24,11,20,8,2,10,32,48,-16,18,22,26
27780,14386,14392,33,8,20,9,4,7,41,31,10,22,18,31
27781,14386,14392,28,16,20,4,4,12,20,43,-23,12,28,16
27782,14386,14392,4,7,20,11,1,8,51,40,11,23,17,34
27783,14386,14392,49,4,20,11,2,7,41,34,7,24,16,35
27784,14386,14392,37,13,20,5,6,9,30,37,-7,16,24,21
27785,14442,14448,37,14,27,7,7,13,39,51,-12,21,33,28
27786,14442,14448,49,2,27,17,2,8,61,39,22,36,18,53
27787,14442,14448,28,15,27,6,5,16,29,56,-27,17,37,23
27788,14442,14448,33,6,27,14,5,8,57,39,18,33,21,47
27789,14442,14448,43,1,27,19,7,1,71,25,46,45,9,64
27790,14442,14448,22,8,27,12,6,9,52,46,6,30,24,42
27791,14442,14448,34,10,27,11,2,14,49,55,-6,24,30,35
27792,14442,14448,24,11,27,10,5,12,40,56,-16,25,29,35
27793,14442,14448,27,16,27,5,6,16,31,55,-24,16,38,21
27794,14442,14448,4,3,27,16,2,9,63,45,18,34,20,50
27795,14442,14448,12,12,27,9,8,10,44,50,-6,26,28,35
27796,14442,14448,58,17,27,3,10,14,21,48,-27,16,38,19
27797,14442,14448,25,9,27,11,7,9,48,57,-9,29,25,40
27798,14442,14448,17,5,27,14,5,8,56,34,22,33,21,47
27799,14442,14448,47,13,27,8,4,15,43,55,-12,20,34,28
27800,14442,14448,6,18,27,3,10,14,27,55,-28,16,38,19
27801,14442,14448,35,7,27,12,7,8,43,37,6,31,23,43
27802,14442,14448,1,4,27,15,4,8,56,27,29,34,20,49
27803,14239,14252,1,1,4,4,0,0,13,2,11,8,0,12
27804,14239,14252,35,7,4,2,0,2,7,7,0,4,4,6
27805,14239,14252,6,9,4,1,2,1,8,9,-1,4,4,5
27806,14239,14252,33,11,4,1,1,2,5,7,-2,3,5,4
27807,14239,14252,47,15,4,0,2,2,4,8,-4,2,6,2
27808,14239,14252,17,5,4,3,0,1,9,6,3,6,2,9
27809,14239,14252,27,12,4,1,0,3,6,8,-2,2,6,3
27810,14239,14252,43,2,4,3,1,0,14,7,7,7,1,10
27811,14239,14252,22,6,4,2,2,0,13,7,6,6,2,8
27812,14239,14252,24,8,4,2,0,2,6,6,0,4,4,6
27813,14239,14252,34,10,4,1,1,2,7,8,-1,3,5,4
27814,14239,14252,37,18,4,0,1,3,5,12,-7,1,7,1
27815,14239,14252,49,13,4,1,0,3,3,9,-6,2,6,3
27816,14239,14252,28,17,4,0,2,2,3,9,-6,2,6,2
27817,14239,14252,4,4,4,3,0,1,10,5,5,6,2,9
27818,14239,14252,25,3,4,3,1,0,13,8,5,7,1,10
27819,9514,9520,2,17,4,0,2,2,3,9,-6,2,6,2
27820,9514,9520,43,2,4,3,1,0,10,1,9,7,1,10
27821,9514,9520,24,8,4,1,2,1,4,2,2,4,4,5
27822,9514,9520,21,15,4,0,3,1,2,3,-1,3,5,3
27823,9514,9520,4,5,4,2,0,2,5,9,-4,4,4,6
27824,9514,9520,1,1,4,3,1,0,14,3,11,7,1,10
27825,9962,9968,57,12,18,6,4,8,26,26,0,16,20,22
27826,9962,9968,2,16,18,4,2,12,13,32,-19,10,26,14
27827,9962,9968,22,17,18,4,1,13,18,51,-33,9,27,13
27828,9962,9968,24,3,18,12,2,4,27,16,11,26,10,38
27829,9962,9968,43,5,18,8,6,4,32,15,17,22,14,30
27830,9962,9968,27,9,18,6,6,6,21,26,-5,18,18,24
27831,9962,9968,53,8,18,7,4,7,23,22,1,18,18,25
27832,9962,9968,12,10,18,6,5,7,24,23,1,17,19,23
27833,9962,9968,28,11,18,6,5,7,15,22,-7,17,19,23
27834,9962,9968,52,13,18,5,6,7,17,23,-6,16,20,21
27835,9962,9968,20,4,18,10,2,6,35,24,11,22,14,32
27836,9962,9968,41,6,18,7,8,3,29,20,9,22,14,29
27837,9962,9968,56,15,18,4,4,10,20,36,-16,12,24,16
27838,9962,9968,49,7,18,7,4,7,28,27,1,18,18,25
27839,9962,9968,37,18,18,2,7,9,16,22,-6,11,25,13
27840,9962,9968,21,1,18,12,6,0,43,15,28,30,6,42
27841,9962,9968,4,14,18,6,1,11,19,30,-11,13,23,19
27842,9962,9968,1,2,18,12,3,3,43,19,24,27,9,39
27843,10004,10010,1,3,20,13,3,4,47,25,22,29,11,42
27844,10004,10010,52,10,20,6,7,7,23,24,-1,19,21,25
27845,10004,10010,28,13,20,6,5,9,16,25,-9,17,23,23
27846,10004,10010,21,1,20,13,6,1,50,19,31,32,8,45
27847,10004,10010,49,7,20,8,4,8,32,28,4,20,20,28
27848,10004,10010,37,16,20,3,7,10,21,25,-4,13,27,16
27849,10004,10010,20,4,20,12,2,6,39,25,14,26,14,38
27850,10004,10010,41,6,20,8,9,3,30,20,10,25,15,33
27851,10004,10010,53,9,20,8,4,8,28,26,2,20,20,28
27852,10004,10010,12,12,20,6,5,9,26,27,-1,17,23,23
27853,10004,10010,27,11,20,6,6,8,22,33,-11,18,22,24
27854,10004,10010,24,2,20,14,2,4,30,16,14,30,10,44
27855,10004,10010,43,5,20,9,6,5,36,19,17,24,16,33
27856,10004,10010,57,8,20,8,4,8,30,27,3,20,20,28
27857,10004,10010,2,17,20,4,3,13,15,39,-24,11,29,15
27858,10004,10010,22,18,20,4,2,14,20,56,-36,10,30,14
27859,10004,10010,4,14,20,6,2,12,19,35,-16,14,26,20
27860,10004,10010,56,15,20,5,5,10,22,37,-15,15,25,20
27861,9860,9863,24,8,4,2,1,1,4,4,0,5,3,7
27862,9860,9863,43,9,4,1,3,0,2,1,1,5,3,6
27863,9860,9863,2,13,4,1,1,2,5,8,-3,3,5,4
27864,9860,9863,22,14,4,1,0,3,3,12,-9,2,6,3
27865,9860,9863,57,15,4,0,2,2,5,7,-2,2,6,2
27866,9860,9863,12,4,4,2,2,0,4,2,2,6,2,8
27867,9860,9863,53,6,4,2,1,1,4,2,2,5,3,7
27868,9860,9863,41,3,4,2,2,0,8,3,5,6,2,8
27869,9860,9863,20,5,4,2,1,1,8,3,5,5,3,7
27870,9860,9863,56,17,4,0,2,2,3,8,-5,2,6,2
27871,9860,9863,52,7,4,2,1,1,8,7,1,5,3,7
27872,9860,9863,28,10,4,1,2,1,4,4,0,4,4,5
27873,9860,9863,21,1,4,3,1,0,12,3,9,7,1,10
27874,9860,9863,4,18,4,0,0,4,3,10,-7,0,8,0
27875,9860,9863,49,11,4,1,1,2,6,6,0,3,5,4
27876,9860,9863,37,12,4,1,1,2,5,5,0,3,5,4
27877,9860,9863,1,2,4,3,1,0,8,4,4,7,1,10
27878,9860,9863,27,16,4,0,2,2,3,6,-3,2,6,2
27879,10207,10209,27,14,1,0,0,1,0,3,-3,0,2,0
27880,10207,10209,21,8,1,0,1,0,2,2,0,1,1,1
27881,10207,10209,17,10,1,0,1,0,1,1,0,1,1,1
27882,10207,10209,28,3,1,1,0,0,3,0,3,2,0,3
27883,10207,10209,54,12,1,0,0,1,0,2,-2,0,2,0
27884,10207,10209,52,14,1,0,0,1,0,3,-3,0,2,0
27885,10207,10209,12,1,1,1,0,0,4,0,4,2,0,3
27886,10207,10209,53,17,1,0,0,1,0,4,-4,0,2,0
27887,10207,10209,24,1,1,1,0,0,4,0,4,2,0,3
27888,10207,10209,43,3,1,1,0,0,3,0,3,2,0,3
27889,10207,10209,22,14,1,0,0,1,0,3,-3,0,2,0
27890,10207,10209,57,17,1,0,0,1,0,4,-4,0,2,0
27891,10207,10209,1,6,1,1,0,0,2,0,2,2,0,3
27892,10207,10209,41,3,1,1,0,0,3,0,3,2,0,3
27893,10207,10209,20,6,1,1,0,0,2,0,2,2,0,3
27894,10207,10209,56,10,1,0,1,0,1,1,0,1,1,1
27895,10207,10209,37,8,1,0,1,0,2,2,0,1,1,1
27896,10207,10209,49,12,1,0,0,1,0,2,-2,0,2,0
27897,10431,10433,24,1,27,21,5,1,54,14,40,47,7,68
27898,10431,10433,43,2,27,16,8,3,65,28,37,40,14,56
27899,10431,10433,57,14,27,7,6,14,29,38,-9,20,34,27
27900,16990,16996,22,1,25,17,6,2,59,22,37,40,10,57
27901,16990,16996,43,2,25,16,7,2,48,25,23,39,11,55
27902,16990,16996,51,9,25,9,7,9,38,41,-3,25,25,34
27903,16990,16996,57,11,25,8,5,12,20,26,-6,21,29,29
27904,16990,16996,25,7,25,10,6,9,30,30,0,26,24,36
27905,16990,16996,12,16,25,4,10,11,21,33,-12,18,32,22
27906,16990,16996,27,6,25,12,6,7,35,29,6,30,20,42
27907,16990,16996,45,10,25,8,7,10,31,37,-6,23,27,31
27908,16990,16996,42,12,25,7,6,12,22,32,-10,20,30,27
27909,16990,16996,17,18,25,4,3,18,19,49,-30,11,39,15
27910,16815,16821,42,10,6,2,2,2,5,4,1,6,6,8
27911,16815,16821,17,18,6,0,1,5,3,11,-8,1,11,1
27912,16815,16821,25,3,6,3,2,1,10,6,4,8,4,11
27913,16815,16821,12,8,6,2,3,1,7,6,1,7,5,9
27914,16815,16821,43,1,6,5,1,0,13,6,7,11,1,16
27915,16815,16821,22,2,6,4,2,0,14,6,8,10,2,14
27916,16815,16821,57,12,6,2,1,3,6,7,-1,5,7,7
27917,16815,16821,51,13,6,1,3,2,12,13,-1,5,7,6
27918,16815,16821,35,7,6,3,1,2,5,5,0,7,5,10
27919,16815,16821,46,6,6,3,1,2,7,6,1,7,5,10
27920,16815,16821,49,9,6,2,2,2,9,8,1,6,6,8
27921,16815,16821,37,17,6,1,1,4,5,11,-6,3,9,4
27922,16815,16821,4,15,6,1,2,3,6,14,-8,4,8,5
27923,16815,16821,27,4,6,3,2,1,9,7,2,8,4,11
27924,16815,16821,45,14,6,1,2,3,6,9,-3,4,8,5
27925,16815,16821,33,11,6,2,2,2,9,9,0,6,6,8
27926,16815,16821,28,16,6,1,1,4,8,12,-4,3,9,4
27927,16815,16821,1,5,6,3,1,2,12,6,6,7,5,10
27928,17221,17227,42,14,11,2,3,6,12,17,-5,7,15,9
27929,17221,17227,12,7,11,5,3,3,10,8,2,13,9,18
27930,17221,17227,25,13,11,3,3,5,12,10,2,9,13,12
27931,17221,17227,33,4,11,6,2,3,20,12,8,14,8,20
27932,17221,17227,28,18,11,1,1,9,8,23,-15,3,19,4
27933,17221,17227,27,8,11,5,2,4,13,11,2,12,10,17
27934,17221,17227,45,11,11,4,3,4,15,17,-2,11,11,15
27935,17221,17227,4,9,11,4,5,2,21,13,8,13,9,17
27936,17221,17227,49,1,11,7,4,0,27,10,17,18,4,25
27937,17221,17227,46,15,11,2,1,8,7,20,-13,5,17,7
27938,17221,17227,23,16,11,1,3,7,7,21,-14,5,17,6
27939,17221,17227,35,10,11,4,3,4,14,13,1,11,11,15
27940,17221,17227,1,2,11,7,3,1,18,10,8,17,5,24
27941,17221,17227,57,3,11,6,3,2,24,11,13,15,7,21
27942,17221,17227,43,5,11,5,5,1,16,10,6,15,7,20
27943,17221,17227,22,6,11,5,4,2,14,14,0,14,8,19
27944,17221,17227,51,12,11,3,5,3,12,19,-7,11,11,14
27945,17221,17227,24,17,11,0,5,6,10,21,-11,5,17,5
27946,17270,17276,57,3,16,9,4,3,35,15,20,22,10,31
27947,17270,17276,22,5,16,8,5,3,26,19,7,21,11,29
27948,17270,17276,43,7,16,6,6,4,22,18,4,18,14,24
27949,17270,17276,12,10,16,5,6,5,15,16,-1,16,16,21
27950,17270,17276,25,12,16,5,5,6,20,16,4,15,17,20
27951,17270,17276,1,1,16,11,4,1,24,12,12,26,6,37
27952,17270,17276,35,4,16,9,3,4,25,14,11,21,11,30
27953,17270,17276,51,13,16,5,5,6,23,31,-8,15,17,20
27954,17270,17276,24,15,16,2,6,8,21,31,-10,10,22,12
27955,17270,17276,49,2,16,9,7,0,33,11,22,25,7,34
27956,17270,17276,23,14,16,3,4,9,12,27,-15,10,22,13
27957,17270,17276,46,17,16,3,2,11,13,35,-22,8,24,11
27958,17270,17276,4,6,16,7,6,3,32,19,13,20,12,27
27959,17270,17276,45,9,16,6,3,7,23,28,-5,15,17,21
27960,17270,17276,27,11,16,6,2,8,18,22,-4,14,18,20
27961,17270,17276,33,8,16,6,4,6,23,21,2,16,16,22
27962,17270,17276,28,16,16,3,2,11,14,32,-18,8,24,11
27963,17270,17276,42,18,16,2,4,10,16,28,-12,8,24,10
27964,17326,17332,42,16,21,4,4,13,22,35,-13,12,30,16
27965,17326,17332,33,12,21,6,5,10,24,30,-6,17,25,23
27966,17326,17332,45,9,21,8,4,9,28,36,-8,20,22,28
27967,17326,17332,27,10,21,7,4,10,23,29,-6,18,24,25
27968,17326,17332,28,17,21,3,6,12,17,36,-19,12,30,15
27969,17326,17332,49,2,21,12,9,0,40,13,27,33,9,45
27970,17326,17332,23,15,21,5,4,12,20,36,-16,14,28,19
27971,17326,17332,4,6,21,9,7,5,41,28,13,25,17,34
27972,17326,17332,46,18,21,3,2,16,17,49,-32,8,34,11
27973,17326,17332,57,3,21,13,5,3,50,19,31,31,11,44
27974,17326,17332,43,5,21,10,7,4,31,22,9,27,15,37
27975,17326,17332,22,7,21,8,7,6,32,33,-1,23,19,31
27976,17326,17332,51,13,21,5,8,8,26,36,-10,18,24,23
27977,17326,17332,24,14,21,5,6,10,25,34,-9,16,26,21
27978,17326,17332,1,1,21,14,6,1,31,13,18,34,8,48
27979,17326,17332,35,4,21,12,4,5,33,19,14,28,14,40
27980,13546,13559,17,8,8,3,2,3,16,12,4,8,8,11
27981,13546,13559,27,10,8,3,2,3,10,18,-8,8,8,11
27982,13546,13559,47,5,8,3,4,1,13,8,5,10,6,13
27983,13546,13559,1,1,8,8,0,0,22,4,18,16,0,24
27984,14113,14119,1,2,30,19,5,6,55,31,24,43,17,62
27985,14113,14119,4,8,30,13,8,9,49,52,-3,34,26,47
27986,14113,14119,9,18,30,2,10,18,24,68,-44,14,46,16
27987,14113,14119,47,11,30,10,9,11,42,42,0,29,31,39
27988,14113,14119,27,14,30,6,11,13,36,47,-11,23,37,29
27989,14113,14119,17,9,30,13,6,11,58,43,15,32,28,45
27990,14113,14119,35,10,30,12,6,12,42,42,0,30,30,42
27991,14113,14119,6,15,30,6,6,18,28,46,-18,18,42,24
27992,14113,14119,56,17,30,5,6,19,41,73,-32,16,44,21
27993,14113,14119,33,3,30,17,7,6,68,44,24,41,19,58
27994,14113,14119,28,7,30,14,7,9,47,37,10,35,25,49
27995,14113,14119,12,6,30,15,6,9,60,51,9,36,24,51
27996,14113,14119,25,12,30,11,5,14,51,54,-3,27,33,38
27997,14113,14119,49,5,30,17,2,11,52,33,19,36,24,53
27998,14113,14119,37,16,30,6,5,19,28,55,-27,17,43,23
27999,14113,14119,22,1,30,19,7,4,63,31,32,45,15,64
28000,14113,14119,43,4,30,17,7,6,58,36,22,41,19,58
28001,14113,14119,34,13,30,8,7,15,41,58,-17,23,37,31
28002,13885,13888,34,15,5,1,1,3,8,10,-2,3,7,4
28003,13885,13888,43,18,5,0,2,3,5,13,-8,2,8,2
28004,13885,13888,49,5,5,3,0,2,9,5,4,6,4,9
28005,13885,13888,37,16,5,1,1,3,5,9,-4,3,7,4
28006,13885,13888,12,1,5,4,1,0,13,2,11,9,1,13
28007,13885,13888,25,2,5,4,0,1,13,5,8,8,2,12
28008,13885,13888,22,4,5,3,1,1,7,5,2,7,3,10
28009,13885,13888,33,6,5,2,3,0,7,3,4,7,3,9
28010,13885,13888,28,8,5,2,1,2,8,6,2,5,5,7
28011,13885,13888,17,9,5,2,0,3,10,11,-1,4,6,6
28012,13885,13888,27,7,5,2,2,1,9,5,4,6,4,8
28013,13885,13888,6,10,5,2,0,3,4,6,-2,4,6,6
28014,13885,13888,35,11,5,2,0,3,4,11,-7,4,6,6
28015,13885,13888,56,17,5,1,0,4,4,14,-10,2,8,3
28016,13885,13888,47,13,5,1,2,2,6,7,-1,4,6,5
28017,13885,13888,1,3,5,3,1,1,8,5,3,7,3,10
28018,13885,13888,9,12,5,1,3,1,4,5,-1,5,5,6
28019,13885,13888,4,14,5,1,2,2,5,7,-2,4,6,5
28020,14375,14378,1,3,18,11,2,5,38,16,22,24,12,35
28021,14375,14378,47,15,18,4,4,10,30,35,-5,12,24,16
28022,14375,14378,17,4,18,9,5,4,31,21,10,23,13,32
28023,14375,14378,27,14,18,4,5,9,21,33,-12,13,23,17
28024,14375,14378,35,6,18,9,4,5,31,25,6,22,14,31
28025,14375,14378,6,18,18,1,8,9,15,34,-19,10,26,11
28026,14375,14378,58,17,18,1,9,8,12,34,-22,11,25,12
28027,14375,14378,33,9,18,7,4,7,34,28,6,18,18,25
28028,14375,14378,28,16,18,3,4,11,18,39,-21,10,26,13
28029,14375,14378,43,1,18,14,3,1,49,19,30,31,5,45
28030,14375,14378,22,2,18,10,6,2,44,23,21,26,10,36
28031,14375,14378,34,10,18,7,2,9,34,34,0,16,20,23
28032,14375,14378,24,11,18,7,2,9,27,44,-17,16,20,23
28033,14375,14378,25,8,18,8,5,5,39,37,2,21,15,29
28034,14375,14378,12,12,18,6,5,7,33,35,-2,17,19,23
28035,14375,14378,49,7,18,9,2,7,32,33,-1,20,16,29
28036,14375,14378,37,13,18,4,5,9,25,37,-12,13,23,17
28037,14375,14378,4,5,18,10,1,7,49,35,14,21,15,31
28038,14414,14427,43,1,24,17,6,1,64,23,41,40,8,57
28039,14414,14427,22,5,24,12,6,6,51,37,14,30,18,42
28040,14414,14427,24,10,24,10,3,11,39,53,-14,23,25,33
28041,14414,14427,49,2,24,15,2,7,55,36,19,32,16,47
28042,14414,14427,37,14,24,6,6,12,35,46,-11,18,30,24
28043,14414,14427,34,12,24,9,2,13,43,50,-7,20,28,29
28044,14414,14427,33,8,24,12,4,8,51,36,15,28,20,40
28045,14414,14427,28,16,24,5,4,15,24,52,-28,14,34,19
28046,14414,14427,17,7,24,12,5,7,48,31,17,29,19,41
28047,14414,14427,25,9,24,10,6,8,45,53,-8,26,22,36
28048,14414,14427,12,11,24,8,6,10,42,50,-8,22,26,30
28049,14414,14427,58,17,24,3,9,12,19,43,-24,15,33,18
28050,14414,14427,27,15,24,5,6,13,28,48,-20,16,32,21
28051,14414,14427,35,6,24,12,6,6,42,33,9,30,18,42
28052,14414,14427,6,18,24,1,10,13,22,50,-28,12,36,13
28053,14414,14427,47,13,24,7,4,13,42,50,-8,18,30,25
28054,14414,14427,1,4,24,13,4,7,52,25,27,30,18,43
28055,14414,14427,4,3,24,14,1,9,58,44,14,29,19,43
28056,14477,14490,4,3,32,19,3,10,74,51,23,41,23,60
28057,14477,14490,1,2,32,19,4,9,65,31,34,42,22,61
28058,14477,14490,47,15,32,9,5,18,52,69,-17,23,41,32
28059,14239,14252,58,14,4,0,3,1,3,7,-4,3,5,3
28060,14239,14252,12,16,4,0,2,2,3,7,-4,2,6,2
28061,14687,14693,49,3,13,8,3,2,35,15,20,19,7,27
28062,14687,14693,37,11,13,4,3,6,12,27,-15,11,15,15
28063,14687,14693,33,6,13,7,1,5,28,14,14,15,11,22
28064,14687,14693,28,14,13,3,3,7,15,24,-9,9,17,12
28065,14687,14693,43,2,13,10,3,0,41,14,27,23,3,33
28066,14687,14693,22,12,13,3,6,4,15,14,1,12,14,15
28067,14687,14693,34,15,13,3,2,8,16,33,-17,8,18,11
28068,14687,14693,40,17,13,1,4,8,11,27,-16,6,20,7
28069,14687,14693,24,18,13,1,3,9,15,29,-14,5,21,6
28070,14687,14693,27,4,13,8,0,5,22,25,-3,16,10,24
28071,14687,14693,1,1,13,13,0,0,51,8,43,26,0,39
28072,14687,14693,4,5,13,7,2,4,29,22,7,16,10,23
28073,14687,14693,21,13,13,4,1,8,13,21,-8,9,17,13
28074,14687,14693,17,8,13,6,2,5,23,21,2,14,12,20
28075,14687,14693,25,7,13,6,3,4,21,21,0,15,11,21
28076,14687,14693,12,10,13,4,5,4,14,20,-6,13,13,17
28077,14687,14693,47,16,13,2,1,10,16,41,-25,5,21,7
28078,14687,14693,35,9,13,6,0,7,21,22,-1,12,14,18
28079,14827,14833,33,6,28,13,6,9,55,39,16,32,24,45
28080,14827,14833,28,17,28,5,6,17,27,47,-20,16,40,21
28081,14827,14833,35,5,28,15,3,10,51,38,13,33,23,48
28082,14827,14833,47,16,28,6,3,19,30,70,-40,15,41,21
28083,14827,14833,17,9,28,12,6,10,39,33,6,30,26,42
28084,14827,14833,1,2,28,18,9,1,71,23,48,45,11,63
28085,14827,14833,12,7,28,12,8,8,40,34,6,32,24,44
28086,14827,14833,25,8,28,12,7,9,50,44,6,31,25,43
28087,14827,14833,4,4,28,14,7,7,50,39,11,35,21,49
28088,14827,14833,21,11,28,10,4,14,32,39,-7,24,32,34
28089,14827,14833,27,10,28,11,5,12,43,50,-7,27,29,38
28090,14827,14833,43,1,28,20,7,1,73,24,49,47,9,67
28091,14827,14833,22,12,28,9,7,12,34,39,-5,25,31,34
28092,14827,14833,34,14,28,6,7,15,27,56,-29,19,37,25
28093,14827,14833,40,15,28,4,10,14,24,47,-23,18,38,22
28094,14827,14833,24,18,28,4,7,17,35,61,-26,15,41,19
28095,14827,14833,49,3,28,14,9,5,64,34,30,37,19,51
28096,14827,14833,37,13,28,8,7,13,24,52,-28,23,33,31
28097,14848,14854,49,3,31,15,11,5,69,38,31,41,21,56
28098,14848,14854,27,9,31,13,5,13,49,54,-5,31,31,44
28099,14848,14854,4,4,31,15,8,8,56,45,11,38,24,53
28100,14848,14854,21,12,31,10,5,16,34,44,-10,25,37,35
28101,14848,14854,12,7,31,13,9,9,48,40,8,35,27,48
28102,14848,14854,25,8,31,13,8,10,56,51,5,34,28,47
28103,14848,14854,43,1,31,22,8,1,81,24,57,52,10,74
28104,14848,14854,22,11,31,10,9,12,42,43,-1,29,33,39
28105,14848,14854,40,15,31,5,11,15,27,50,-23,21,41,26
28106,14848,14854,34,17,31,6,7,18,28,60,-32,19,43,25
28107,14848,14854,24,18,31,4,9,18,39,67,-28,17,45,21
28108,14848,14854,1,2,31,21,9,1,75,23,52,51,11,72
28109,14848,14854,17,10,31,12,6,13,43,42,1,30,32,42
28110,14848,14854,47,16,31,7,4,20,33,73,-40,18,44,25
28111,14848,14854,35,5,31,16,3,12,55,48,7,35,27,51
28112,14848,14854,33,6,31,14,7,10,58,45,13,35,27,49
28113,14848,14854,28,14,31,7,7,17,35,52,-17,21,41,28
28114,14848,14854,37,13,31,9,8,14,27,56,-29,26,36,35
28115,14613,14616,35,9,4,2,0,2,6,5,1,4,4,6
28116,14613,14616,47,17,4,0,1,3,5,13,-8,1,7,1
28117,14613,14616,17,4,4,3,0,1,7,2,5,6,2,9
28118,14613,14616,25,6,4,3,0,1,7,5,2,6,2,9
28119,14613,14616,12,8,4,2,1,1,6,5,1,5,3,7
28120,14613,14616,43,2,4,3,1,0,13,5,8,7,1,10
28121,14613,14616,22,11,4,1,2,1,6,5,1,4,4,5
28122,14613,14616,49,10,4,2,0,2,7,8,-1,4,4,6
28123,14613,14616,37,13,4,1,0,3,3,8,-5,2,6,3
28124,14613,14616,27,5,4,3,0,1,10,8,2,6,2,9
28125,14613,14616,1,1,4,4,0,0,15,4,11,8,0,12
28126,14613,14616,28,14,4,0,2,2,3,5,-2,2,6,2
28127,14613,14616,40,15,4,0,2,2,2,10,-8,2,6,2
28128,14613,14616,24,16,4,0,1,3,4,10,-6,1,7,1
28129,14613,14616,34,18,4,0,0,4,3,12,-9,0,8,0
28130,14613,14616,33,3,4,3,0,1,11,3,8,6,2,9
28131,14613,14616,4,7,4,3,0,1,10,9,1,6,2,9
28132,14613,14616,21,12,4,1,0,3,3,4,-1,2,6,3
28133,15058,15064,33,8,13,6,0,7,25,16,9,12,14,18
28134,15058,15064,28,9,13,5,3,5,21,20,1,13,13,18
28135,15058,15064,52,16,13,3,2,8,15,25,-10,8,18,11
28136,15058,15064,22,3,13,8,4,1,38,17,21,20,6,28
28137,15058,15064,43,5,13,7,4,2,26,14,12,18,8,25
28138,10431,10433,22,18,27,2,9,16,16,53,-37,13,41,15
28139,10431,10433,28,7,27,10,8,9,34,39,-5,28,26,38
28140,10431,10433,52,13,27,8,3,16,27,50,-23,19,35,27
28141,10431,10433,54,17,27,6,6,15,27,49,-22,18,36,24
28142,10431,10433,41,4,27,13,9,5,50,19,31,35,19,48
28143,10431,10433,56,8,27,8,13,6,42,34,8,29,25,37
28144,10431,10433,20,9,27,10,5,12,40,41,-1,25,29,35
28145,10431,10433,17,11,27,8,7,12,21,38,-17,23,31,31
28146,10431,10433,21,3,27,14,9,4,53,29,24,37,17,51
28147,10431,10433,49,6,27,12,8,7,40,32,8,32,22,44
28148,10431,10433,37,10,27,9,6,12,33,38,-5,24,30,33
28149,10431,10433,27,12,27,5,13,9,23,40,-17,23,31,28
28150,10431,10433,12,15,27,6,8,13,33,48,-15,20,34,26
28151,10431,10433,53,16,27,6,8,13,31,46,-15,20,34,26
28152,10431,10433,1,5,27,12,9,6,49,31,18,33,21,45
28153,10452,10458,1,5,31,14,9,8,58,39,19,37,25,51
28154,10452,10458,21,4,31,14,10,7,55,36,19,38,24,52
28155,10452,10458,49,6,31,14,8,9,43,35,8,36,26,50
28156,10452,10458,37,10,31,10,8,13,37,44,-7,28,34,38
28157,10452,10458,41,3,31,16,10,5,56,19,37,42,20,58
28158,10452,10458,56,8,31,9,14,8,49,40,9,32,30,41
28159,10452,10458,20,9,31,11,6,14,47,48,-1,28,34,39
28160,10452,10458,28,7,31,11,10,10,37,42,-5,32,30,43
28161,10452,10458,52,11,31,10,4,17,31,52,-21,24,38,34
28162,10452,10458,54,14,31,9,6,16,32,51,-19,24,38,33
28163,10452,10458,12,15,31,8,9,14,40,53,-13,25,37,33
28164,10452,10458,53,16,31,8,8,15,37,54,-17,24,38,32
28165,10452,10458,27,17,31,6,14,11,26,44,-18,26,36,32
28166,10452,10458,24,1,31,23,6,2,58,16,42,52,10,75
28167,10452,10458,43,2,31,19,9,3,73,32,41,47,15,66
28168,10452,10458,57,12,31,9,7,15,35,45,-10,25,37,34
28169,10452,10458,22,18,31,2,9,20,20,66,-46,13,49,15
28170,10452,10458,17,13,31,9,7,15,26,44,-18,25,37,34
28171,10578,10591,17,16,2,0,1,1,0,4,-4,1,3,1
28172,10578,10591,24,1,2,2,0,0,4,0,4,4,0,6
28173,10578,10591,43,2,2,1,1,0,8,2,6,3,1,4
28174,10578,10591,57,8,2,1,0,1,2,2,0,2,2,3
28175,10578,10591,27,6,2,1,0,1,4,3,1,2,2,3
28176,10578,10591,12,5,2,1,1,0,4,3,1,3,1,4
28177,10578,10591,53,14,2,0,2,0,0,0,0,2,2,2
28178,10578,10591,28,15,2,0,1,1,1,3,-2,1,3,1
28179,10578,10591,54,18,2,0,0,2,3,7,-4,0,4,0
28180,10578,10591,56,4,2,1,1,0,4,2,2,3,1,4
28181,10578,10591,41,7,2,1,0,1,2,1,1,2,2,3
28182,10578,10591,20,10,2,1,0,1,2,7,-5,2,2,3
28183,10578,10591,35,17,2,0,0,2,1,4,-3,0,4,0
28184,10578,10591,49,3,2,1,1,0,5,1,4,3,1,4
28185,10578,10591,37,13,2,0,2,0,1,1,0,2,2,2
28186,10578,10591,4,9,2,1,0,1,3,4,-1,2,2,3
28187,10578,10591,21,11,2,0,2,0,2,2,0,2,2,2
28188,10578,10591,1,11,2,0,2,0,2,2,0,2,2,2
28189,10802,10808,1,1,28,20,6,2,61,19,42,46,10,66
28190,10802,10808,12,8,28,9,8,11,28,49,-21,26,30,35
28191,10802,10808,53,10,28,9,7,12,28,42,-14,25,31,34
28192,10802,10808,17,13,28,9,5,14,33,54,-21,23,33,32
28193,10802,10808,27,11,28,8,9,11,36,40,-4,25,31,33
28194,10802,10808,37,17,28,5,6,17,22,52,-30,16,40,21
28195,10802,10808,21,4,28,13,10,5,54,29,25,36,20,49
28196,10802,10808,4,6,28,10,12,6,38,30,8,32,24,42
28197,10802,10808,28,15,28,6,10,12,20,38,-18,22,34,28
28198,10802,10808,54,18,28,4,8,16,22,50,-28,16,40,20
28199,10802,10808,56,9,28,9,7,12,31,41,-10,25,31,34
28200,10802,10808,35,12,28,9,5,14,34,44,-10,23,33,32
28201,10802,10808,41,14,28,7,10,11,26,34,-8,24,32,31
28202,10802,10808,20,16,28,5,8,15,27,56,-29,18,38,23
28203,10802,10808,43,2,28,20,4,4,65,13,52,44,12,64
28204,10802,10808,24,3,28,16,11,1,56,9,47,43,13,59
28205,10802,10808,57,7,28,10,7,11,41,38,3,27,29,37
28206,10802,10808,49,5,28,12,9,7,42,26,16,33,23,45
28207,10613,10619,43,1,6,4,2,0,16,3,13,10,2,14
28208,10613,10619,28,17,6,0,3,3,2,8,-6,3,9,3
28209,10613,10619,54,18,6,0,1,5,5,13,-8,1,11,1
28210,10613,10619,56,3,6,4,1,1,12,6,6,9,3,13
28211,10613,10619,20,9,6,2,2,2,8,10,-2,6,6,8
28212,10613,10619,41,15,6,1,2,3,2,3,-1,4,8,5
28213,10613,10619,35,16,6,1,1,4,6,10,-4,3,9,4
28214,10613,10619,53,8,6,2,3,1,5,6,-1,7,5,9
28215,10613,10619,12,11,6,2,1,3,9,12,-3,5,7,7
28216,10613,10619,24,2,6,4,2,0,12,2,10,10,2,14
28217,17326,17332,25,8,21,7,8,6,31,21,10,22,20,29
28218,17326,17332,12,11,21,5,10,6,19,21,-2,20,22,25
28219,17151,17157,43,4,3,2,1,0,4,2,2,5,1,7
28220,17151,17157,51,7,3,1,2,0,4,2,2,4,2,5
28221,17151,17157,22,11,3,1,1,1,3,6,-3,3,3,4
28222,17151,17157,57,12,3,1,0,2,4,7,-3,2,4,3
28223,17151,17157,24,14,3,0,1,2,1,3,-2,1,5,1
28224,17151,17157,27,8,3,1,1,1,2,2,0,3,3,4
28225,17151,17157,45,13,3,1,0,2,2,6,-4,2,4,3
28226,17151,17157,35,8,3,1,1,1,2,2,0,3,3,4
28227,17151,17157,49,2,3,3,0,0,12,3,9,6,0,9
28228,17151,17157,23,15,3,0,1,2,4,7,-3,1,5,1
28229,17151,17157,46,18,3,0,0,3,1,7,-6,0,6,0
28230,17151,17157,4,1,3,3,0,0,11,1,10,6,0,9
28231,17151,17157,33,5,3,2,0,1,6,5,1,4,2,6
28232,17151,17157,28,17,3,0,0,3,3,7,-4,0,6,0
28233,17151,17157,25,6,3,2,0,1,2,1,1,4,2,6
28234,17151,17157,12,8,3,1,1,1,2,2,0,3,3,4
28235,17151,17157,1,3,3,3,0,0,6,3,3,6,0,9
28236,17151,17157,42,16,3,0,1,2,3,6,-3,1,5,1
28237,17634,17640,42,16,16,3,5,8,17,22,-5,11,21,14
28238,17634,17640,25,5,16,8,3,5,22,20,2,19,13,27
28239,17634,17640,12,6,16,6,8,2,20,12,8,20,12,26
28240,17634,17640,33,8,16,7,3,6,23,21,2,17,15,24
28241,17634,17640,4,10,16,6,5,5,32,22,10,17,15,23
28242,17634,17640,1,3,16,9,4,3,28,18,10,22,10,31
28243,17634,17640,49,2,16,9,4,3,28,16,12,22,10,31
28244,17634,17640,23,14,16,3,6,7,21,31,-10,12,20,15
28245,17634,17640,56,11,16,5,6,5,18,24,-6,16,16,21
28246,17634,17640,35,17,16,2,6,8,16,23,-7,10,22,12
28247,17634,17640,45,9,16,7,2,7,23,21,2,16,16,23
28248,17634,17640,27,12,16,5,3,8,20,26,-6,13,19,18
28249,17634,17640,43,1,16,11,2,3,41,17,24,24,8,35
28250,17634,17640,22,4,16,9,3,4,26,20,6,21,11,30
28251,17634,17640,57,7,16,8,1,7,25,25,0,17,15,25
28252,17634,17640,24,13,16,4,5,7,17,26,-9,13,19,17
28253,17634,17640,32,15,16,4,2,10,20,34,-14,10,22,14
28254,17634,17640,51,18,16,2,4,10,10,29,-19,8,24,10
28255,17725,17731,45,7,26,11,6,9,40,31,9,28,24,39
28256,17725,17731,27,14,26,7,7,12,32,40,-8,21,31,28
28257,17725,17731,43,2,26,18,3,5,61,28,33,39,13,57
28258,17725,17731,22,4,26,13,4,9,40,37,3,30,22,43
28259,17725,17731,24,10,26,9,9,8,37,41,-4,27,25,36
28260,17725,17731,57,11,26,10,5,11,36,42,-6,25,27,35
28261,17725,17731,51,16,26,5,6,15,26,47,-21,16,36,21
28262,17725,17731,32,17,26,5,3,18,26,64,-38,13,39,18
28263,17725,17731,35,9,26,9,9,8,36,29,7,27,25,36
28264,17725,17731,56,13,26,7,9,10,26,39,-13,23,29,30
28265,17725,17731,4,5,26,12,6,8,54,36,18,30,22,42
28266,17725,17731,49,1,26,18,4,4,52,23,29,40,12,58
28267,17725,17731,23,15,26,6,6,14,34,46,-12,18,34,24
28268,17725,17731,33,12,26,9,8,9,34,33,1,26,26,35
28269,17725,17731,25,6,26,11,7,8,30,28,2,29,23,40
28270,17725,17731,12,8,26,9,11,6,31,24,7,29,23,38
28271,17725,17731,42,18,26,3,8,15,26,42,-16,14,38,17
28272,17725,17731,1,3,26,14,5,7,45,36,9,33,19,47
28273,17578,17584,33,4,8,5,1,2,15,9,6,11,5,16
28274,17578,17584,4,8,8,3,3,2,16,11,5,9,7,12
28275,17578,17584,51,18,8,0,2,6,3,13,-10,2,14,2
28276,17578,17584,1,1,8,6,2,0,15,4,11,14,2,20
28277,17578,17584,56,9,8,3,2,3,7,12,-5,8,8,11
28278,17578,17584,35,15,8,1,4,3,8,8,0,6,10,7
28279,17578,17584,49,2,8,6,1,1,15,8,7,13,3,19
28280,17578,17584,23,16,8,1,2,5,10,17,-7,4,12,5
28281,17578,17584,45,10,8,3,1,4,10,10,0,7,9,10
28282,17578,17584,27,12,8,3,1,4,8,11,-3,7,9,10
28283,17578,17584,42,14,8,2,1,5,9,14,-5,5,11,7
28284,17578,17584,43,3,8,5,1,2,16,10,6,11,5,16
28285,17578,17584,22,5,8,5,1,2,14,10,4,11,5,16
28286,17578,17584,57,11,8,3,1,4,12,14,-2,7,9,10
28287,17578,17584,24,13,8,2,2,4,10,13,-3,6,10,8
28288,17578,17584,32,17,8,1,1,6,5,14,-9,3,13,4
28289,17578,17584,25,6,8,4,2,2,9,9,0,10,6,14
28290,17578,17584,12,7,8,3,4,1,10,5,5,10,6,13
28291,18026,18032,25,10,20,5,5,9,20,28,-8,15,23,20
28292,18026,18032,12,14,19,3,3,13,14,29,-15,9,29,12
28293,18026,18032,43,1,20,15,3,2,40,17,23,33,7,48
28294,18026,18032,24,8,20,9,1,10,27,36,-9,19,21,28
28295,18026,18032,22,11,19,4,8,7,21,22,-1,16,22,20
28296,18026,18032,57,13,19,4,5,10,26,32,-6,13,25,17
28297,13224,13230,21,7,15,8,1,6,26,25,1,17,13,25
28298,13224,13230,4,11,15,5,3,7,25,31,-6,13,17,18
28299,13231,13237,21,8,16,8,1,7,28,29,-1,17,15,25
28300,13231,13237,4,10,16,6,3,7,27,32,-5,15,17,21
28301,13231,13237,47,5,16,8,3,5,27,20,7,19,13,27
28302,13231,13237,17,4,16,7,7,2,25,15,10,21,11,28
28303,13231,13237,1,1,16,10,4,2,33,16,17,24,8,34
28304,13231,13237,49,2,16,11,0,5,31,18,13,22,10,33
28305,13231,13237,43,6,16,7,6,3,26,13,13,20,12,27
28306,13231,13237,22,12,16,4,7,5,18,22,-4,15,17,19
28307,13231,13237,24,15,16,3,5,8,16,26,-10,11,21,14
28308,13231,13237,34,16,16,2,8,6,19,28,-9,12,20,14
28309,13231,13237,57,18,16,0,5,11,15,37,-22,5,27,5
28310,13231,13237,27,13,16,5,3,8,23,26,-3,13,19,18
28311,13231,13237,33,3,16,9,5,2,28,14,14,23,9,32
28312,13231,13237,52,9,16,6,4,6,18,18,0,16,16,22
28313,13231,13237,28,17,16,2,5,9,21,36,-15,9,23,11
28314,13231,13237,6,7,16,7,5,4,27,25,2,19,13,26
28315,13231,13237,35,14,16,4,4,8,21,27,-6,12,20,16
28316,13231,13237,12,11,16,5,5,6,26,27,-1,15,17,20
28317,13350,13363,12,15,28,8,6,14,36,51,-15,22,34,30
28318,13350,13363,52,11,28,8,8,12,28,34,-6,24,32,32
28319,13350,13363,28,13,28,8,7,13,37,48,-11,23,33,31
28320,13350,13363,27,10,28,9,6,13,37,42,-5,24,32,33
28321,13350,13363,17,2,28,16,10,2,53,28,25,42,14,58
28322,13350,13363,43,4,28,13,9,6,48,30,18,35,21,48
28323,13350,13363,22,9,28,9,8,11,34,36,-2,26,30,35
28324,13350,13363,24,16,28,7,9,12,31,43,-12,23,33,30
28325,13350,13363,34,17,28,4,10,14,29,50,-21,18,38,22
28326,13350,13363,57,18,28,4,8,16,28,54,-26,16,40,20
28327,13350,13363,49,6,28,14,2,12,48,43,5,30,26,44
28328,13350,13363,33,3,28,15,9,4,52,29,23,39,17,54
28329,13350,13363,1,1,28,18,5,5,60,30,30,41,15,59
28330,13350,13363,47,8,28,12,8,8,44,31,13,32,24,44
28331,13350,13363,6,5,28,13,7,8,39,38,1,33,23,46
28332,13350,13363,35,12,28,8,7,13,35,44,-9,23,33,31
28333,13350,13363,4,14,28,8,6,14,36,48,-12,22,34,30
28334,13350,13363,21,7,28,13,5,10,40,36,4,31,25,44
28335,13399,13405,21,6,32,15,5,12,46,42,4,35,29,50
28336,13399,13405,4,16,32,9,6,17,42,57,-15,24,40,33
28337,13399,13405,1,1,32,21,5,6,67,32,35,47,17,68
28338,13399,13405,47,9,32,12,10,10,46,37,9,34,30,46
28339,13399,13405,43,5,32,14,10,8,51,36,15,38,26,52
28340,13399,13405,22,8,32,13,8,11,46,37,9,34,30,47
28341,13399,13405,34,15,32,8,10,14,42,53,-11,26,38,34
28342,13399,13405,24,17,32,7,10,15,33,49,-16,24,40,31
28343,13399,13405,57,18,32,5,9,18,31,63,-32,19,45,24
28344,13399,13405,17,2,32,19,10,3,62,36,26,48,16,67
28345,13399,13405,27,12,32,10,7,15,43,49,-6,27,37,37
28346,13399,13405,49,7,32,15,2,15,52,50,2,32,32,47
28347,13399,13405,33,3,32,16,9,7,56,38,18,41,23,57
28348,13399,13405,28,11,32,10,8,14,45,54,-9,28,36,38
28349,13399,13405,52,14,32,8,10,14,30,39,-9,26,38,34
28350,13399,13405,12,13,32,9,7,16,37,54,-17,25,39,34
28351,13399,13405,6,4,32,16,7,9,45,43,2,39,25,55
28352,13399,13405,35,10,32,11,7,14,47,52,-5,29,35,40
28353,13175,13181,6,7,8,3,3,2,14,15,-1,9,7,12
28354,13175,13181,35,16,8,1,2,5,7,13,-6,4,12,5
28355,13175,13181,17,8,8,2,5,1,11,7,4,9,7,11
28356,13175,13181,27,9,8,3,1,4,13,13,0,7,9,10
28357,13175,13181,57,18,8,0,3,5,7,18,-11,3,13,3
28358,13175,13181,49,1,8,6,0,2,14,9,5,12,4,18
28359,13175,13181,4,5,8,4,2,2,16,14,2,10,6,14
28360,13175,13181,21,6,8,4,1,3,13,15,-2,9,7,13
28361,13175,13181,33,4,8,4,3,1,14,9,5,11,5,15
28362,13175,13181,52,14,8,1,4,3,6,11,-5,6,10,7
28363,13175,13181,28,17,8,1,2,5,12,22,-10,4,12,5
28364,13175,13181,12,12,8,2,3,3,12,12,0,7,9,9
28365,13175,13181,43,3,8,4,4,0,17,4,13,12,4,16
28366,13175,13181,34,10,8,2,4,2,11,11,0,8,8,10
28367,13175,13181,22,11,8,2,4,2,9,10,-1,8,8,10
28368,13175,13181,24,13,8,1,5,2,12,14,-2,7,9,8
28369,13175,13181,47,15,8,1,3,4,7,11,-4,5,11,6
28370,13175,13181,1,2,8,5,3,0,19,6,13,13,3,18
28371,13581,13590,1,1,11,10,1,0,28,6,22,21,1,31
28372,13581,13590,21,18,11,1,1,9,11,24,-13,3,19,4
28373,13581,13590,47,5,11,5,5,1,17,9,8,15,7,20
28374,13581,13590,25,7,11,5,3,3,24,23,1,13,9,18
28375,13581,13590,12,9,11,5,0,6,19,26,-7,10,12,15
28376,15058,15064,34,12,13,4,2,7,13,30,-17,10,16,14
28377,15058,15064,40,17,13,2,2,9,12,29,-17,6,20,8
28378,15058,15064,27,10,13,5,2,6,12,20,-8,12,14,17
28379,15058,15064,4,2,13,9,2,2,26,16,10,20,6,29
28380,15058,15064,21,15,13,3,2,8,18,24,-6,8,18,11
28381,15058,15064,12,4,13,8,1,4,20,12,8,17,9,25
28382,15058,15064,25,11,13,4,2,7,19,21,-2,10,16,14
28383,15058,15064,17,14,13,3,4,6,15,19,-4,10,16,13
28384,15058,15064,35,7,13,5,4,4,29,22,7,14,12,19
28385,15058,15064,6,13,13,3,5,5,22,30,-8,11,15,14
28386,15058,15064,49,6,13,7,4,2,20,14,6,18,8,25
28387,15058,15064,37,18,13,1,4,8,10,32,-22,6,20,7
28388,15058,15064,1,1,13,10,1,2,32,12,20,21,5,31
28389,15107,15113,1,1,18,13,1,4,42,20,22,27,9,40
28390,15107,15113,49,2,18,12,4,2,38,18,20,28,8,40
28391,15107,15113,37,18,18,1,5,12,17,49,-32,7,29,8
28392,15107,15113,35,7,18,7,6,5,36,25,11,20,16,27
28393,15107,15113,6,11,18,5,6,7,29,36,-7,16,20,21
28394,15107,15113,12,6,18,9,5,4,27,18,9,23,13,32
28395,15107,15113,25,12,18,5,3,10,29,36,-7,13,23,18
28396,15107,15113,17,14,18,4,5,9,26,31,-5,13,23,17
28397,15107,15113,4,3,18,12,3,3,33,21,12,27,9,39
28398,15107,15113,21,15,18,4,5,9,24,31,-7,13,23,17
28399,15107,15113,27,10,18,6,3,9,15,35,-20,15,21,21
28400,15107,15113,22,4,18,11,6,1,54,24,30,28,8,39
28401,15107,15113,43,5,18,10,6,2,38,20,18,26,10,36
28402,15107,15113,34,16,18,4,3,11,18,46,-28,11,25,15
28403,15107,15113,40,17,18,3,6,9,21,37,-16,12,24,15
28404,15107,15113,33,8,18,8,1,9,40,28,12,17,19,25
28405,15107,15113,28,9,18,6,4,8,26,28,-2,16,20,22
28406,15107,15113,52,13,18,5,2,11,23,33,-10,12,24,17
28407,15149,15155,33,7,24,12,3,9,50,30,20,27,21,39
28408,15149,15155,28,9,24,9,4,11,33,36,-3,22,26,31
28409,15149,15155,4,6,24,12,7,5,42,34,8,31,17,43
28410,15149,15155,21,16,24,5,7,12,35,47,-12,17,31,22
28411,15149,15155,27,11,24,8,5,11,24,44,-20,21,27,29
28412,15149,15155,1,1,24,17,1,6,57,29,28,35,13,52
28413,15149,15155,49,4,24,12,7,5,45,30,15,31,17,43
28414,15149,15155,37,18,24,2,8,14,25,62,-37,12,36,14
28415,15149,15155,17,15,24,5,7,12,36,46,-10,17,31,22
28416,15149,15155,12,5,24,12,7,5,35,23,12,31,17,43
28417,15149,15155,25,10,24,8,5,11,42,45,-3,21,27,29
28418,15149,15155,22,2,24,14,9,1,66,33,33,37,11,51
28419,15149,15155,43,3,24,14,7,3,55,26,29,35,13,49
28420,15149,15155,40,14,24,5,8,11,28,45,-17,18,30,23
28421,15149,15155,34,17,24,4,4,16,19,54,-35,12,36,16
28422,15149,15155,35,8,24,8,10,6,46,35,11,26,22,34
28423,15149,15155,6,12,24,7,7,10,38,43,-5,21,27,28
28424,15149,15155,52,13,24,7,4,13,31,45,-14,18,30,25
28425,15184,15190,49,5,29,14,9,6,52,33,19,37,21,51
28426,15184,15190,37,18,29,2,8,19,29,75,-46,12,46,14
28427,15184,15190,1,1,29,20,2,7,66,34,32,42,16,62
28428,15184,15190,22,2,29,17,10,2,76,39,37,44,14,61
28429,15184,15190,43,3,29,16,10,3,63,31,32,42,16,58
28430,15184,15190,40,13,29,8,8,13,33,51,-18,24,34,32
28431,15184,15190,34,17,29,4,8,17,26,63,-37,16,42,20
28432,15184,15190,35,9,29,8,14,7,54,44,10,30,28,38
28433,15184,15190,6,15,29,8,7,14,45,58,-13,23,35,31
28434,15184,15190,12,7,29,13,8,8,37,29,8,34,24,47
28435,15184,15190,25,12,29,9,6,14,44,52,-8,24,34,33
28436,15184,15190,17,14,29,8,7,14,50,58,-8,23,35,31
28437,15184,15190,4,6,29,13,9,7,50,43,7,35,23,48
28438,15184,15190,21,16,29,6,8,15,40,60,-20,20,38,26
28439,15184,15190,27,10,29,10,6,13,36,51,-15,26,32,36
28440,15184,15190,33,4,29,16,4,9,64,33,31,36,22,52
28441,15184,15190,28,8,29,13,4,12,42,42,0,30,28,43
28442,15184,15190,52,11,29,10,4,15,39,50,-11,24,34,34
28443,14981,14987,28,7,4,2,1,1,10,8,2,5,3,7
28444,14981,14987,33,12,4,1,0,3,7,5,2,2,6,3
28445,14981,14987,52,15,4,0,1,3,3,6,-3,1,7,1
28446,14981,14987,43,4,4,2,2,0,10,5,5,6,2,8
28447,14981,14987,22,6,4,2,1,1,13,8,5,5,3,7
28448,14981,14987,40,17,4,0,1,3,4,16,-12,1,7,1
28449,14981,14987,21,14,4,1,0,3,5,7,-2,2,6,3
28450,14981,14987,49,5,4,2,2,0,6,2,4,6,2,8
28451,14981,14987,37,18,4,0,1,3,3,16,-13,1,7,1
28452,14981,14987,27,8,4,2,1,1,2,3,-1,5,3,7
28453,14981,14987,1,1,4,4,0,0,13,4,9,8,0,12
28454,14981,14987,4,2,4,4,0,0,10,3,7,8,0,12
28455,10613,10619,57,4,6,4,0,2,9,8,1,8,4,12
28456,10613,10619,27,10,6,2,1,3,7,6,1,5,7,7
28457,10613,10619,21,6,6,2,3,1,7,6,1,7,5,9
28458,10613,10619,4,12,6,2,1,3,7,11,-4,5,7,7
28459,10613,10619,37,7,6,2,3,1,7,7,0,7,5,9
28460,10613,10619,49,13,6,1,4,1,8,5,3,6,6,7
28461,10613,10619,17,14,6,1,3,2,4,12,-8,5,7,6
28462,10613,10619,1,5,6,2,3,1,10,8,2,7,5,9
28463,11033,11039,12,6,14,6,4,4,20,14,6,16,12,22
28464,11033,11039,1,3,14,8,4,2,22,13,9,20,8,28
28465,11033,11039,53,15,14,3,3,8,19,33,-14,9,19,12
28466,11033,11039,27,11,14,3,6,5,15,17,-2,12,16,15
28467,11033,11039,49,4,14,7,6,1,25,15,10,20,8,27
28468,11033,11039,4,1,14,10,4,0,34,13,21,24,4,34
28469,11033,11039,21,7,14,5,6,3,26,18,8,16,12,21
28470,11033,11039,17,17,14,2,6,6,8,17,-9,10,18,12
28471,11033,11039,56,12,14,4,2,8,16,26,-10,10,18,14
28472,11033,11039,20,13,14,3,4,7,12,24,-12,10,18,13
28473,11033,11039,35,8,14,5,5,4,23,20,3,15,13,20
28474,11033,11039,41,10,14,4,4,6,17,18,-1,12,16,16
28475,11033,11039,52,14,14,3,3,8,15,26,-11,9,19,12
28476,11033,11039,28,18,14,2,4,8,10,24,-14,8,20,10
28477,11033,11039,43,2,14,9,3,2,39,10,29,21,7,30
28478,11033,11039,24,5,14,7,4,3,27,15,12,18,10,25
28479,11033,11039,57,9,14,5,3,6,18,21,-3,13,15,18
28480,11033,11039,22,16,14,3,3,8,12,34,-22,9,19,12
28481,11061,11088,43,2,18,12,4,2,45,12,33,28,8,40
28482,11061,11088,24,4,18,10,5,3,34,18,16,25,11,35
28483,11061,11088,57,10,18,6,4,8,22,28,-6,16,20,22
28484,11061,11088,22,13,18,4,4,10,16,40,-24,12,24,16
28485,11061,11088,52,17,18,3,4,11,16,31,-15,10,26,13
28486,11061,11088,28,18,18,2,7,9,13,28,-15,11,25,13
28487,11061,11088,35,7,18,7,5,6,31,27,4,19,17,26
28488,11061,11088,41,11,18,5,7,6,22,22,0,17,19,22
28489,11061,11088,20,12,18,4,6,8,17,28,-11,14,22,18
28490,11061,11088,56,15,18,4,3,11,20,34,-14,11,25,15
28491,11061,11088,17,14,18,3,7,8,10,22,-12,13,23,16
28492,11061,11088,49,5,18,9,7,2,30,19,11,25,11,34
28493,11061,11088,4,1,18,12,5,1,40,18,22,29,7,41
28494,11061,11088,21,6,18,6,9,3,35,24,11,21,15,27
28495,11061,11088,27,9,18,5,8,5,20,18,2,18,18,23
28496,11061,11088,12,8,18,7,4,7,24,22,2,18,18,25
28497,11061,11088,53,16,18,4,3,11,23,40,-17,11,25,15
28498,11061,11088,1,3,18,10,6,2,28,15,13,26,10,36
28499,11362,11368,27,18,10,1,2,7,5,15,-10,4,16,5
28500,11362,11368,21,4,10,6,1,3,13,9,4,13,7,19
28501,11362,11368,4,7,10,4,3,3,16,15,1,11,9,15
28502,11362,11368,49,5,10,4,5,1,13,7,6,13,7,17
28503,11362,11368,37,6,10,4,3,3,16,10,6,11,9,15
28504,11362,11368,17,8,10,4,3,3,14,14,0,11,9,15
28505,11362,11368,52,15,10,2,2,6,10,18,-8,6,14,8
28506,11362,11368,12,13,10,2,4,4,14,14,0,8,12,10
28507,11362,11368,43,1,10,7,2,1,19,6,13,16,4,23
28508,11362,11368,24,2,10,7,2,1,19,8,11,16,4,23
28509,11362,11368,57,9,10,4,3,3,18,21,-3,11,9,15
28510,11362,11368,22,12,10,3,1,6,9,12,-3,7,13,10
28511,11362,11368,34,17,10,1,3,6,4,15,-11,5,15,6
28512,11362,11368,1,3,10,7,1,2,29,12,17,15,5,22
28513,11362,11368,20,10,10,4,1,5,12,15,-3,9,11,13
28514,11362,11368,35,11,10,3,3,4,11,16,-5,9,11,12
28515,11362,11368,41,14,10,2,4,4,8,12,-4,8,12,10
28516,11362,11368,56,16,10,1,5,4,9,20,-11,7,13,8
28517,11537,11543,35,9,28,9,10,9,36,37,-1,28,28,37
28518,11537,11543,20,11,28,10,5,13,43,50,-7,25,31,35
28519,11537,11543,41,15,28,5,12,11,25,34,-9,22,34,27
28520,11537,11543,56,17,28,5,7,16,28,62,-34,17,39,22
28521,11537,11543,52,10,28,10,6,12,32,37,-5,26,30,36
28522,11537,11543,17,7,28,12,6,10,44,40,4,30,26,42
28523,11537,11543,21,5,28,14,4,10,37,34,3,32,24,46
28524,11537,11543,4,6,28,12,8,8,44,38,6,32,24,44
28525,11537,11543,49,3,28,14,12,2,46,21,25,40,16,54
28526,11537,11543,37,14,28,6,11,11,34,40,-6,23,33,29
28527,11537,11543,43,1,28,18,6,4,56,18,38,42,14,60
28528,11537,11543,24,4,28,14,9,5,39,18,21,37,19,51
28529,11537,11543,57,8,28,9,13,6,45,40,5,31,25,40
28530,11537,11543,22,16,28,5,9,14,21,38,-17,19,37,24
28531,11537,11543,34,18,28,2,6,20,12,54,-42,10,46,12
28532,11537,11543,27,13,28,7,8,13,25,35,-10,22,34,29
28533,11537,11543,12,12,28,8,10,10,35,38,-3,26,30,34
28534,16304,16310,27,5,30,17,7,6,40,29,11,41,19,58
28535,16304,16310,28,15,30,8,6,16,34,49,-15,22,38,30
28536,16304,16310,33,14,30,8,6,16,36,41,-5,22,38,30
28537,16304,16310,1,1,30,23,5,2,78,20,58,51,9,74
28538,16304,16310,57,8,30,11,5,14,42,65,-23,27,33,38
28539,16304,16310,40,9,30,10,8,12,37,34,3,28,32,38
28540,16304,16310,12,7,30,10,11,9,33,33,0,31,29,41
28541,16304,16310,25,10,30,11,4,15,31,49,-18,26,34,37
28542,16304,16310,35,12,30,9,6,15,28,40,-12,24,36,33
28543,16304,16310,17,11,30,10,5,15,45,52,-7,25,35,35
28544,16304,16310,42,16,30,7,4,19,38,52,-14,18,42,25
28545,16115,16121,17,12,9,3,1,5,13,15,-2,7,11,10
28546,16115,16121,42,16,9,1,3,5,9,15,-6,5,13,6
28547,16115,16121,35,14,9,2,1,6,10,15,-5,5,13,7
28548,16115,16121,12,7,9,4,2,3,11,10,1,10,8,14
28549,16115,16121,25,11,9,3,2,4,9,13,-4,8,10,11
28550,16115,16121,1,1,9,7,2,0,24,4,20,16,2,23
28551,16115,16121,33,10,9,3,3,3,10,9,1,9,9,12
28552,16115,16121,28,17,9,1,3,5,6,16,-10,5,13,6
28553,16115,16121,27,6,9,5,1,3,12,12,0,11,7,16
28554,16115,16121,4,3,9,6,0,3,17,14,3,12,6,18
28555,16115,16121,9,18,9,0,4,5,8,18,-10,4,14,4
28556,16115,16121,49,5,9,5,2,2,13,8,5,12,6,17
28557,16115,16121,37,13,9,2,3,4,9,11,-2,7,11,9
28558,16115,16121,46,15,9,2,1,6,7,15,-8,5,13,7
28559,16115,16121,43,2,9,7,0,2,20,9,11,14,4,21
28560,16115,16121,40,4,9,5,2,2,16,8,8,12,6,17
28561,16115,16121,22,8,9,3,5,1,9,8,1,11,7,14
28562,16115,16121,57,9,9,4,1,4,17,20,-3,9,9,13
28563,16500,16513,4,8,13,5,4,4,18,15,3,14,12,19
28564,16500,16513,49,1,13,10,1,2,24,12,12,21,5,31
28565,16500,16513,46,10,13,4,5,4,15,14,1,13,13,17
28566,16500,16513,37,14,13,4,1,8,13,20,-7,9,17,13
28567,16500,16513,28,13,13,4,1,8,13,18,-5,9,17,13
28568,16500,16513,33,14,13,4,1,8,13,20,-7,9,17,13
28569,16500,16513,45,4,13,7,2,4,24,20,4,16,10,23
28570,16500,16513,27,12,13,3,6,4,15,17,-2,12,14,15
28571,16500,16513,1,5,13,6,4,3,18,15,3,16,10,22
28572,16500,16513,43,2,13,8,5,0,34,12,22,21,5,29
28573,16500,16513,22,7,13,5,5,3,21,16,5,15,11,20
28574,16500,16513,57,9,13,5,2,6,17,19,-2,12,14,17
28575,16500,16513,51,11,13,4,3,6,21,21,0,11,15,15
28576,16500,16513,40,16,13,3,4,6,14,24,-10,10,16,13
28577,16500,16513,12,3,13,7,3,3,19,16,3,17,9,24
28578,16500,16513,25,6,13,6,3,4,17,9,8,15,11,21
28579,16500,16513,17,18,13,1,5,7,5,21,-16,7,19,8
28580,16500,16513,35,17,13,2,3,8,15,27,-12,7,19,9
28581,16451,16453,25,4,6,4,1,1,9,2,7,9,3,13
28582,16451,16453,12,5,6,4,1,1,7,6,1,9,3,13
28583,16451,16453,17,14,6,1,2,3,4,9,-5,4,8,5
28584,16451,16453,1,3,6,4,2,0,8,3,5,10,2,14
28585,16451,16453,45,6,6,3,1,2,11,9,2,7,5,10
28586,16451,16453,27,8,6,2,4,0,6,3,3,8,4,10
28587,16451,16453,28,12,6,2,0,4,4,7,-3,4,8,6
28588,16451,16453,33,17,6,1,0,5,3,10,-7,2,10,3
28589,16451,16453,49,1,6,5,0,1,14,7,7,10,2,15
28590,16451,16453,37,11,6,2,0,4,7,7,0,4,8,6
28591,16451,16453,46,13,6,1,3,2,6,8,-2,5,7,6
28592,16451,16453,35,15,6,1,1,4,5,10,-5,3,9,4
28593,16451,16453,4,7,6,3,1,2,8,7,1,7,5,10
28594,16451,16453,43,2,6,4,2,0,18,6,12,10,2,14
28595,16451,16453,51,9,6,2,1,3,6,5,1,5,7,7
28596,16451,16453,22,10,6,1,4,1,8,8,0,6,6,7
28597,16451,16453,40,16,6,0,4,2,4,11,-7,4,8,4
28598,16451,16453,57,18,6,0,1,5,2,12,-10,1,11,1
28599,16766,16772,4,18,1,0,0,1,0,5,-5,0,2,0
28600,16766,16772,46,7,1,1,0,0,1,0,1,2,0,3
28601,16766,16772,49,11,1,0,0,1,1,2,-1,0,2,0
28602,16766,16772,37,14,1,0,0,1,0,1,-1,0,2,0
28603,16766,16772,27,9,1,0,1,0,0,0,0,1,1,1
28604,16766,16772,45,17,1,0,0,1,1,3,-2,0,2,0
28605,16766,16772,33,4,1,1,0,0,2,1,1,2,0,3
28606,16766,16772,28,16,1,0,0,1,2,4,-2,0,2,0
28607,16766,16772,43,2,1,1,0,0,4,2,2,2,0,3
28608,16766,16772,22,3,1,1,0,0,3,1,2,2,0,3
28609,16766,16772,57,11,1,0,0,1,1,2,-1,0,2,0
28610,16766,16772,51,11,1,0,0,1,1,2,-1,0,2,0
28611,16766,16772,1,1,1,1,0,0,5,0,5,2,0,3
28612,16766,16772,17,9,1,0,1,0,0,0,0,1,1,1
28613,16766,16772,42,14,1,0,0,1,0,1,-1,0,2,0
28614,16766,16772,35,7,1,1,0,0,1,0,1,2,0,3
28615,18026,18032,51,15,19,3,3,13,21,46,-25,9,29,12
28616,18026,18032,45,6,20,8,6,6,30,26,4,22,18,30
28617,18026,18032,27,12,20,4,7,9,21,30,-9,15,25,19
28618,18026,18032,4,3,20,12,3,5,41,22,19,27,13,39
28619,18026,18032,28,7,20,8,5,7,26,26,0,21,19,29
28620,18026,18032,49,5,20,8,7,5,32,23,9,23,17,31
28621,18026,18032,1,2,20,13,3,4,40,25,15,29,11,42
28622,18026,18032,35,4,20,9,5,6,25,22,3,23,17,32
28623,18026,18032,56,9,19,7,6,6,21,20,1,20,18,27
28624,18033,18039,35,5,21,9,5,7,26,26,0,23,19,32
28625,18033,18039,56,9,20,7,7,6,23,22,1,21,19,28
28626,18033,18039,1,2,21,14,3,4,42,26,16,31,11,45
28627,18033,18039,49,7,21,8,7,6,32,27,5,23,19,31
28628,18033,18039,28,4,21,9,5,7,28,27,1,23,19,32
28629,18033,18039,4,3,21,12,4,5,43,24,19,28,14,40
28630,18033,18039,45,8,20,8,6,6,30,26,4,22,18,30
28631,18033,18039,27,13,21,4,7,10,22,33,-11,15,27,19
28632,18033,18039,43,1,21,16,3,2,44,17,27,35,7,51
28633,18033,18039,24,6,21,10,1,10,29,37,-8,21,21,31
28634,18033,18039,22,10,20,5,8,7,24,23,1,18,22,23
28635,18033,18039,57,12,20,5,5,10,30,33,-3,15,25,20
28636,18033,18039,51,15,20,3,3,14,22,48,-26,9,31,12
28637,18033,18039,25,11,20,5,5,10,20,30,-10,15,25,20
28638,18033,18039,12,14,20,3,3,14,15,31,-16,9,31,12
28639,17886,17892,12,14,4,0,1,3,3,9,-6,1,7,1
28640,17886,17892,25,15,4,0,1,3,2,9,-7,1,7,1
28641,17886,17892,43,1,4,4,0,0,10,2,8,8,0,12
28642,17886,17892,24,3,4,3,0,1,10,5,5,6,2,9
28643,17886,17892,22,7,3,1,2,0,4,3,1,4,2,5
28644,17886,17892,57,12,3,0,1,2,5,8,-3,1,5,1
28645,17886,17892,51,13,3,0,1,2,3,8,-5,1,5,1
28646,17886,17892,56,10,3,0,2,1,3,5,-2,2,4,2
28647,17886,17892,35,11,4,0,2,2,3,6,-3,2,6,2
28648,17886,17892,27,8,4,1,2,1,3,3,0,4,4,5
28649,17886,17892,45,9,4,0,3,1,5,7,-2,3,5,3
28650,17886,17892,49,6,4,1,3,0,9,5,4,5,3,6
28651,17886,17892,4,2,4,3,1,0,10,4,6,7,1,10
28652,17886,17892,28,4,4,2,2,0,6,4,2,6,2,8
28653,17886,17892,1,5,4,2,1,1,7,5,2,5,3,7
28654,17907,17913,28,1,6,4,2,0,10,5,5,10,2,14
28655,17907,17913,49,5,6,2,4,0,13,6,7,8,4,10
28656,17907,17913,4,2,6,4,1,1,15,6,9,9,3,13
28657,17907,17913,27,8,6,2,2,2,6,8,-2,6,6,8
28658,17907,17913,45,11,6,1,3,2,7,10,-3,5,7,6
28659,17907,17913,43,3,6,4,1,1,12,5,7,9,3,13
28660,17907,17913,24,6,6,3,0,3,10,10,0,6,6,9
28661,17907,17913,22,9,5,1,4,0,6,5,1,6,4,7
28662,17907,17913,57,12,5,1,1,3,11,11,0,3,7,4
28663,17907,17913,51,15,5,0,1,4,5,16,-11,1,9,1
28664,17907,17913,56,7,5,2,2,1,6,5,1,6,4,8
28665,17907,17913,35,10,6,1,3,2,6,8,-2,5,7,6
28666,17907,17913,1,4,6,3,2,1,11,8,3,8,4,11
28667,17907,17913,25,13,5,0,1,4,3,11,-8,1,9,4
28668,17907,17913,12,14,5,0,1,4,4,11,-7,1,9,1
28669,17917,17920,25,11,7,1,1,5,6,16,-10,3,11,4
28670,17917,17920,12,14,7,1,1,5,7,15,-8,3,11,4
28671,17917,17920,1,1,8,5,2,1,18,10,8,12,4,17
28672,17917,17920,35,7,8,3,3,2,9,9,0,9,7,12
28673,17917,17920,56,10,7,2,2,3,6,7,-1,6,8,8
28674,17917,17920,24,3,8,5,0,3,15,13,2,10,6,15
28675,17917,17920,43,5,7,4,2,1,13,6,7,10,4,14
28676,17917,17920,22,9,7,2,4,1,11,9,2,8,6,10
28677,17917,17920,57,13,7,1,2,4,13,14,-1,4,10,5
28678,17917,17920,51,15,7,0,1,6,8,21,-13,1,13,1
28679,17917,17920,27,8,8,3,2,3,9,11,-2,8,8,11
28680,17917,17920,45,12,7,1,3,3,8,13,-5,5,9,6
28681,17917,17920,4,4,8,4,2,2,17,9,8,10,6,14
28682,17917,17920,49,6,8,3,5,0,17,8,9,11,5,14
28683,17917,17920,28,2,8,5,2,1,13,9,4,12,4,17
28684,18404,18410,28,12,23,6,3,14,15,43,-28,15,31,21
28685,18404,18410,12,4,23,11,8,4,35,28,7,30,16,41
28686,18404,18410,25,11,23,7,7,9,30,32,-2,21,25,28
28687,18404,18410,56,9,23,9,4,10,26,26,0,22,24,31
28688,18404,18410,35,13,23,4,8,11,17,32,-15,16,30,20
28689,18404,18410,49,7,23,11,3,9,41,29,12,25,21,36
28690,18404,18410,4,3,23,13,4,6,45,35,10,30,16,43
28691,18404,18410,1,5,23,12,3,8,49,30,19,27,19,39
28692,18404,18410,17,15,23,3,7,13,19,49,-30,13,33,16
28693,18404,18410,43,1,23,16,5,2,50,14,36,37,9,53
28694,18404,18410,22,2,23,14,6,3,57,24,33,34,12,48
28695,18404,18410,57,6,23,11,5,7,32,27,5,27,19,38
28696,14981,14987,34,3,4,3,0,1,7,6,1,6,2,9
28697,14981,14987,25,13,4,1,0,3,9,9,0,2,6,3
28698,14981,14987,12,16,4,0,1,3,2,5,-3,1,7,1
28699,14981,14987,6,9,4,2,0,2,7,12,-5,4,4,6
28700,14981,14987,35,11,4,1,2,1,11,8,3,4,4,5
28701,14981,14987,17,10,4,1,3,0,4,3,1,5,3,6
28702,15394,15400,35,9,9,3,2,4,15,19,-4,8,10,11
28703,15394,15400,37,14,9,2,0,7,8,24,-16,4,14,6
28704,15394,15400,49,14,9,1,3,5,11,19,-8,5,13,6
28705,15394,15400,43,5,10,6,2,2,24,13,11,14,6,20
28706,15394,15400,22,6,9,5,3,1,22,12,10,13,5,18
28707,15394,15400,40,10,9,2,4,3,11,10,1,8,10,10
28708,15394,15400,24,16,9,1,3,5,8,21,-13,5,13,6
28709,15394,15400,12,2,9,7,2,0,23,12,11,16,2,23
28710,15394,15400,25,13,9,2,0,7,5,19,-14,4,14,6
28711,15394,15400,17,4,9,6,2,1,19,6,13,14,4,20
28712,15394,15400,42,7,10,5,1,4,18,11,7,11,9,16
28713,15394,15400,21,11,10,2,3,5,13,20,-7,7,13,9
28714,15394,15400,4,12,10,2,2,6,15,21,-6,6,14,8
28715,15394,15400,1,1,10,9,1,0,26,7,19,19,1,28
28716,15394,15400,27,17,10,0,3,7,10,25,-15,3,17,3
28717,15394,15400,28,3,9,6,2,1,31,15,16,14,4,20
28718,15394,15400,33,8,10,3,3,4,21,26,-5,9,11,12
28719,15429,15435,28,3,13,8,3,2,41,23,18,19,7,27
28720,15429,15435,33,9,13,4,4,5,24,29,-5,12,14,16
28721,15429,15435,27,17,13,0,4,9,14,37,-23,4,22,4
28722,15429,15435,1,1,14,12,1,1,37,13,24,25,3,37
28723,15429,15435,21,10,13,4,3,6,21,27,-6,11,15,15
28724,15429,15435,4,12,13,4,2,7,18,23,-5,10,16,14
28725,15429,15435,17,5,13,7,4,2,23,12,11,18,8,25
28726,15429,15435,42,7,14,6,2,6,23,18,5,14,14,20
28727,15429,15435,22,6,13,6,5,2,33,18,15,17,9,23
28728,15429,15435,40,14,13,3,4,6,14,14,0,10,16,13
28729,15429,15435,24,16,13,1,4,8,9,35,-26,6,20,7
28730,15429,15435,12,2,13,9,3,1,32,16,16,21,5,30
28731,15429,15435,43,4,14,8,2,4,30,19,11,18,10,26
28732,15429,15435,49,8,13,4,4,5,19,21,-2,12,14,16
28733,15429,15435,37,15,13,4,0,9,15,30,-15,8,18,12
28734,15429,15435,35,11,13,4,2,7,25,29,-4,10,16,14
28735,15429,15435,25,13,13,4,1,8,9,23,-14,9,17,13
28736,15499,15505,12,3,19,12,4,3,42,27,15,28,10,40
28737,15499,15505,25,11,20,7,1,12,17,32,-15,15,25,22
28738,15499,15505,35,14,19,5,3,11,31,39,-8,13,25,18
28739,15499,15505,28,4,19,11,4,4,49,28,21,26,12,37
28740,15499,15505,33,10,20,7,5,8,34,39,-5,19,21,26
28741,15499,15505,49,8,20,8,6,6,34,26,8,22,18,30
28742,15499,15505,37,12,20,7,1,12,31,50,-19,15,25,22
28743,15499,15505,17,5,19,10,5,4,32,24,8,25,13,35
28744,15499,15505,42,7,20,9,3,8,32,25,7,21,19,30
28745,15499,15505,1,1,20,18,1,1,66,16,50,37,3,55
28746,15499,15505,40,15,20,4,5,11,22,30,-8,13,27,17
28747,15499,15505,24,17,20,1,4,15,10,57,-47,6,34,7
28748,15499,15505,43,2,20,13,2,5,45,24,21,28,12,41
28749,15499,15505,22,6,20,9,5,6,44,35,9,23,17,32
28750,15499,15505,4,9,20,9,2,9,31,31,0,20,20,29
28751,15499,15505,21,13,20,6,4,10,29,38,-9,16,24,22
28752,15499,15505,27,16,20,2,5,13,21,49,-28,9,31,11
28753,15604,15680,27,16,32,6,9,17,39,66,-27,21,43,27
28754,15604,15680,4,8,32,15,2,15,49,55,-6,32,32,47
28755,15604,15680,21,12,32,9,7,16,44,55,-11,25,39,34
28756,15604,15680,17,5,32,16,8,8,51,41,10,40,24,56
28757,15604,15680,42,9,32,13,4,15,45,45,0,30,34,43
28758,15604,15680,12,3,32,18,6,8,69,51,18,42,22,60
28759,15604,15680,25,10,32,12,4,16,39,46,-7,28,36,40
28760,15604,15680,43,2,32,23,2,7,72,33,39,48,16,71
28761,15604,15680,22,6,32,16,7,9,73,52,21,39,25,55
28762,15604,15680,40,15,32,7,9,16,34,44,-10,23,41,30
28763,15604,15680,24,17,32,4,6,22,18,86,-68,14,50,18
28764,15604,15680,28,4,32,16,8,8,63,44,19,40,24,56
28765,15604,15680,33,13,32,9,5,18,42,72,-30,23,41,32
28766,15604,15680,1,1,32,25,4,3,96,33,63,54,10,79
28767,15604,15680,49,7,32,14,8,10,53,39,14,36,28,50
28768,15604,15680,37,11,32,12,2,18,52,69,-17,26,38,38
28769,15604,15680,35,14,32,8,7,17,49,57,-8,23,41,31
28770,15961,16044,35,7,34,11,11,12,34,40,-6,33,35,44
28771,15961,16044,25,6,34,14,10,10,51,45,6,38,30,52
28772,15961,16044,12,10,34,10,9,15,45,54,-9,29,39,39
28773,15961,16044,49,3,34,18,11,5,68,31,37,47,21,65
28774,15961,16044,37,12,34,11,5,18,45,58,-13,27,41,38
28775,16766,16772,12,4,1,1,0,0,2,1,1,2,0,3
28776,16766,16772,25,4,1,1,0,0,2,1,1,2,0,3
28777,16871,16877,35,8,12,4,4,4,13,14,-1,12,12,16
28778,16871,16877,25,5,12,6,2,4,18,15,3,14,10,20
28779,16871,16877,12,12,12,3,5,4,12,16,-4,11,13,14
28780,16871,16877,42,15,12,3,4,5,11,14,-3,10,14,13
28781,16871,16877,17,18,12,0,2,10,4,24,-20,2,22,2
28782,16871,16877,1,3,12,7,2,3,25,12,13,16,8,23
28783,16871,16877,22,1,12,10,2,0,31,9,22,22,2,32
28784,16871,16877,43,2,12,8,3,1,23,11,12,19,5,27
28785,16871,16877,51,13,12,3,4,5,19,22,-3,10,14,13
28786,16871,16877,57,16,12,3,2,7,9,14,-5,8,16,11
28787,16871,16877,33,9,12,4,4,4,19,22,-3,12,12,16
28788,16871,16877,28,17,12,3,1,8,15,20,-5,7,17,10
28789,16871,16877,27,6,12,5,4,3,16,15,1,14,10,19
28790,16871,16877,45,14,12,3,4,5,14,17,-3,10,14,13
28791,16871,16877,49,4,12,6,3,3,19,13,6,15,9,21
28792,16871,16877,37,10,12,4,2,6,10,17,-7,10,14,14
28793,16871,16877,46,11,12,3,5,4,13,14,-1,11,13,14
28794,16871,16877,4,7,12,5,3,4,18,20,-2,13,11,18
28795,17025,17031,49,3,29,17,5,7,55,33,22,39,19,56
28796,17025,17031,46,14,29,6,13,10,34,42,-8,25,33,31
28797,17025,17031,37,17,29,5,8,16,26,49,-23,18,40,23
28798,17025,17031,33,13,29,7,11,11,39,48,-9,25,33,32
28799,17025,17031,28,15,29,7,8,14,33,43,-10,22,36,29
28800,17025,17031,27,5,29,13,9,7,41,34,7,35,23,48
28801,17025,17031,45,12,29,8,9,12,34,43,-9,25,33,33
28802,17025,17031,43,1,29,19,8,2,54,26,28,46,12,65
28803,17025,17031,22,2,29,19,6,4,65,30,35,44,14,63
28804,17025,17031,51,9,29,9,8,12,44,54,-10,26,32,35
28805,17025,17031,57,11,29,9,7,13,24,29,-5,25,33,34
28806,17025,17031,1,6,29,13,8,8,50,33,17,34,24,47
28807,17025,17031,4,4,29,16,5,8,49,35,14,37,21,53
28808,17025,17031,25,8,29,11,7,11,33,35,-2,29,29,40
28809,17025,17031,12,16,29,5,13,11,27,38,-11,23,35,28
28810,17025,17031,42,10,29,9,7,13,30,35,-5,25,33,34
28811,17025,17031,17,18,29,4,6,19,22,55,-33,14,44,18
28812,17025,17031,35,7,29,11,8,10,42,40,2,30,28,41
28813,17046,17052,35,7,32,12,9,11,47,45,2,33,31,45
28814,17046,17052,42,9,32,11,7,14,38,40,-2,29,35,40
28815,17046,17052,17,18,32,5,7,20,26,62,-36,17,47,22
28816,17046,17052,25,8,32,12,9,11,39,39,0,33,31,45
28817,17046,17052,12,16,32,5,14,13,30,43,-13,24,40,29
28818,17046,17052,4,4,32,18,5,9,54,37,17,41,23,59
28819,17046,17052,1,6,32,14,8,10,55,36,19,36,28,50
28820,17046,17052,43,1,32,22,8,2,68,27,41,52,12,74
28821,17046,17052,22,2,32,22,6,4,70,32,38,50,14,72
28822,17046,17052,51,12,32,9,9,14,47,67,-20,27,37,36
28823,17046,17052,57,14,32,9,7,16,24,32,-8,25,39,34
28824,17046,17052,27,5,32,15,9,8,47,39,8,39,25,54
28825,17046,17052,45,11,32,9,9,14,38,51,-13,27,37,36
28826,17046,17052,33,10,32,9,11,12,46,52,-6,29,35,38
28827,17046,17052,28,15,32,8,8,16,34,47,-13,24,40,32
28828,17046,17052,49,3,32,18,7,7,61,36,25,43,21,61
28829,17046,17052,46,13,32,7,14,11,36,43,-7,28,36,35
28830,17046,17052,37,17,32,5,9,18,29,61,-32,19,45,24
28831,16822,16828,49,7,7,3,2,2,10,8,2,8,6,11
28832,16822,16828,46,9,7,3,1,3,7,7,0,7,7,10
28833,16822,16828,37,17,7,1,1,5,5,12,-7,3,11,4
28834,16822,16828,4,13,7,2,2,3,10,15,-5,6,8,8
28835,16822,16828,27,5,7,3,3,1,10,8,2,9,5,12
28836,16822,16828,45,12,7,2,2,3,10,11,-1,6,8,8
28837,16822,16828,33,8,7,3,2,2,10,9,1,8,6,11
28838,16822,16828,28,16,7,1,1,5,8,13,-5,3,11,4
28839,16822,16828,51,15,7,1,3,3,14,17,-3,5,9,6
28840,16822,16828,1,4,7,4,1,2,13,6,7,9,5,13
28841,16822,16828,22,1,7,5,2,0,15,6,9,12,2,17
28842,16822,16828,43,2,7,5,2,0,14,7,7,12,2,17
28843,16822,16828,57,14,7,2,1,4,6,8,-2,5,9,7
28844,16822,16828,42,6,7,3,2,2,7,4,3,8,6,11
28845,16822,16828,17,18,7,0,1,6,4,15,-11,1,13,1
28846,16822,16828,35,10,7,3,1,3,5,6,-1,7,7,10
28847,16822,16828,25,3,7,4,2,1,11,6,5,10,4,14
28848,16822,16828,12,11,7,2,3,2,7,8,-1,7,7,9
28849,17368,17374,25,8,27,10,8,9,38,28,10,28,26,38
28850,17368,17374,12,13,27,6,12,9,21,26,-5,24,30,30
28851,17368,17374,35,5,27,14,6,7,40,24,16,34,20,48
28852,17368,17374,42,16,27,6,7,14,30,41,-11,19,35,25
28853,17368,17374,1,2,27,16,6,5,34,20,14,38,16,54
28854,18404,18410,24,8,23,10,6,7,26,26,0,26,20,36
28855,18404,18410,45,10,23,7,10,6,34,29,5,24,22,31
28856,18404,18410,15,14,23,4,4,15,23,44,-21,12,34,16
28857,18404,18410,27,16,23,2,5,16,14,45,-31,9,37,11
28858,18418,18424,45,11,25,7,10,8,34,32,2,24,26,31
28859,18418,18424,15,14,25,5,4,16,25,45,-20,14,36,19
28860,18418,18424,27,16,25,3,5,17,16,46,-30,11,39,14
28861,18418,18424,43,1,25,17,6,2,52,14,38,40,10,57
28862,18418,18424,22,2,25,16,6,3,59,24,35,38,12,54
28863,18418,18424,24,7,25,11,7,7,27,26,1,29,21,40
28864,18418,18424,57,8,25,11,5,9,33,30,3,27,23,38
28865,18418,18424,17,15,25,4,7,14,21,53,-32,15,35,19
28866,18418,18424,1,4,25,13,3,9,50,31,19,29,21,42
28867,18418,18424,4,3,25,14,5,6,50,37,13,33,17,47
28868,18418,18424,49,5,25,13,3,9,44,30,14,29,21,42
28869,18418,18424,56,9,25,10,4,11,29,29,0,24,26,34
28870,18418,18424,35,13,25,4,9,12,18,34,-16,17,33,21
28871,18418,18424,25,10,25,8,7,10,33,35,-2,23,27,31
28872,18418,18424,12,6,25,11,9,5,36,31,5,31,19,42
28873,18418,18424,28,12,25,6,4,15,16,46,-30,16,34,22
28874,18278,18280,25,9,7,2,2,3,6,7,-1,6,8,8
28875,18278,18280,12,13,7,1,3,3,9,14,-5,5,9,6
28876,18278,18280,28,11,7,2,1,4,5,12,-7,5,9,7
28877,18278,18280,56,5,7,4,1,2,7,6,1,9,5,13
28878,18278,18280,35,10,7,2,2,3,3,7,-4,6,8,8
28879,18278,18280,4,4,7,5,1,1,14,11,3,11,3,16
28880,18278,18280,45,12,7,1,4,2,10,9,1,6,8,7
28881,18278,18280,27,14,7,1,2,4,4,15,-11,4,10,5
28882,18278,18280,15,16,7,0,1,6,3,14,-11,1,13,1
28883,18278,18280,22,1,7,6,1,0,24,6,18,13,1,19
28884,18278,18280,43,2,7,5,2,0,16,1,15,12,2,17
28885,18278,18280,24,3,7,5,1,1,8,3,5,11,3,16
28886,18278,18280,57,8,7,2,3,2,9,11,-2,7,7,9
28887,18278,18280,17,15,7,0,1,6,5,16,-11,1,13,1
28888,18278,18280,49,6,7,3,2,2,11,7,4,8,6,11
28889,18278,18280,1,7,7,3,1,3,15,10,5,7,7,10
28890,18684,18690,1,4,12,6,4,2,25,16,9,16,8,22
28891,18684,18690,43,1,12,9,2,1,26,9,17,20,4,29
28892,18684,18690,57,3,12,6,5,1,17,11,6,17,7,23
28893,18684,18690,22,6,12,5,4,3,23,18,5,14,10,19
28894,18684,18690,24,10,12,4,2,6,13,20,-7,10,14,14
28895,18684,18690,56,5,12,6,2,4,18,12,6,14,10,20
28896,18684,18690,35,11,12,3,5,4,22,21,1,11,13,14
28897,18684,18690,42,8,12,4,5,3,25,20,5,13,11,17
28898,18684,18690,17,14,12,1,6,5,6,15,-9,8,16,9
28899,18684,18690,45,13,12,2,5,5,11,17,-6,9,15,11
28900,18684,18690,4,2,12,7,2,3,26,16,10,16,8,23
28901,18684,18690,49,7,12,5,4,3,14,16,-2,14,10,19
28902,18684,18690,16,9,12,4,2,6,14,21,-7,10,14,14
28903,18684,18690,12,12,12,3,3,6,15,19,-4,9,15,12
28904,18684,18690,25,15,12,1,4,7,9,20,-11,6,18,7
28905,18684,18690,28,16,12,1,3,8,19,32,-13,5,19,6
28906,18705,18711,28,15,14,1,4,9,20,35,-15,6,22,7
28907,18705,18711,12,10,14,4,4,6,20,22,-2,12,16,16
28908,18705,18711,25,16,14,1,4,9,11,27,-16,6,22,7
28909,18705,18711,49,5,14,7,4,3,19,18,1,18,10,25
28910,18705,18711,16,12,14,4,2,8,16,27,-11,10,18,14
28911,18705,18711,4,2,14,9,2,3,36,18,18,20,8,29
28912,18705,18711,45,13,14,2,7,5,12,18,-6,11,17,13
28913,18705,18711,42,8,14,5,5,4,27,23,4,15,13,20
28914,18705,18711,17,14,14,2,6,6,10,18,-8,10,18,12
28915,18705,18711,56,7,14,6,3,5,20,18,2,15,13,21
28916,18705,18711,35,9,14,4,6,4,25,22,3,14,14,18
28917,18705,18711,43,1,14,10,2,2,29,11,18,22,6,32
28918,18705,18711,57,3,14,7,5,2,18,12,6,19,9,26
28919,18705,18711,22,6,14,6,5,3,28,20,8,17,11,23
28920,18705,18711,24,11,14,4,3,7,16,27,-11,11,17,15
28921,18705,18711,1,4,14,7,4,3,27,18,9,18,10,25
28922,18712,18718,1,3,15,8,4,3,28,18,10,20,10,28
28923,18712,18718,43,1,15,11,2,2,32,13,19,24,6,35
28924,18712,18718,57,5,15,7,6,2,19,13,6,20,10,27
28925,18712,18718,22,7,15,6,5,4,28,22,6,17,13,23
28926,18712,18718,24,11,15,4,3,8,18,30,-12,11,19,15
28927,18712,18718,42,8,15,5,5,5,28,25,3,15,15,20
28928,18712,18718,17,14,15,2,6,7,10,19,-9,10,20,12
28929,18712,18718,56,6,15,7,3,5,21,18,3,17,13,24
28930,18712,18718,35,9,15,4,6,5,25,23,2,14,16,18
28931,18712,18718,45,13,15,2,7,6,14,21,-7,11,19,13
28932,18712,18718,4,2,15,10,2,3,38,18,20,22,8,32
28933,11537,11543,1,2,28,16,10,2,50,18,32,42,14,58
28934,11316,11319,1,5,3,2,0,1,8,4,4,4,2,6
28935,11316,11319,52,11,3,1,0,2,2,5,-3,2,4,3
28936,11316,11319,12,13,3,0,2,1,3,4,-1,2,4,2
28937,11316,11319,17,14,3,0,2,1,2,3,-1,2,4,2
28938,11316,11319,27,7,3,1,1,1,4,3,1,3,3,4
28939,11316,11319,21,1,3,3,0,0,6,1,5,6,0,9
28940,11316,11319,4,9,3,1,1,1,5,7,-2,3,3,4
28941,11316,11319,43,2,3,2,1,0,8,2,6,5,1,7
28942,11316,11319,22,3,3,2,1,0,5,1,4,5,1,7
28943,11316,11319,24,4,3,2,1,0,5,2,3,5,1,7
28944,11316,11319,57,12,3,0,3,0,3,3,0,3,3,3
28945,11316,11319,34,18,3,0,0,3,1,8,-7,0,6,0
28946,11316,11319,20,6,3,2,0,1,3,2,1,4,2,6
28947,11316,11319,56,10,3,1,1,1,3,5,-2,3,3,4
28948,11316,11319,41,15,3,0,2,1,1,3,-2,2,4,2
28949,11316,11319,35,16,3,0,1,2,2,5,-3,1,5,1
28950,11316,11319,49,8,3,1,1,1,2,2,0,3,3,4
28951,11316,11319,37,17,3,0,1,2,1,4,-3,1,5,1
28952,11334,11340,49,9,6,2,3,1,6,5,1,7,5,9
28953,11334,11340,43,1,6,4,2,0,11,3,8,10,2,14
28954,11334,11340,24,3,6,4,1,1,10,7,3,9,3,13
28955,11334,11340,22,4,6,3,1,2,9,4,5,7,5,10
28956,11334,11340,57,8,6,2,3,1,12,11,1,7,5,9
28957,11334,11340,34,17,6,1,1,4,2,10,-8,3,9,4
28958,11334,11340,20,6,6,3,0,3,9,9,0,6,6,9
28959,11334,11340,35,14,6,1,2,3,5,9,-4,4,8,5
28960,11334,11340,56,15,6,1,2,3,6,14,-8,4,8,5
28961,11334,11340,41,18,6,0,4,2,2,5,-3,4,8,4
28962,11334,11340,21,5,6,3,1,2,7,5,2,7,5,10
28963,11334,11340,4,11,6,2,2,2,9,11,-2,6,6,8
28964,11334,11340,27,16,6,1,1,4,5,9,-4,3,9,4
28965,11334,11340,37,10,6,2,2,2,9,6,3,6,6,8
28966,11334,11340,17,13,6,1,3,2,4,5,-1,5,7,6
28967,11334,11340,12,7,6,2,3,1,9,6,3,7,5,9
28968,11334,11340,52,12,6,2,0,4,5,11,-6,4,8,6
28969,11334,11340,1,2,6,4,1,1,17,7,10,9,3,13
28970,11348,11354,1,3,8,5,1,2,22,10,12,11,5,16
28971,11348,11354,52,13,8,2,1,5,8,15,-7,5,11,7
28972,11348,11354,12,12,8,2,4,2,11,9,2,8,8,10
28973,11348,11354,17,8,8,3,3,2,10,9,1,9,7,12
28974,11348,11354,49,6,8,3,4,1,9,6,3,10,6,13
28975,11348,11354,37,10,8,3,2,3,13,8,5,8,8,11
28976,11348,11354,27,18,8,1,1,6,5,14,-9,3,13,4
28977,11348,11354,4,4,8,4,2,2,15,13,2,10,6,14
28978,11348,11354,21,5,8,4,1,3,10,8,2,9,7,13
28979,11348,11354,20,7,8,4,0,4,11,13,-2,8,8,12
28980,11348,11354,41,14,8,1,4,3,6,8,-2,6,10,7
28981,11348,11354,35,15,8,1,3,4,6,14,-8,5,11,6
28982,11348,11354,56,16,8,1,3,4,7,18,-11,5,11,6
28983,11348,11354,43,1,8,6,2,0,17,4,13,14,2,20
28984,11348,11354,24,2,8,6,1,1,17,7,10,13,3,19
28985,11348,11354,57,9,8,3,3,2,15,17,-2,9,7,12
28986,11348,11354,22,11,8,3,1,4,9,8,1,7,9,10
28987,11348,11354,34,17,8,1,2,5,3,13,-10,4,12,5
28988,11775,11781,27,6,14,7,2,5,28,22,6,16,12,23
28989,11775,11781,52,12,14,3,8,3,19,16,3,14,14,17
28990,11775,11781,35,17,14,3,2,9,20,35,-15,8,20,11
28991,11775,11781,6,18,14,2,1,11,13,36,-23,5,23,7
28992,11775,11781,20,4,14,8,2,4,41,21,20,18,10,26
28993,11775,11781,41,13,14,4,3,7,20,31,-11,11,17,15
28994,11775,11781,4,5,14,7,3,4,22,14,8,17,11,24
28995,11775,11781,21,9,14,6,1,7,22,27,-5,13,15,19
28996,11775,11781,43,1,14,11,2,1,32,11,21,24,4,35
28997,11775,11781,24,3,14,9,0,5,25,17,8,18,10,27
28998,11775,11781,57,11,14,5,3,6,33,34,-1,13,15,18
28999,11775,11781,22,14,14,3,5,6,16,16,0,11,17,14
29000,11775,11781,14,15,14,4,1,9,25,41,-16,9,19,13
29001,11775,11781,49,2,14,10,2,2,30,17,13,22,6,32
29002,11775,11781,37,8,14,6,3,5,16,17,-1,15,13,21
29003,11775,11781,17,10,14,5,4,5,20,20,0,14,14,19
29004,11775,11781,12,16,14,3,2,9,13,25,-12,8,20,11
29005,11775,11781,1,7,14,7,2,5,17,12,5,16,12,23
29006,11838,11844,52,8,21,8,9,4,33,23,10,25,17,33
29007,11838,11844,12,17,21,3,4,14,20,40,-20,10,32,13
29008,11838,11844,17,10,21,8,5,8,32,31,1,21,21,29
29009,11838,11844,49,2,21,13,4,4,44,27,17,30,12,43
29010,11838,11844,37,11,21,8,5,8,25,28,-3,21,21,29
29011,11838,11844,14,16,21,4,3,14,31,71,-40,11,31,15
29012,11838,11844,43,1,21,16,4,1,48,17,31,36,6,52
29013,11838,11844,24,4,21,11,2,8,33,24,9,24,18,35
29014,15961,16044,17,11,34,8,15,11,33,40,-7,31,37,39
29015,15961,16044,42,16,34,7,12,15,29,52,-23,26,42,33
29016,15961,16044,33,5,34,15,14,5,64,42,22,44,24,59
29017,15961,16044,28,13,34,9,11,14,36,50,-14,29,39,38
29018,15961,16044,43,1,34,25,6,3,77,27,50,56,12,81
29019,15961,16044,22,4,34,17,8,9,58,40,18,42,26,59
29020,15961,16044,40,8,34,10,14,10,45,46,-1,34,34,44
29021,15961,16044,57,14,34,7,14,13,28,52,-24,28,40,35
29022,15961,16044,4,9,34,8,16,10,33,34,-1,32,36,40
29023,15961,16044,31,17,34,7,7,20,36,68,-32,21,47,28
29024,15961,16044,21,18,34,7,6,21,30,67,-37,20,48,27
29025,15961,16044,1,2,34,22,6,6,77,31,46,50,18,72
29026,15961,16044,27,15,34,8,9,17,35,47,-12,25,43,33
29027,16598,16604,45,4,22,11,4,7,41,34,7,26,18,37
29028,16598,16604,27,10,22,8,6,8,22,27,-5,22,22,30
29029,16598,16604,1,3,22,12,7,3,37,21,16,31,13,43
29030,16598,16604,4,6,22,10,4,8,30,27,3,24,20,34
29031,16598,16604,40,16,22,4,8,10,20,39,-19,16,28,20
29032,16598,16604,43,2,22,12,7,3,47,22,25,31,13,43
29033,16598,16604,22,5,22,10,7,5,37,28,9,27,17,37
29034,16598,16604,51,11,22,7,8,7,35,27,8,22,22,29
29035,16598,16604,57,13,22,7,4,11,28,36,-8,18,26,25
29036,16598,16604,17,18,22,3,7,12,13,37,-24,13,31,16
29037,16598,16604,49,1,22,13,4,5,34,20,14,30,14,43
29038,16598,16604,46,8,22,8,8,6,25,22,3,24,20,32
29039,16598,16604,37,15,22,6,3,13,25,36,-11,15,29,21
29040,16598,16604,25,7,22,9,5,8,28,25,3,23,21,32
29041,16598,16604,12,9,22,8,8,6,31,31,0,24,20,32
29042,16598,16604,35,12,22,8,3,11,30,36,-6,19,25,27
29043,16598,16604,33,14,22,7,2,13,31,35,-4,16,28,23
29044,16598,16604,28,17,22,4,7,11,22,33,-11,15,29,19
29045,16654,16660,33,13,30,10,4,16,40,39,1,24,36,34
29046,16654,16660,28,14,30,8,9,13,34,39,-5,25,35,33
29047,16654,16660,35,10,30,11,6,13,38,43,-5,28,32,39
29048,16654,16660,49,1,30,18,7,5,50,24,26,43,17,61
29049,16654,16660,46,12,30,9,10,11,26,28,-2,28,32,37
29050,16654,16660,37,16,30,8,4,18,33,52,-19,20,40,28
29051,16654,16660,17,17,30,6,8,16,18,49,-31,20,40,26
29052,16654,16660,43,2,30,17,9,4,62,27,35,43,17,60
29053,16654,16660,22,5,30,14,8,8,43,33,10,36,24,50
29054,16654,16660,51,11,30,9,10,11,43,40,3,28,32,37
29055,16654,16660,57,15,30,8,7,15,34,53,-19,23,37,31
29056,16654,16660,40,18,30,4,13,13,21,44,-23,21,39,25
29057,16654,16660,12,7,30,11,10,9,43,42,1,32,28,43
29058,16654,16660,25,8,30,11,7,12,38,40,-2,29,31,40
29059,16654,16660,4,4,30,16,5,9,43,32,11,37,23,53
29060,16654,16660,45,6,30,14,6,10,49,41,8,34,26,48
29061,16654,16660,27,9,30,10,10,10,33,34,-1,30,30,40
29062,16654,16660,1,3,30,15,9,6,44,32,12,39,21,54
29063,16976,16982,27,6,23,11,6,6,32,26,6,28,18,39
29064,16976,16982,45,11,23,7,7,9,28,33,-5,21,25,28
29065,16976,16982,4,4,23,12,4,7,38,30,8,28,18,40
29066,16976,16982,25,7,23,10,5,8,29,27,2,25,21,35
29067,16976,16982,12,16,23,4,9,10,20,31,-11,17,29,21
29068,16976,16982,35,9,23,8,7,8,30,33,-3,23,23,31
29069,16976,16982,22,1,23,16,5,2,53,21,32,37,9,53
29070,16976,16982,43,2,23,15,6,2,44,22,22,36,10,51
29071,16976,16982,51,8,23,8,7,8,34,37,-3,23,23,31
29072,16976,16982,57,10,23,8,4,11,20,24,-4,20,26,28
29073,16976,16982,42,13,23,6,6,11,21,31,-10,18,28,24
29074,16976,16982,17,18,23,3,3,17,16,44,-28,9,37,12
29075,16976,16982,28,12,23,7,3,13,28,36,-8,17,29,24
29076,16976,16982,33,15,23,5,8,10,32,42,-10,18,28,23
29077,16976,16982,49,3,23,14,4,5,49,29,20,32,14,46
29078,16976,16982,46,14,23,5,9,9,23,32,-9,19,27,24
29079,16976,16982,37,17,23,5,5,13,22,38,-16,15,31,20
29080,16976,16982,1,5,23,11,6,6,40,23,17,28,18,39
29081,17263,17269,1,1,15,10,4,1,23,12,11,24,6,34
29082,17263,17269,49,2,15,9,6,0,33,11,22,24,6,33
29083,17263,17269,23,14,15,3,3,9,12,27,-15,9,21,12
29084,17263,17269,46,16,15,3,2,10,12,31,-19,8,22,11
29085,17263,17269,12,11,15,5,5,5,14,15,-1,15,15,20
29086,17263,17269,25,12,15,5,4,6,19,15,4,14,16,19
29087,17263,17269,35,4,15,8,3,4,23,13,10,19,11,27
29088,17263,17269,33,8,15,6,4,5,22,18,4,16,14,22
29089,17263,17269,28,17,15,3,1,11,14,32,-18,7,23,10
29090,17263,17269,42,18,15,2,3,10,16,28,-12,7,23,9
29091,17263,17269,57,3,15,8,4,3,31,14,17,20,10,28
29092,13581,13590,4,12,11,3,5,3,21,18,3,11,11,14
29093,13581,13590,49,16,11,2,3,6,9,15,-6,7,15,9
29094,13581,13590,22,4,11,6,2,3,27,17,10,14,8,20
29095,13581,13590,43,8,11,5,1,5,15,14,1,11,11,16
29096,13581,13590,34,14,11,2,3,6,17,22,-5,7,15,9
29097,13581,13590,33,15,11,2,3,6,8,13,-5,7,15,9
29098,13581,13590,27,13,11,3,3,5,13,24,-11,9,13,12
29099,13581,13590,17,6,11,5,3,3,22,16,6,13,9,18
29100,13581,13590,37,17,11,1,4,6,11,20,-9,6,16,7
29101,13581,13590,28,10,11,4,3,4,11,15,-4,11,11,15
29102,13581,13590,52,11,11,4,2,5,18,24,-6,10,12,14
29103,13581,13590,6,2,11,7,1,3,23,15,8,15,7,22
29104,13581,13590,35,3,11,7,1,3,21,14,7,15,7,22
29105,13497,13503,6,4,2,1,1,0,4,2,2,3,1,4
29106,13497,13503,35,4,2,1,1,0,4,2,2,3,1,4
29107,13497,13503,25,8,2,1,0,1,5,4,1,2,2,3
29108,13497,13503,12,18,2,0,0,2,1,8,-7,0,4,0
29109,13497,13503,33,12,2,0,2,0,2,2,0,2,2,2
29110,13497,13503,28,17,2,0,0,2,2,6,-4,0,4,0
29111,13497,13503,52,9,2,1,0,1,3,3,0,2,2,3
29112,13497,13503,49,13,2,0,1,1,2,3,-1,1,3,1
29113,13497,13503,37,14,2,0,1,1,1,3,-2,1,3,1
29114,13497,13503,17,3,2,1,1,0,4,1,3,3,1,4
29115,13497,13503,27,11,2,1,0,1,2,5,-3,2,2,3
29116,13497,13503,22,1,2,2,0,0,9,1,8,4,0,6
29117,13497,13503,34,6,2,1,1,0,2,0,2,3,1,4
29118,13497,13503,43,10,2,1,0,1,1,2,-1,2,2,3
29119,13497,13503,4,15,2,0,1,1,1,5,-4,1,3,1
29120,13497,13503,21,16,2,0,0,2,0,3,-3,0,4,0
29121,13497,13503,47,7,2,1,1,0,3,2,1,3,1,4
29122,13497,13503,1,2,2,2,0,0,7,1,6,4,0,6
29123,13672,13678,47,4,21,9,9,3,37,22,15,27,15,36
29124,13672,13678,1,1,21,18,3,0,53,15,38,39,3,57
29125,13672,13678,4,8,21,7,8,6,33,29,4,22,20,29
29126,13672,13678,21,18,21,3,4,14,23,43,-20,10,32,13
29127,13672,13678,22,2,21,13,3,5,46,28,18,29,13,42
29128,13672,13678,43,6,21,9,5,7,30,25,5,23,19,32
29129,13672,13678,34,11,21,7,5,9,33,35,-2,19,23,26
29130,13672,13678,49,13,21,6,7,8,29,30,-1,19,23,25
29131,13672,13678,37,17,21,3,7,11,20,35,-15,13,29,16
29132,13672,13678,27,12,21,7,5,9,29,38,-9,19,23,26
29133,13672,13678,17,10,21,7,6,8,32,30,2,20,22,27
29134,13672,13678,28,9,21,7,7,7,22,23,-1,21,21,28
29135,13672,13678,33,15,21,5,5,11,20,32,-12,15,27,20
29136,13672,13678,52,16,21,5,3,13,25,53,-28,13,29,18
29137,13672,13678,12,7,21,10,0,11,40,44,-4,20,22,30
29138,13672,13678,25,14,21,5,8,8,29,37,-8,18,24,23
29139,13672,13678,35,3,21,12,4,5,38,25,13,28,14,40
29140,13672,13678,6,5,21,9,5,7,34,29,5,23,19,32
29141,13931,13937,25,6,11,6,1,4,28,21,7,13,9,19
29142,13931,13937,28,4,11,6,2,3,17,10,7,14,8,20
29143,13931,13937,33,13,11,3,5,3,17,20,-3,11,11,14
29144,13931,13937,17,7,11,5,1,5,19,19,0,11,11,16
29145,13931,13937,27,11,11,3,5,3,15,12,3,11,11,14
29146,13931,13937,12,2,11,7,2,2,25,12,13,16,6,23
29147,13931,13937,49,5,11,6,1,4,19,10,9,13,9,19
29148,13931,13937,37,10,11,4,2,5,16,17,-1,10,12,14
29149,13931,13937,34,9,11,4,3,4,18,18,0,11,11,15
29150,13931,13937,43,12,11,3,5,3,17,19,-2,11,11,14
29151,13931,13937,22,1,11,8,2,1,22,10,12,18,4,26
29152,13931,13937,1,3,11,7,2,2,21,10,11,16,6,23
29153,13931,13937,47,16,11,1,4,6,10,19,-9,6,16,7
29154,13931,13937,35,14,11,3,2,6,11,19,-8,8,14,11
29155,13931,13937,6,15,11,2,2,7,11,18,-7,6,16,8
29156,13931,13937,56,18,11,1,3,7,17,31,-14,5,17,6
29157,13931,13937,4,8,11,4,4,3,19,18,1,12,10,16
29158,13931,13937,9,17,11,1,4,6,9,28,-19,6,16,7
29159,13973,13979,4,7,17,7,6,4,29,32,-3,20,14,27
29160,13973,13979,9,17,17,2,5,10,16,40,-24,9,25,11
29161,13973,13979,1,1,17,12,3,2,34,16,18,27,7,39
29162,13973,13979,47,13,17,4,6,7,22,29,-7,14,20,18
29163,13973,13979,22,2,17,10,4,3,37,21,16,24,10,34
29164,13973,13979,43,10,17,7,5,5,30,25,5,19,15,26
29165,13973,13979,34,12,17,6,4,7,29,34,-5,16,18,22
29166,13973,13979,27,14,17,3,7,7,23,25,-2,13,21,16
29167,13973,13979,17,9,17,8,2,7,32,29,3,18,16,26
29168,13973,13979,49,4,17,9,2,6,25,18,7,20,14,29
29169,13973,13979,37,15,17,4,3,10,18,27,-9,11,23,15
29170,13973,13979,28,5,17,8,5,4,24,16,8,21,13,29
29171,13973,13979,33,6,17,7,7,3,31,27,4,21,13,28
29172,17368,17374,22,9,27,9,8,10,39,42,-3,26,28,35
29173,17368,17374,24,11,27,8,8,11,34,40,-6,24,30,32
29174,17368,17374,51,15,27,6,9,12,29,47,-18,21,33,27
29175,17368,17374,57,3,27,15,7,5,55,25,30,37,17,52
29176,17368,17374,43,4,27,15,7,5,44,26,18,37,17,52
29177,17368,17374,33,12,27,8,6,13,31,37,-6,22,32,30
29178,17368,17374,28,17,27,4,8,15,23,44,-21,16,38,20
29179,17368,17374,45,7,27,11,5,11,36,44,-8,27,27,38
29180,17368,17374,27,10,27,9,6,12,27,34,-7,24,30,33
29181,17368,17374,4,6,27,12,8,7,49,36,13,32,22,44
29182,17368,17374,23,14,27,8,5,14,27,43,-16,21,33,29
29183,17368,17374,46,18,27,4,4,19,22,56,-34,12,42,16
29184,17368,17374,49,1,27,17,10,0,51,17,34,44,10,61
29185,17382,17388,49,1,29,19,10,0,53,17,36,48,10,67
29186,17382,17388,23,15,29,8,5,16,30,49,-19,21,37,29
29187,17382,17388,46,18,29,4,5,20,24,59,-35,13,45,17
29188,17382,17388,4,6,29,12,8,9,51,43,8,32,26,44
29189,17382,17388,27,8,29,11,6,12,32,36,-4,28,30,39
29190,17382,17388,45,9,29,11,6,12,38,47,-9,28,30,39
29191,17382,17388,33,12,29,9,6,14,33,39,-6,24,34,33
29192,17382,17388,28,17,29,5,8,16,26,47,-21,18,40,23
29193,17382,17388,43,2,29,17,7,5,49,27,22,41,17,58
29194,17382,17388,57,4,29,15,8,6,56,28,28,38,20,53
29195,17382,17388,22,10,29,10,8,11,47,47,0,28,30,38
29196,17382,17388,24,13,29,8,9,12,36,43,-7,25,33,33
29197,17382,17388,51,14,29,8,9,12,31,47,-16,25,33,33
29198,17382,17388,1,3,29,17,6,6,39,28,11,40,18,57
29199,17382,17388,42,16,29,7,8,14,34,41,-7,22,36,29
29200,17382,17388,35,5,29,14,6,9,40,27,13,34,24,48
29201,17382,17388,25,7,29,11,8,10,40,30,10,30,28,41
29202,17382,17388,12,11,29,7,13,9,24,28,-4,27,31,34
29203,17522,17528,56,7,2,1,1,0,4,3,1,3,1,4
29204,17522,17528,35,11,2,0,2,0,2,2,0,2,2,2
29205,17522,17528,12,5,2,1,1,0,4,1,3,3,1,4
29206,17522,17528,25,9,2,1,0,1,1,3,-2,2,2,3
29207,17522,17528,42,10,2,1,0,1,3,6,-3,2,2,3
29208,17522,17528,23,13,2,0,1,1,2,4,-2,1,3,1
29209,17522,17528,1,6,2,1,1,0,3,1,2,3,1,4
29210,17522,17528,43,4,2,1,1,0,5,2,3,3,1,4
29211,17522,17528,51,12,2,0,1,1,2,3,-1,1,3,1
29212,17522,17528,24,13,2,0,1,1,2,4,-2,1,3,1
29213,17522,17528,22,13,2,0,1,1,2,4,-2,1,3,1
29214,17522,17528,32,17,2,0,0,2,2,6,-4,0,4,0
29215,17522,17528,57,18,2,0,0,2,1,5,-4,0,4,0
29216,17522,17528,33,2,2,2,0,0,5,2,3,4,0,6
29217,17522,17528,27,8,2,1,0,1,1,1,0,2,2,3
29218,17522,17528,45,16,2,0,1,1,0,2,-2,1,3,1
29219,17522,17528,4,3,2,1,1,0,7,2,5,3,1,4
29220,17522,17528,49,1,2,2,0,0,6,1,5,4,0,6
29221,17683,17689,33,9,20,8,5,7,31,27,4,21,19,29
29222,17683,17689,45,10,20,8,4,8,30,27,3,20,20,28
29223,17683,17689,27,13,20,6,3,11,26,36,-10,15,25,21
29224,17683,17689,57,5,20,10,2,8,32,31,1,22,18,32
29225,17683,17689,24,14,20,4,8,8,22,34,-12,16,24,20
29226,17683,17689,32,15,20,5,3,12,24,41,-17,13,27,18
29227,17683,17689,51,18,20,3,4,13,17,39,-22,10,30,13
29228,17683,17689,43,1,20,14,2,4,49,21,28,30,10,44
29229,17683,17689,22,4,20,11,3,6,31,27,4,25,15,36
29230,17683,17689,1,3,20,11,4,5,36,27,9,26,14,37
29231,17683,17689,4,8,20,8,5,7,41,29,12,21,19,29
29232,17683,17689,49,2,20,13,4,3,37,19,18,30,10,43
29233,17683,17689,23,16,20,4,6,10,25,37,-12,14,26,18
29234,17683,17689,42,17,20,3,7,10,21,29,-8,13,27,16
29235,17683,17689,25,6,20,9,4,7,25,24,1,22,18,31
29236,17683,17689,12,7,20,7,9,4,26,19,7,23,17,30
29237,17683,17689,56,11,20,7,7,6,22,28,-6,21,19,28
29238,17683,17689,35,12,20,6,6,8,25,25,0,18,22,24
29239,17550,17556,12,5,5,2,2,1,6,3,3,6,4,8
29240,17550,17556,25,6,5,2,2,1,3,4,-1,6,4,8
29241,17550,17556,56,9,5,2,1,2,5,9,-4,5,5,7
29242,17550,17556,35,12,5,1,2,2,5,4,1,4,6,5
29243,17550,17556,42,16,5,1,0,4,5,11,-6,2,8,3
29244,17550,17556,1,4,5,3,2,0,9,3,6,8,2,11
29245,17550,17556,43,1,5,4,1,0,13,3,10,9,1,13
29246,17550,17556,22,8,5,2,1,2,6,6,0,5,5,7
29247,17550,17556,57,10,5,2,0,3,6,9,-3,4,6,6
29248,17550,17556,24,14,5,1,2,2,4,7,-3,4,6,5
29249,17550,17556,51,17,5,0,2,3,3,8,-5,2,8,2
29250,17550,17556,32,18,5,0,1,4,3,11,-8,1,9,1
29251,17550,17556,27,11,5,2,0,3,4,7,-3,4,6,6
29252,18712,18718,49,4,15,8,4,3,22,20,2,20,10,28
29253,18712,18718,16,12,15,4,2,9,17,29,-12,10,20,14
29254,18712,18718,12,10,15,4,5,6,21,23,-2,13,17,17
29255,18712,18718,25,16,15,2,4,9,13,28,-15,8,22,10
29256,18712,18718,28,15,15,2,4,9,22,36,-14,8,22,10
29257,18775,18781,49,4,23,11,8,4,32,25,7,30,16,41
29258,18775,18781,16,13,23,5,7,11,27,44,-17,17,29,22
29259,18775,18781,28,16,23,2,7,14,25,51,-26,11,35,13
29260,18775,18781,12,11,23,6,9,8,31,34,-3,21,25,27
29261,18775,18781,25,15,23,4,5,14,21,39,-18,13,33,17
29262,18775,18781,4,2,23,13,4,6,50,25,25,30,16,43
29263,18775,18781,45,14,23,3,12,8,21,29,-8,18,28,21
29264,18775,18781,56,5,23,11,5,7,28,22,6,27,19,38
29265,18775,18781,35,9,23,7,8,8,34,33,1,22,24,29
29266,18775,18781,42,10,23,7,7,9,39,42,-3,21,25,28
29267,18775,18781,17,12,23,5,9,9,20,30,-10,19,27,24
29268,18775,18781,1,3,23,13,4,6,37,25,12,30,16,43
29269,18775,18781,43,1,23,15,5,3,44,19,25,35,11,50
29270,18775,18781,22,6,23,10,7,6,46,31,15,27,19,37
29271,18775,18781,57,7,23,9,7,7,29,28,1,25,21,34
29272,18775,18781,24,8,23,8,6,9,34,41,-7,22,24,30
29273,18782,18788,43,1,24,16,5,3,48,21,27,37,11,53
29274,18782,18788,22,6,24,10,7,7,48,35,13,27,21,37
29275,18782,18788,1,3,24,14,4,6,42,26,16,32,16,46
29276,18782,18788,42,11,24,7,7,10,40,45,-5,21,27,28
29277,18782,18788,17,12,24,5,9,10,20,32,-12,19,29,24
29278,18782,18788,56,5,24,11,6,7,28,22,6,28,20,39
29279,18782,18788,35,10,24,7,8,9,35,38,-3,22,26,29
29280,18782,18788,45,13,24,4,12,8,24,30,-6,20,28,24
29281,18782,18788,57,7,24,10,7,7,30,28,2,27,21,37
29282,18782,18788,24,8,24,8,7,9,34,41,-7,23,25,31
29283,18782,18788,4,2,24,14,4,6,53,27,26,32,16,46
29284,18782,18788,12,9,24,7,9,8,34,35,-1,23,25,30
29285,18782,18788,25,15,24,4,5,15,22,42,-20,13,35,17
29286,18782,18788,28,16,24,2,7,15,25,52,-27,11,37,13
29287,18782,18788,49,4,24,12,8,4,34,25,9,32,16,44
29288,18782,18788,16,14,24,5,7,12,29,47,-18,17,31,22
29289,19104,19110,49,5,21,11,2,8,42,28,14,24,18,35
29290,19104,19110,16,9,21,6,10,5,38,32,6,22,20,28
29291,19104,19110,12,4,21,11,4,6,38,30,8,26,16,37
29292,19104,19110,56,7,21,8,4,9,24,23,1,20,22,28
29293,19104,19110,35,14,21,5,3,13,23,42,-19,13,29,18
29294,19104,19110,4,12,21,5,7,9,24,33,-9,17,25,22
29295,19104,19110,45,2,21,12,5,4,34,22,12,29,13,41
29296,19104,19110,27,11,21,7,3,11,21,38,-17,17,25,24
29297,19104,19110,10,13,21,5,6,10,21,36,-15,16,26,21
29298,19104,19110,43,1,21,15,4,2,53,19,34,34,8,49
29299,19104,19110,22,6,21,9,8,4,42,32,10,26,16,35
29300,19104,19110,24,10,21,7,5,9,30,31,-1,19,23,26
29301,19104,19110,57,16,21,3,5,13,26,44,-18,11,31,14
29302,19104,19110,42,8,21,8,4,9,35,41,-6,20,22,28
29303,19104,19110,17,15,21,3,9,9,22,39,-17,15,27,18
29304,19104,19110,1,3,21,11,5,5,51,34,17,27,15,38
29305,19160,19166,43,1,27,19,5,3,65,24,41,43,11,62
29306,19160,19166,22,3,27,13,9,5,55,37,18,35,19,48
29307,19160,19166,24,7,27,12,5,10,41,36,5,29,25,41
29308,19160,19166,57,16,27,3,5,19,28,57,-29,11,43,14
29309,19160,19166,42,9,27,11,5,11,43,47,-4,27,27,38
29310,19160,19166,17,15,27,3,11,13,24,49,-25,17,37,20
29311,19160,19166,1,4,27,13,8,6,59,40,19,34,20,47
29312,19160,19166,45,2,27,17,6,4,44,25,19,40,14,57
29313,19160,19166,27,11,27,9,3,15,26,47,-21,21,33,30
29314,19160,19166,10,13,27,6,8,13,25,44,-19,20,34,26
29315,19160,19166,4,12,27,7,9,11,28,36,-8,23,31,30
29316,19160,19166,49,5,27,14,4,9,50,31,19,32,22,46
29317,19160,19166,16,10,27,7,11,9,44,46,-2,25,29,32
29318,19160,19166,56,8,27,11,5,11,31,28,3,27,27,38
29319,19160,19166,35,14,27,5,5,17,25,54,-29,15,39,20
29320,19160,19166,12,6,27,13,7,7,50,37,13,33,21,46
29321,19895,19901,56,4,27,15,2,10,53,33,20,32,22,47
29322,19895,19901,12,8,27,10,11,6,37,29,8,31,23,41
29323,19895,19901,25,12,27,7,9,11,38,59,-21,23,31,30
29324,19895,19901,49,5,27,14,5,8,47,38,9,33,21,47
29325,19895,19901,38,15,27,6,5,16,31,46,-15,17,37,23
29326,19895,19901,4,3,27,13,9,5,47,27,20,35,19,48
29327,19895,19901,9,9,27,9,5,13,32,45,-13,23,31,32
29328,19895,19901,43,2,27,14,9,4,46,27,19,37,17,51
29329,19895,19901,22,7,27,11,10,6,33,25,8,32,22,43
29330,17263,17269,22,5,15,7,5,3,21,17,4,19,11,26
29331,17263,17269,43,7,15,6,6,3,22,17,5,18,12,24
29332,17263,17269,51,13,15,4,5,6,20,30,-10,13,17,17
29333,17263,17269,24,15,15,2,6,7,20,29,-9,10,20,12
29334,17263,17269,4,6,15,6,6,3,30,18,12,18,12,24
29335,17263,17269,45,9,15,6,3,6,21,23,-2,15,15,21
29336,17263,17269,27,10,15,6,2,7,17,20,-3,14,16,20
29337,17403,17409,27,6,32,13,7,12,39,40,-1,33,31,46
29338,17403,17409,45,10,32,12,7,13,43,51,-8,31,33,43
29339,17403,17409,4,7,32,12,10,10,52,45,7,34,30,46
29340,17403,17409,22,9,32,12,8,12,52,51,1,32,32,44
29341,17403,17409,24,11,32,10,10,12,40,45,-5,30,34,40
29342,17403,17409,51,14,32,8,11,13,34,51,-17,27,37,35
29343,17403,17409,43,2,32,19,7,6,55,30,25,45,19,64
29344,17403,17409,57,4,32,16,8,8,59,32,27,40,24,56
29345,17403,17409,42,16,32,7,11,14,35,42,-7,25,39,32
29346,17403,17409,25,8,32,12,9,11,42,31,11,33,31,45
29347,17403,17409,35,5,32,15,7,10,42,30,12,37,27,52
29348,17403,17409,33,12,32,11,6,15,36,41,-5,28,36,39
29349,17403,17409,28,17,32,5,8,19,28,55,-27,18,46,23
29350,17403,17409,12,13,32,7,15,10,27,32,-5,29,35,36
29351,17403,17409,23,15,32,9,6,17,33,53,-20,24,40,33
29352,17403,17409,46,18,32,4,6,22,26,64,-38,14,50,18
29353,17403,17409,49,1,32,20,11,1,56,19,37,51,13,71
29354,17403,17409,1,3,32,19,7,6,41,28,13,45,19,64
29355,17158,17164,1,4,4,3,1,0,7,4,3,7,1,10
29356,17158,17164,49,1,4,4,0,0,16,3,13,8,0,12
29357,17158,17164,23,16,4,0,1,3,4,10,-6,1,7,1
29358,17158,17164,46,18,4,0,0,4,1,10,-9,0,8,0
29359,17158,17164,35,12,4,1,1,2,3,4,-1,3,5,4
29360,17158,17164,42,15,4,0,1,3,3,7,-4,1,7,1
29361,17158,17164,33,5,4,3,0,1,8,5,3,6,2,9
29362,17158,17164,28,17,4,0,0,4,4,10,-6,0,8,0
29363,17158,17164,12,7,4,2,1,1,3,2,1,5,3,7
29364,17158,17164,25,10,4,2,0,2,2,3,-1,4,4,6
29365,17158,17164,43,3,4,3,1,0,7,2,5,7,1,10
29366,17158,17164,22,8,4,2,1,1,5,7,-2,5,3,7
29367,17158,17164,57,9,4,2,0,2,7,7,0,4,4,6
29368,17158,17164,51,11,4,1,2,1,4,6,-2,4,4,5
29369,17158,17164,24,14,4,0,2,2,2,4,-2,2,6,2
29370,17158,17164,4,2,4,3,1,0,12,2,10,7,1,10
29371,17158,17164,27,6,4,2,1,1,5,3,2,5,3,7
29372,17158,17164,45,13,4,1,1,2,3,7,-4,3,5,4
29373,17599,17605,27,10,11,4,3,4,13,15,-2,11,11,15
29374,17599,17605,45,11,11,4,1,6,13,14,-1,9,13,13
29375,17599,17605,4,6,11,5,4,2,22,12,10,14,8,19
29376,17599,17605,43,3,11,7,1,3,28,15,13,15,7,22
29377,17599,17605,22,5,11,6,2,3,17,12,5,14,8,20
29378,17599,17605,57,9,11,5,1,5,16,16,0,11,11,16
29379,17599,17605,24,15,11,2,3,6,12,22,-10,7,15,9
29380,17599,17605,32,17,11,2,1,8,9,22,-13,5,17,7
29381,17599,17605,51,18,11,1,2,8,6,19,-13,4,18,5
29382,17599,17605,42,13,11,2,4,5,9,14,-5,8,14,10
29383,17599,17605,25,4,11,6,3,2,16,12,4,15,7,21
29384,17599,17605,12,8,11,4,6,1,14,8,6,14,8,18
29385,17599,17605,33,7,11,5,3,3,17,12,5,13,9,18
29386,17599,17605,56,12,11,3,4,4,10,18,-8,10,12,13
29387,17599,17605,35,16,11,1,5,5,10,14,-4,7,15,8
29388,17599,17605,49,2,11,7,2,2,19,11,8,16,6,23
29389,17599,17605,23,14,11,2,4,5,15,21,-6,8,14,10
29390,17599,17605,1,1,11,7,3,1,21,10,11,17,5,24
29391,17641,17668,49,2,17,10,4,3,30,17,13,24,10,34
29392,17641,17668,23,16,17,3,6,8,21,33,-12,12,22,15
29393,17641,17668,56,11,17,5,7,5,18,24,-6,17,17,22
29394,17641,17668,35,15,17,3,6,8,18,23,-5,12,22,15
29395,17641,17668,33,7,17,8,3,6,28,22,6,19,15,27
29396,17641,17668,42,14,17,3,6,8,19,24,-5,12,22,15
29397,17641,17668,25,6,17,8,4,5,22,20,2,20,14,28
29398,17641,17668,12,8,17,6,9,2,22,14,8,21,13,27
29399,17641,17668,43,1,17,12,2,3,43,17,26,26,8,38
29400,17641,17668,22,4,17,9,3,5,26,22,4,21,13,30
29401,17641,17668,57,5,17,9,1,7,29,28,1,19,15,28
29402,17641,17668,24,13,17,4,6,7,19,28,-9,14,20,18
29403,17641,17668,32,17,17,4,2,11,20,36,-16,10,24,14
29404,17641,17668,51,18,17,2,4,11,13,33,-20,8,26,10
29405,17641,17668,4,10,17,6,5,6,33,24,9,17,17,23
29406,17641,17668,45,9,17,7,3,7,25,23,2,17,17,24
29407,17641,17668,27,12,17,6,3,8,22,26,-4,15,19,21
29408,17641,17668,1,3,17,9,4,4,29,23,6,22,12,31
29409,14477,14490,35,7,32,15,7,10,52,43,9,37,27,52
29410,14477,14490,6,18,32,4,12,16,30,62,-32,20,44,24
29411,14477,14490,27,17,32,6,9,17,38,61,-23,21,43,27
29412,14477,14490,17,6,32,15,7,10,63,43,20,37,27,52
29413,14477,14490,37,13,32,9,8,15,48,60,-12,26,38,35
29414,14477,14490,25,8,32,14,8,10,66,63,3,36,28,50
29415,14477,14490,12,11,32,10,11,11,49,55,-6,31,33,41
29416,14477,14490,58,16,32,5,13,14,31,54,-23,23,41,28
29417,14477,14490,33,5,32,15,8,9,65,44,21,38,26,53
29418,14477,14490,28,14,32,9,7,16,38,60,-22,25,39,34
29419,14477,14490,43,1,32,21,8,3,83,35,48,50,14,71
29420,14477,14490,22,9,32,14,6,12,58,57,1,34,30,48
29421,14477,14490,24,10,32,12,5,15,46,72,-26,29,35,41
29422,14477,14490,34,12,32,11,3,18,52,68,-16,25,39,36
29423,14477,14490,49,4,32,18,2,12,65,47,18,38,26,56
29424,14715,14721,25,7,17,8,4,5,30,26,4,20,14,28
29425,14715,14721,33,5,17,9,3,5,37,21,16,21,13,30
29426,14715,14721,28,14,17,3,4,10,17,31,-14,10,24,13
29427,14715,14721,43,2,17,14,3,0,49,14,35,31,3,45
29428,14715,14721,22,13,17,4,6,7,18,22,-4,14,20,18
29429,14715,14721,34,15,17,3,4,10,17,41,-24,10,24,13
29430,14715,14721,24,16,17,2,4,11,21,38,-17,8,26,10
29431,14715,14721,40,17,17,1,6,10,12,31,-19,8,26,9
29432,14715,14721,49,3,17,9,4,4,42,23,19,22,12,31
29433,14715,14721,37,10,17,6,5,6,17,30,-13,17,17,23
29434,14715,14721,27,6,17,9,2,6,30,32,-2,20,14,29
29435,14715,14721,47,18,17,2,1,14,21,57,-36,5,29,7
29436,14715,14721,17,8,17,7,4,6,27,24,3,18,16,25
29437,14715,14721,35,11,17,7,1,9,28,28,0,15,19,22
29438,14715,14721,1,1,17,16,0,1,55,10,45,32,2,48
29439,14715,14721,4,4,17,9,4,4,36,26,10,22,12,31
29440,14715,14721,21,12,17,7,1,9,22,24,-2,15,19,22
29441,14715,14721,12,9,17,6,6,5,24,25,-1,18,16,24
29442,14750,14756,25,6,19,9,5,5,35,29,6,23,15,32
29443,14750,14756,12,10,19,7,6,6,27,28,-1,20,18,27
29444,14750,14756,28,15,19,3,4,12,20,36,-16,10,28,13
29445,14750,14756,4,5,19,9,5,5,39,31,8,23,15,32
29446,14750,14756,21,12,19,7,1,11,24,29,-5,15,23,22
29447,14750,14756,1,1,19,17,1,1,59,12,47,35,3,52
29448,14750,14756,35,9,19,9,1,9,34,29,5,19,19,28
29449,14750,14756,17,8,19,9,4,6,31,25,6,22,16,31
29450,14750,14756,47,17,19,3,1,15,22,60,-38,7,31,10
29451,14750,14756,27,4,19,10,2,7,35,33,2,22,16,32
29452,14750,14756,49,3,19,11,4,4,49,23,26,26,12,37
29453,14750,14756,37,11,19,7,5,7,19,36,-17,19,19,26
29454,14750,14756,43,2,19,15,4,0,54,18,36,34,4,49
29455,14750,14756,22,13,19,5,6,8,23,27,-4,16,22,21
29456,14750,14756,34,14,19,4,4,11,21,45,-24,12,26,16
29457,14750,14756,24,16,19,2,5,12,25,44,-19,9,29,11
29458,14750,14756,40,18,19,1,6,12,13,38,-25,8,30,9
29459,14750,14756,33,7,19,9,4,6,40,27,13,22,16,31
29460,14764,14770,28,16,21,3,4,14,20,40,-20,10,32,13
29461,14764,14770,43,1,21,17,4,0,62,18,44,38,4,55
29462,14764,14770,49,3,21,11,6,4,51,25,26,28,14,39
29463,14764,14770,37,11,21,8,5,8,21,41,-20,21,21,29
29464,14764,14770,27,7,21,10,3,8,36,38,-2,23,19,33
29465,14764,14770,22,12,21,6,6,9,26,32,-6,18,24,24
29466,14764,14770,34,14,21,5,4,12,22,46,-24,14,28,19
29467,14764,14770,24,17,21,2,5,14,27,51,-24,9,33,11
29468,14764,14770,40,18,21,1,6,14,14,43,-29,8,34,9
29469,14764,14770,47,15,21,5,1,15,26,60,-34,11,31,16
29470,14764,14770,17,9,21,9,4,8,33,29,4,22,20,31
29471,14764,14770,35,8,21,10,2,9,38,31,7,22,20,32
29472,14764,14770,1,2,21,17,3,1,62,15,47,37,5,54
29473,14764,14770,4,5,21,11,5,5,41,31,10,27,15,38
29474,14764,14770,21,13,21,7,2,12,25,32,-7,16,26,23
29475,14764,14770,33,6,21,10,4,7,44,30,14,24,18,34
29476,14764,14770,25,4,21,11,5,5,42,30,12,27,15,38
29477,14764,14770,12,10,21,8,7,6,32,30,2,23,19,31
29478,14820,14826,4,4,27,13,7,7,48,38,10,33,21,46
29479,14820,14826,21,12,27,9,4,14,31,39,-8,22,32,31
29480,14820,14826,1,2,27,18,8,1,69,21,48,44,10,62
29481,14820,14826,17,9,27,11,6,10,37,32,5,28,26,39
29482,14820,14826,47,16,27,6,2,19,30,70,-40,14,40,20
29483,14820,14826,22,11,27,9,7,11,33,37,-4,25,29,34
29484,14820,14826,34,14,27,6,6,15,27,56,-29,18,36,24
29485,14820,14826,40,15,27,4,9,14,23,46,-23,17,37,21
29486,14820,14826,24,17,27,4,7,16,34,59,-25,15,39,19
29487,11838,11844,22,12,21,6,8,7,23,19,4,20,22,26
29488,11838,11844,57,13,21,6,6,9,42,47,-5,18,24,24
29489,11838,11844,4,5,21,10,5,6,33,23,10,25,17,35
29490,11838,11844,21,7,21,10,3,8,38,35,3,23,19,33
29491,11838,11844,20,3,21,11,5,5,55,27,28,27,15,38
29492,11838,11844,41,14,21,6,6,9,28,45,-17,18,24,24
29493,11838,11844,35,15,21,6,3,12,33,44,-11,15,27,21
29494,11838,11844,6,18,21,2,3,16,20,53,-33,7,35,9
29495,11838,11844,27,9,21,9,5,7,35,30,5,23,19,32
29496,11838,11844,1,6,21,10,4,7,30,19,11,24,18,34
29497,11908,11914,43,1,29,23,5,1,70,20,50,51,7,74
29498,11908,11914,24,6,29,14,5,10,42,31,11,33,25,47
29499,11908,11914,22,13,29,8,10,11,33,36,-3,26,32,34
29500,11908,11914,57,15,29,7,9,13,56,65,-9,23,35,30
29501,11908,11914,20,3,29,14,7,8,67,41,26,35,23,49
29502,11908,11914,41,12,29,9,7,13,38,57,-19,25,33,34
29503,11908,11914,35,14,29,9,6,14,48,57,-9,24,34,33
29504,11908,11914,6,18,29,5,4,20,32,70,-38,14,44,19
29505,11908,11914,21,5,29,14,5,10,53,41,12,33,25,47
29506,11908,11914,4,10,29,11,8,10,42,38,4,30,28,41
29507,11908,11914,17,9,29,12,5,12,41,42,-1,29,29,41
29508,11908,11914,12,17,29,4,8,17,27,52,-25,16,42,20
29509,11908,11914,27,8,29,12,8,9,46,40,6,32,26,44
29510,11908,11914,49,2,29,15,8,6,54,34,20,38,20,53
29511,11908,11914,37,7,29,13,6,10,40,36,4,32,26,45
29512,11908,11914,14,16,29,5,5,19,35,85,-50,15,43,20
29513,11908,11914,52,11,29,10,11,8,37,30,7,31,27,41
29514,11908,11914,1,4,29,14,7,8,41,27,14,35,23,49
29515,11719,11732,1,3,9,6,1,2,13,6,7,13,5,19
29516,11719,11732,21,5,9,5,1,3,18,16,2,11,7,16
29517,11719,11732,4,9,9,4,2,3,15,11,4,10,8,14
29518,11719,11732,43,1,9,7,1,1,24,10,14,15,3,22
29519,11719,11732,24,7,9,5,0,4,15,12,3,10,8,15
29520,11719,11732,22,13,9,2,3,4,9,9,0,7,11,9
29521,11719,11732,57,17,9,1,3,5,18,24,-6,5,13,6
29522,11719,11732,49,2,9,7,1,1,19,10,9,15,3,22
29523,11719,11732,37,6,9,5,1,3,10,10,0,11,7,16
29524,11719,11732,14,12,9,3,0,6,15,22,-7,6,12,9
29525,11719,11732,20,8,9,4,2,3,21,15,6,10,8,14
29526,11719,11732,35,11,9,3,1,5,15,18,-3,7,11,10
29527,11719,11732,41,15,9,2,2,5,13,23,-10,6,12,8
29528,11719,11732,6,18,9,1,1,7,6,24,-18,3,15,4
29529,11719,11732,52,14,9,1,6,2,9,10,-1,8,10,9
29530,11719,11732,12,16,9,2,1,6,7,16,-9,5,13,7
29531,11719,11732,27,4,9,5,1,3,22,15,7,11,7,16
29532,11719,11732,17,10,9,3,3,3,15,13,2,9,9,12
29533,12671,12677,28,9,33,10,13,10,32,35,-3,33,33,43
29534,12671,12677,52,14,33,9,11,13,33,41,-8,29,37,38
29535,12671,12677,35,5,33,12,13,8,55,35,20,37,29,49
29536,12671,12677,13,7,33,12,10,11,53,44,9,34,32,46
29537,12671,12677,6,8,33,12,9,12,42,40,2,33,33,45
29538,12671,12677,41,17,33,5,7,21,34,70,-36,17,49,22
29539,12671,12677,49,3,33,20,9,4,50,23,27,49,17,69
29540,12671,12677,37,11,33,10,12,11,39,44,-5,32,34,42
29541,12671,12677,43,1,33,22,6,5,78,31,47,50,16,72
29542,12671,12677,34,4,33,14,10,9,62,56,6,38,28,52
29543,12671,12677,24,10,33,11,9,13,41,44,-3,31,35,42
29544,12671,12677,57,15,33,9,9,15,42,51,-9,27,39,36
29545,12671,12677,4,12,33,11,8,14,41,51,-10,30,36,41
29546,12671,12677,21,16,33,8,7,18,40,56,-16,23,43,31
29547,12671,12677,1,2,33,21,7,5,68,29,39,49,17,70
29548,12671,12677,9,18,33,4,9,20,32,80,-48,17,49,21
29549,12671,12677,27,13,33,10,10,13,33,43,-10,30,36,40
29550,12671,12677,17,6,33,13,9,11,48,50,-2,35,31,48
29551,12433,12439,17,2,5,4,0,1,16,8,8,8,2,12
29552,12433,12439,1,4,5,2,2,1,10,6,4,6,4,8
29553,12433,12439,21,5,5,2,2,1,9,6,3,6,4,8
29554,12433,12439,4,7,5,2,1,2,8,9,-1,5,5,7
29555,12433,12439,9,13,5,2,0,3,7,12,-5,4,6,6
29556,12433,12439,43,3,5,3,1,1,15,10,5,7,3,10
29557,12433,12439,34,9,5,2,1,2,10,12,-2,5,5,7
29558,12433,12439,57,10,5,2,1,2,4,7,-3,5,5,7
29559,12433,12439,24,11,5,2,0,3,6,8,-2,4,6,6
29560,12433,12439,49,1,5,4,1,0,11,2,9,9,1,13
29561,12433,12439,37,12,5,2,0,3,5,8,-3,4,6,6
29562,12433,12439,13,6,5,2,1,2,8,7,1,5,5,7
29563,12433,12439,35,14,5,1,3,1,9,7,2,5,5,6
29564,12433,12439,6,16,5,1,1,3,7,9,-2,3,7,4
29565,12433,12439,41,17,5,0,3,2,4,11,-7,3,7,3
29566,12433,12439,52,8,5,2,1,2,7,8,-1,5,5,7
29567,17550,17556,45,15,5,1,1,3,3,7,-4,3,7,4
29568,17550,17556,33,3,5,4,1,0,11,5,6,9,1,13
29569,17550,17556,49,2,5,4,1,0,10,2,8,9,1,13
29570,17550,17556,23,13,5,1,2,2,6,7,-1,4,6,5
29571,17550,17556,4,7,5,2,1,2,12,8,4,5,5,7
29572,17942,17948,4,8,10,4,2,4,18,13,5,10,10,14
29573,17942,17948,28,5,10,5,2,3,14,13,1,12,8,17
29574,17942,17948,49,4,11,5,5,1,20,10,10,15,7,20
29575,17942,17948,45,6,10,4,3,3,17,15,2,11,9,15
29576,17942,17948,27,11,11,3,3,5,13,20,-7,9,13,12
29577,17942,17948,51,15,10,1,2,7,12,26,-14,4,16,5
29578,17942,17948,24,2,11,7,0,4,19,15,4,14,8,21
29579,17942,17948,43,3,10,6,2,2,18,10,8,14,6,20
29580,17942,17948,22,12,10,2,5,3,13,13,0,9,11,11
29581,17942,17948,57,13,10,2,3,5,17,18,-1,7,13,9
29582,17942,17948,1,1,10,7,2,1,23,12,11,16,4,23
29583,17942,17948,25,9,10,3,1,6,11,19,-8,7,13,10
29584,17942,17948,12,14,10,2,2,6,12,19,-7,6,14,8
29585,17942,17948,35,7,11,4,3,4,12,15,-3,11,11,15
29586,17942,17948,56,10,10,3,3,4,11,12,-1,9,11,12
29587,17991,17997,25,9,16,5,4,7,18,24,-6,14,18,19
29588,17991,17997,12,14,16,2,3,11,12,26,-14,7,25,9
29589,17991,17997,35,4,16,8,4,4,24,19,5,20,12,28
29590,17991,17997,56,7,16,6,5,5,17,15,2,17,15,23
29591,17991,17997,1,2,16,11,2,3,31,19,12,24,8,35
29592,17991,17997,43,1,16,12,2,2,31,12,19,26,6,38
29593,17991,17997,24,10,16,7,0,9,22,30,-8,14,18,21
29594,17991,17997,22,11,15,4,6,5,18,17,1,14,16,18
29595,17991,17997,57,13,16,3,5,8,23,29,-6,11,21,14
29596,17991,17997,51,15,15,2,3,10,19,37,-18,7,23,9
29597,17991,17997,45,6,16,6,5,5,25,22,3,17,15,23
29598,17991,17997,27,12,16,3,6,7,16,26,-10,12,20,15
29599,17991,17997,28,8,16,6,4,6,19,21,-2,16,16,22
29600,17991,17997,49,5,16,6,7,3,27,18,9,19,13,25
29601,17991,17997,4,3,16,9,2,5,32,19,13,20,12,29
29602,18061,18067,4,3,24,12,6,6,44,27,17,30,18,42
29603,18061,18067,57,10,24,9,5,10,39,34,5,23,25,32
29604,18061,18067,22,11,24,7,9,8,29,26,3,23,25,30
29605,18061,18067,51,14,24,4,4,16,27,54,-27,12,36,16
29606,18061,18067,28,8,24,10,5,9,30,31,-1,25,23,35
29607,18061,18067,45,4,24,10,8,6,36,28,8,28,20,38
29608,18061,18067,27,13,25,5,7,13,27,39,-12,17,33,22
29609,18061,18067,1,2,24,14,5,5,44,30,14,33,15,47
29610,18061,18067,43,1,24,18,3,3,52,19,33,39,9,57
29611,18061,18067,24,7,25,11,2,12,33,42,-9,24,26,35
29612,18061,18067,49,5,25,10,8,7,36,29,7,28,22,38
29613,18061,18067,56,6,24,10,7,7,31,26,5,27,21,37
29614,18061,18067,35,9,25,9,7,9,28,36,-8,25,25,34
29615,18061,18067,25,12,24,6,7,11,22,32,-10,19,29,25
29616,18061,18067,12,15,24,4,3,17,19,44,-25,11,37,15
29617,18327,18333,12,7,14,6,5,3,20,20,0,17,11,23
29618,18327,18333,25,10,14,5,4,5,15,16,-1,14,14,19
29619,18327,18333,17,14,14,1,6,7,12,23,-11,8,20,9
29620,18327,18333,56,6,14,7,2,5,17,13,4,16,12,23
29621,18327,18333,35,12,14,3,4,7,10,23,-13,10,18,13
29622,18327,18333,1,9,14,6,3,5,30,21,9,15,13,21
29623,18327,18333,22,1,14,9,3,2,37,14,23,21,7,30
29624,18327,18333,43,3,14,8,4,2,29,11,18,20,8,28
29625,18327,18333,24,4,14,7,4,3,21,17,4,18,10,25
29626,18327,18333,57,8,14,6,4,4,18,18,0,16,12,22
29627,18327,18333,28,13,14,3,2,9,9,29,-20,8,20,11
29628,18327,18333,45,11,14,3,7,4,21,20,1,13,15,16
29629,18327,18333,15,15,14,2,2,10,16,27,-11,6,22,8
29630,18327,18333,27,16,14,1,4,9,9,26,-17,6,22,7
29631,18327,18333,49,5,14,7,3,4,27,20,7,17,11,24
29632,18327,18333,4,2,14,9,1,4,27,20,7,19,9,28
29633,18334,18340,4,3,15,9,1,5,28,22,6,19,11,28
29634,18334,18340,28,13,15,3,2,10,9,32,-23,8,22,11
29635,18334,18340,1,7,15,7,3,5,32,21,11,17,13,24
29636,18334,18340,45,11,15,3,8,4,22,21,1,14,16,17
29637,18334,18340,15,15,15,2,2,11,16,28,-12,6,24,8
29638,18334,18340,27,16,15,1,4,10,9,27,-18,6,24,7
29639,18334,18340,22,1,15,10,3,2,40,14,26,23,7,33
29640,18334,18340,43,2,15,9,4,2,31,12,19,22,8,31
29641,18334,18340,24,4,15,8,4,3,22,17,5,20,10,28
29642,18334,18340,57,10,15,6,4,5,18,21,-3,16,14,22
29643,18334,18340,49,5,15,8,3,4,28,20,8,19,11,27
29644,18334,18340,17,14,15,1,6,8,12,25,-13,8,22,9
29645,18334,18340,12,6,15,7,5,3,23,20,3,19,11,26
29646,17767,17773,45,7,31,14,6,11,50,36,14,34,28,48
29647,17767,17773,27,13,31,10,7,14,37,45,-8,27,35,37
29648,17767,17773,4,4,31,15,8,8,63,40,23,38,24,53
29649,17767,17773,1,3,31,17,5,9,53,44,9,39,23,56
29650,17767,17773,43,1,31,22,4,5,69,28,41,48,14,70
29651,17767,17773,22,5,31,15,5,11,48,45,3,35,27,50
29652,17767,17773,57,9,31,12,5,14,43,49,-6,29,33,41
29653,17767,17773,24,11,31,10,10,11,40,48,-8,30,32,40
29654,17767,17773,51,16,31,8,6,17,31,53,-22,22,40,30
29655,17767,17773,32,17,31,6,4,21,32,75,-43,16,46,22
29656,17767,17773,42,18,31,3,8,20,30,53,-23,14,48,17
29657,17767,17773,33,10,31,11,8,12,38,42,-4,30,32,41
29658,17767,17773,49,2,31,22,4,5,63,26,37,48,14,70
29659,17767,17773,23,15,31,8,7,16,41,56,-15,23,39,31
29660,17767,17773,35,12,31,10,9,12,40,37,3,29,33,39
29661,17767,17773,56,14,31,7,11,13,33,52,-19,25,37,32
29662,17767,17773,25,6,31,14,7,10,39,33,6,35,27,49
29663,17767,17773,12,8,31,12,12,7,37,25,12,36,26,48
29664,17984,17990,28,8,15,6,3,6,19,21,-2,15,15,21
29665,17984,17990,49,5,15,6,6,3,25,16,9,18,12,24
29666,17984,17990,45,6,15,6,5,4,25,21,4,17,13,23
29667,17984,17990,27,13,15,3,5,7,16,26,-10,11,19,14
29668,17984,17990,35,3,15,8,3,4,22,17,5,19,11,27
29669,17984,17990,56,10,15,5,5,5,16,15,1,15,15,20
29670,17984,17990,1,2,15,10,2,3,30,19,11,22,8,32
29671,17984,17990,43,1,15,11,2,2,28,11,17,24,6,35
29672,17984,17990,25,9,15,5,3,7,18,24,-6,13,17,18
29673,17984,17990,12,14,15,2,3,10,12,25,-13,7,23,9
29674,17984,17990,24,7,15,7,0,8,20,25,-5,14,16,21
29675,17984,17990,22,11,14,4,5,5,18,17,1,13,15,17
29676,17984,17990,57,12,15,3,5,7,22,26,-4,11,19,14
29677,17984,17990,51,15,15,2,3,10,19,37,-18,7,23,9
29678,17984,17990,4,4,15,8,2,5,27,17,10,18,12,26
29679,17879,17885,4,2,3,2,1,0,6,3,3,5,1,7
29680,17879,17885,27,7,3,1,1,1,2,2,0,3,3,4
29681,17879,17885,45,8,3,0,3,0,5,5,0,3,3,3
29682,17879,17885,43,1,3,3,0,0,8,2,6,6,0,9
29683,17879,17885,24,3,3,2,0,1,7,4,3,4,2,6
29684,17879,17885,22,9,2,0,2,0,3,3,0,2,2,2
29685,17879,17885,57,12,3,0,1,2,5,8,-3,1,5,1
29686,17879,17885,51,14,2,0,1,1,2,6,-4,1,3,1
29687,17879,17885,1,4,3,2,0,1,5,3,2,4,2,6
29688,17879,17885,28,6,3,1,2,0,4,3,1,4,2,5
29689,17879,17885,49,5,3,1,2,0,8,4,4,4,2,5
29690,17879,17885,12,13,3,0,1,2,2,5,-3,1,5,1
29691,17879,17885,25,15,3,0,1,2,2,8,-6,1,5,1
29692,17879,17885,35,10,3,0,2,1,2,3,-1,2,4,2
29693,17879,17885,56,11,2,0,1,1,1,3,-2,1,3,1
29694,18229,18235,56,4,1,1,0,0,1,0,1,2,0,3
29695,18229,18235,35,11,1,0,0,1,1,2,-1,0,2,0
29696,18229,18235,28,4,1,1,0,0,1,0,1,2,0,3
29697,18229,18235,49,7,1,0,1,0,1,1,0,1,1,1
29698,18229,18235,1,12,1,0,0,1,0,1,-1,0,2,0
29699,18229,18235,17,12,1,0,0,1,0,1,-1,0,2,0
29700,18229,18235,25,12,1,0,0,1,0,1,-1,0,2,0
29701,18229,18235,12,15,1,0,0,1,0,2,-2,0,2,0
29702,18229,18235,15,16,1,0,0,1,1,4,-3,0,2,0
29703,18229,18235,27,7,1,0,1,0,1,1,0,1,1,1
29704,18229,18235,45,7,1,0,1,0,1,1,0,1,1,1
29705,18229,18235,4,4,1,1,0,0,1,0,1,2,0,3
29706,18229,18235,43,1,1,1,0,0,4,1,3,2,0,3
29707,18229,18235,24,2,1,1,0,0,2,0,2,2,0,3
29708,18229,18235,22,3,1,1,0,0,2,1,1,2,0,3
29709,18229,18235,57,7,1,0,1,0,1,1,0,1,1,1
29710,18313,18319,22,1,12,9,2,1,35,11,24,20,4,29
29711,18313,18319,43,2,12,7,3,2,25,8,17,17,7,24
29712,18313,18319,24,5,12,6,4,2,18,14,4,16,8,22
29713,18313,18319,57,6,12,6,4,2,17,15,2,16,8,22
29714,18313,18319,4,4,12,7,1,4,23,19,4,15,9,22
29715,18313,18319,45,12,12,2,6,4,17,19,-2,10,14,12
29716,18313,18319,27,15,12,1,3,8,9,24,-15,5,19,6
29717,18313,18319,15,16,12,1,1,10,11,24,-13,3,21,4
29718,18313,18319,12,7,12,6,3,3,17,17,0,15,9,21
29719,18313,18319,25,10,12,4,3,5,12,14,-2,11,13,15
29720,18313,18319,1,8,12,6,1,5,26,17,9,13,11,19
29721,18313,18319,28,13,12,3,1,8,9,26,-17,7,17,10
29722,18313,18319,17,14,12,1,4,7,8,19,-11,6,18,7
29723,18313,18319,56,9,12,6,1,5,13,13,0,13,11,19
29724,18313,18319,35,11,12,3,3,6,10,19,-9,9,15,12
29725,18313,18319,49,3,12,7,2,3,24,15,9,16,8,23
29726,18691,18704,49,5,13,6,4,3,16,17,-1,16,10,22
29727,12433,12439,28,15,5,1,2,2,6,7,-1,4,6,5
29728,12433,12439,27,18,5,0,2,3,2,7,-5,2,8,2
29729,12839,12845,52,4,14,7,6,1,18,10,8,20,8,27
29730,12839,12845,28,15,14,3,4,7,14,25,-11,10,18,13
29731,12839,12845,35,10,14,4,6,4,23,17,6,14,14,18
29732,12839,12845,6,16,14,3,3,8,15,23,-8,9,19,12
29733,12839,12845,13,17,14,3,3,8,15,27,-12,9,19,12
29734,12839,12845,20,18,14,2,3,9,13,29,-16,7,21,9
29735,12839,12845,43,3,14,8,3,3,30,16,14,19,9,27
29736,12839,12845,34,8,14,5,5,4,20,18,2,15,13,20
29737,12839,12845,24,9,14,5,4,5,20,25,-5,14,14,19
29738,12839,12845,57,11,14,3,9,2,19,21,-2,15,13,18
29739,12839,12845,21,12,14,4,3,7,18,22,-4,11,17,15
29740,12839,12845,4,14,14,3,4,7,17,24,-7,10,18,13
29741,12839,12845,1,1,14,8,4,2,31,13,18,20,8,28
29742,12839,12845,27,7,14,5,6,3,27,26,1,16,12,21
29743,12839,12845,49,6,14,5,6,3,21,15,6,16,12,21
29744,12839,12845,37,13,14,4,3,7,15,19,-4,11,17,15
29745,12839,12845,47,5,14,7,2,5,19,16,3,16,12,23
29746,12839,12845,17,2,14,8,4,2,26,15,11,20,8,28
29747,13203,13209,17,5,12,5,6,1,18,10,8,16,8,21
29748,13203,13209,47,7,12,5,3,4,20,15,5,13,11,18
29749,13203,13209,6,10,12,4,4,4,19,21,-2,12,12,16
29750,13203,13209,35,13,12,4,2,6,15,17,-2,10,14,14
29751,13203,13209,27,8,12,5,1,6,19,18,1,11,13,16
29752,13203,13209,12,11,12,4,3,5,19,21,-2,11,13,15
29753,13203,13209,1,1,12,7,4,1,25,12,13,18,6,25
29754,13203,13209,33,4,12,6,4,2,21,12,9,16,8,22
29755,13203,13209,21,6,12,6,1,5,19,19,0,13,11,19
29756,13203,13209,4,14,12,4,2,6,20,25,-5,10,14,14
29757,13203,13209,43,3,12,6,5,1,21,9,12,17,7,23
29758,13203,13209,22,12,12,3,6,3,12,13,-1,12,12,15
29759,13203,13209,24,15,12,2,5,5,15,19,-4,9,15,11
29760,13203,13209,34,16,12,2,5,5,14,22,-8,9,15,11
29761,13203,13209,57,18,12,0,4,8,11,27,-16,4,20,4
29762,13203,13209,49,2,12,8,0,4,20,14,6,16,8,24
29763,13203,13209,52,9,12,4,4,4,12,13,-1,12,12,16
29764,13203,13209,28,17,12,2,3,7,17,30,-13,7,17,9
29765,13210,13216,33,3,13,7,4,2,22,12,10,18,8,25
29766,13210,13216,49,1,13,9,0,4,24,16,8,18,8,27
29767,13210,13216,43,4,13,6,5,2,21,10,11,17,9,23
29768,13210,13216,22,13,13,3,6,4,12,17,-5,12,14,15
29769,13210,13216,34,15,13,2,6,5,16,24,-8,10,16,12
29770,13210,13216,24,16,13,2,5,6,15,23,-8,9,17,11
29771,13210,13216,57,18,13,0,4,9,13,31,-18,4,22,4
29772,13210,13216,21,5,13,7,1,5,23,19,4,15,11,22
29773,13210,13216,4,12,13,4,3,6,21,26,-5,11,15,15
29774,13210,13216,52,8,13,5,4,4,13,13,0,14,12,19
29775,13210,13216,28,17,13,2,4,7,18,31,-13,8,18,10
29776,13210,13216,12,10,13,5,3,5,23,21,2,13,13,18
29777,13210,13216,27,11,13,5,2,6,21,20,1,12,14,17
29778,13210,13216,6,9,13,5,4,4,22,23,-1,14,12,19
29779,13210,13216,35,14,13,4,2,7,17,20,-3,10,16,14
29780,13210,13216,47,6,13,6,3,4,23,16,7,15,11,21
29781,13210,13216,17,7,13,5,6,2,19,13,6,16,10,21
29782,13210,13216,1,2,13,7,4,2,25,13,12,18,8,25
29783,13595,13601,47,2,13,6,6,1,25,13,12,18,8,24
29784,13595,13601,27,14,13,3,5,5,17,28,-11,11,15,14
29785,13595,13601,25,8,13,5,4,4,25,27,-2,14,12,19
29786,13595,13601,12,9,13,6,0,7,22,31,-9,12,14,18
29787,13595,13601,17,6,13,6,3,4,25,17,8,15,11,21
29788,13595,13601,33,16,13,2,4,7,10,19,-9,8,18,10
29789,13595,13601,1,1,13,11,2,0,35,8,27,24,2,35
29790,13595,13601,4,11,13,4,5,4,22,20,2,13,13,17
29791,13595,13601,21,17,13,2,2,9,15,27,-12,6,20,8
29792,13595,13601,22,3,13,7,2,4,31,19,12,16,10,23
29793,13595,13601,43,7,13,6,2,5,18,16,2,14,12,20
29794,13595,13601,34,12,13,4,3,6,21,23,-2,11,15,15
29795,13595,13601,49,15,13,3,4,6,14,19,-5,10,16,13
29796,13595,13601,37,18,13,1,5,7,14,24,-10,7,19,8
29797,13595,13601,28,10,13,5,3,5,13,16,-3,13,13,18
29798,13595,13601,52,13,13,4,2,7,18,30,-12,10,16,14
29799,13595,13601,6,4,13,7,2,4,26,19,7,16,10,23
29800,13595,13601,35,5,13,7,2,4,23,18,5,16,10,23
29801,13602,13608,35,4,14,7,3,4,24,19,5,17,11,24
29802,13602,13608,6,5,14,7,2,5,26,20,6,16,12,23
29803,13602,13608,49,12,14,4,4,6,18,20,-2,12,16,16
29804,13602,13608,37,17,14,2,5,7,15,24,-9,9,19,11
29805,13602,13608,22,3,14,8,2,4,33,20,13,18,10,26
29806,13973,13979,12,3,17,9,4,4,37,21,16,22,12,31
29807,13973,13979,25,8,17,8,2,7,37,29,8,18,16,26
29808,13973,13979,35,11,17,6,4,7,28,28,0,16,18,22
29809,13973,13979,6,16,17,4,3,10,18,28,-10,11,23,15
29810,13973,13979,56,18,17,1,4,12,23,48,-25,6,28,7
29811,14029,14042,35,9,22,10,4,8,36,32,4,24,20,34
29812,14029,14042,6,15,22,5,4,13,23,35,-12,14,30,19
29813,14029,14042,56,17,22,3,5,14,31,56,-25,11,33,14
29814,14029,14042,12,5,22,11,4,7,46,35,11,26,18,37
29815,14029,14042,25,11,22,9,3,10,43,40,3,21,23,30
29816,14029,14042,33,3,22,11,7,4,50,34,16,29,15,40
29817,14029,14042,28,7,22,10,6,6,31,24,7,26,18,36
29818,14029,14042,49,8,22,11,2,9,35,27,8,24,20,35
29819,14029,14042,37,16,22,4,4,14,23,40,-17,12,32,16
29820,14029,14042,17,10,22,10,3,9,42,35,7,23,21,33
29821,14029,14042,27,14,22,4,9,9,27,34,-7,17,27,21
29822,14029,14042,22,1,22,14,5,3,49,25,24,33,11,47
29823,14029,14042,43,4,22,11,5,6,41,32,9,27,17,38
29824,14029,14042,34,12,22,7,5,10,30,39,-9,19,25,26
29825,14029,14042,4,6,22,10,7,5,37,37,0,27,17,37
29826,14029,14042,9,18,22,2,7,13,20,52,-32,11,33,13
29827,14029,14042,47,13,22,6,8,8,29,34,-5,20,24,26
29828,14029,14042,1,2,22,14,4,4,40,22,18,32,12,46
29829,13896,13902,4,12,7,2,3,2,10,11,-1,7,7,9
29830,13896,13902,9,16,7,1,3,3,6,14,-8,5,9,6
29831,13896,13902,47,17,7,1,2,4,6,12,-6,4,10,5
29832,13896,13902,1,4,7,4,1,2,9,7,2,9,5,13
29833,13896,13902,22,2,7,5,1,1,12,6,6,11,3,16
29834,13896,13902,34,13,7,2,1,4,11,13,-2,5,9,7
29835,13896,13902,43,15,7,1,3,3,9,14,-5,5,9,6
29836,13896,13902,37,9,7,3,1,3,12,10,2,7,7,10
29837,13896,13902,49,10,7,3,0,4,10,8,2,6,8,9
29838,13896,13902,27,6,7,3,3,1,11,6,5,9,5,12
29839,13896,13902,17,8,7,3,1,3,15,12,3,7,7,10
29840,13896,13902,33,5,7,3,4,0,11,5,6,10,4,13
29841,13896,13902,28,7,7,3,2,2,11,8,3,8,6,11
29842,13896,13902,12,1,7,5,1,1,18,6,12,11,3,16
29843,13896,13902,25,3,7,5,0,2,18,13,5,10,4,15
29844,13896,13902,35,11,7,3,0,4,8,14,-6,6,8,9
29845,13896,13902,6,14,7,2,0,5,6,11,-5,4,10,6
29846,13896,13902,56,18,7,1,0,6,8,21,-13,2,12,3
29847,14309,14315,33,12,12,4,3,5,21,19,2,11,13,15
29848,14309,14315,28,14,12,2,2,8,14,31,-17,6,18,8
29849,14309,14315,17,2,12,8,3,1,24,12,12,19,5,27
29850,14309,14315,27,11,12,4,4,4,16,16,0,12,12,16
29851,14309,14315,49,10,12,5,1,6,18,22,-4,11,13,16
29852,14309,14315,37,17,12,1,4,7,15,29,-14,6,18,7
29853,14309,14315,43,1,12,10,2,0,37,16,21,22,2,32
29854,14309,14315,22,5,12,6,5,1,30,15,15,17,7,23
29855,14309,14315,24,7,12,6,0,6,17,26,-9,12,12,18
29856,14309,14315,34,9,12,5,2,5,23,19,4,12,12,17
29857,14309,14315,4,3,12,8,0,4,36,21,15,16,8,24
29858,14309,14315,25,8,12,5,3,4,25,26,-1,13,11,18
29859,14309,14315,12,15,12,1,5,6,13,24,-11,7,17,8
29860,14309,14315,58,18,12,0,6,6,6,24,-18,6,18,6
29861,14309,14315,47,13,12,2,4,6,13,18,-5,8,16,10
29862,14309,14315,35,4,12,7,2,3,24,18,6,16,8,23
29863,14309,14315,6,16,12,1,5,6,14,26,-12,7,17,8
29864,14309,14315,1,6,12,7,1,4,28,12,16,15,9,22
29865,14470,14476,4,3,31,18,3,10,70,49,21,39,23,57
29866,14470,14476,35,6,31,15,7,9,52,40,12,37,25,52
29867,14470,14476,6,18,31,4,11,16,29,61,-32,19,43,23
29868,14470,14476,47,14,31,9,5,17,50,65,-15,23,39,32
29869,14470,14476,1,2,31,19,4,8,65,30,35,42,20,61
29870,14470,14476,43,1,31,20,8,3,79,34,45,48,14,68
29871,14470,14476,22,8,31,14,6,11,57,53,4,34,28,48
29872,14470,14476,24,10,31,12,5,14,46,64,-18,29,33,41
29873,14470,14476,49,4,31,17,2,12,62,46,16,36,26,53
29874,14470,14476,37,13,31,9,8,14,45,56,-11,26,36,35
29875,14470,14476,27,17,31,5,9,17,35,61,-26,19,43,24
29876,14470,14476,17,7,31,14,7,10,62,43,19,35,27,49
29877,14470,14476,33,5,31,15,7,9,65,44,21,37,25,52
29878,14470,14476,28,15,31,8,7,16,34,57,-23,23,39,31
29879,14470,14476,34,12,31,11,3,17,51,65,-14,25,37,36
29880,14470,14476,25,9,31,13,8,10,58,63,-5,34,28,47
29881,14470,14476,12,11,31,10,10,11,49,55,-6,30,32,40
29882,14470,14476,58,16,31,5,12,14,30,53,-23,22,40,27
29883,14596,14602,12,6,2,1,1,0,2,0,2,3,1,4
29884,14596,14602,25,9,2,1,0,1,4,4,0,2,2,3
29885,14820,14826,49,3,27,14,9,4,64,33,31,37,17,51
29886,14820,14826,37,13,27,8,7,12,24,50,-26,23,31,31
29887,14820,14826,27,10,27,11,4,12,42,49,-7,26,28,37
29888,14820,14826,35,5,27,14,3,10,49,38,11,31,23,45
29889,14820,14826,33,6,27,13,6,8,54,37,17,32,22,45
29890,14820,14826,28,18,27,4,6,17,25,46,-21,14,40,18
29891,14820,14826,12,7,27,12,7,8,40,34,6,31,23,43
29892,14820,14826,25,8,27,12,6,9,48,42,6,30,24,42
29893,14820,14826,43,1,27,20,6,1,73,24,49,46,8,66
29894,15030,15036,17,12,11,3,4,4,13,15,-2,10,12,13
29895,15030,15036,12,6,11,6,1,4,16,10,6,13,9,19
29896,15030,15036,25,14,11,3,1,7,16,19,-3,7,15,10
29897,15030,15036,28,7,11,5,3,3,21,17,4,13,9,18
29898,15030,15036,33,9,11,5,0,6,22,14,8,10,12,15
29899,15030,15036,52,15,11,3,1,7,11,18,-7,7,15,10
29900,15030,15036,22,3,11,7,3,1,32,14,18,17,5,24
29901,15030,15036,43,4,11,6,3,2,22,12,10,15,7,21
29902,15030,15036,34,11,11,4,1,6,11,26,-15,9,13,13
29903,15030,15036,40,18,11,1,2,8,11,27,-16,4,18,5
29904,15030,15036,35,8,11,4,4,3,24,17,7,12,10,16
29905,15030,15036,6,13,11,3,4,4,20,26,-6,10,12,13
29906,15030,15036,27,10,11,4,2,5,10,15,-5,10,12,14
29907,15030,15036,49,5,11,6,3,2,17,12,5,15,7,21
29908,15030,15036,37,17,11,1,3,7,9,30,-21,5,17,6
29909,15030,15036,1,2,11,8,1,2,25,11,14,17,5,25
29910,15030,15036,4,1,11,8,2,1,21,12,9,18,4,26
29911,15030,15036,21,16,11,2,2,7,15,21,-6,6,16,8
29912,14967,14980,21,13,3,1,0,2,4,5,-1,2,4,3
29913,14967,14980,1,1,3,3,0,0,11,3,8,6,0,9
29914,14967,14980,27,11,3,1,1,1,1,3,-2,3,3,4
29915,14967,14980,17,9,3,1,2,0,4,3,1,4,2,5
29916,14967,14980,4,2,3,3,0,0,9,3,6,6,0,9
29917,14967,14980,6,7,3,2,0,1,7,6,1,4,2,6
29918,14967,14980,35,10,3,1,1,1,9,6,3,3,3,4
29919,14967,14980,49,4,3,2,1,0,5,1,4,5,1,7
29920,14967,14980,37,15,3,0,1,2,3,12,-9,1,5,1
29921,14967,14980,28,6,3,2,0,1,9,7,2,4,2,6
29922,14967,14980,33,12,3,1,0,2,7,4,3,2,4,3
29923,14967,14980,52,16,3,0,0,3,1,4,-3,0,6,0
29924,14967,14980,43,3,3,2,1,0,7,2,5,5,1,7
29925,14967,14980,22,5,3,2,0,1,10,5,5,4,2,6
29926,14967,14980,34,8,3,2,0,1,3,6,-3,4,2,6
29927,14967,14980,40,18,3,0,0,3,4,16,-12,0,6,0
29928,14967,14980,12,14,3,0,1,2,2,4,-2,1,5,1
29929,14967,14980,25,17,3,0,0,3,3,9,-6,0,6,0
29930,15198,15204,22,1,31,19,10,2,79,39,40,48,14,67
29931,15198,15204,43,3,31,16,11,4,64,34,30,43,19,59
29932,15198,15204,40,11,31,10,8,13,35,51,-16,28,34,38
29933,15198,15204,12,7,31,14,9,8,39,29,10,37,25,51
29934,15198,15204,25,13,31,9,7,15,45,54,-9,25,37,34
29935,15198,15204,34,17,31,4,8,19,27,66,-39,16,46,20
29936,15198,15204,33,4,31,16,5,10,65,35,30,37,25,53
29937,15198,15204,28,8,31,14,4,13,44,43,1,32,30,46
29938,15198,15204,52,12,31,11,4,16,40,52,-12,26,36,37
29939,15198,15204,49,5,31,14,11,6,54,35,19,39,23,53
29940,15198,15204,27,10,31,11,6,14,38,53,-15,28,34,39
29941,15198,15204,37,18,31,2,8,21,30,81,-51,12,50,14
29942,15198,15204,17,15,31,8,8,15,51,60,-9,24,38,32
29943,15198,15204,35,9,31,9,15,7,59,46,13,33,29,42
29944,15198,15204,6,14,31,9,7,15,48,62,-14,25,37,34
29945,15198,15204,1,2,31,21,3,7,68,35,33,45,17,66
29946,15198,15204,4,6,31,14,10,7,55,46,9,38,24,52
29947,15198,15204,21,16,31,6,10,15,41,61,-20,22,40,28
29948,14995,15001,1,2,6,5,0,1,15,6,9,10,2,15
29949,14995,15001,17,10,6,2,3,1,8,7,1,7,5,9
29950,14995,15001,6,9,6,3,0,3,12,16,-4,6,6,9
29951,14995,15001,35,12,6,1,4,1,14,11,3,6,6,7
29952,14995,15001,27,8,6,3,1,2,6,6,0,7,5,10
29953,14995,15001,49,3,6,4,2,0,10,4,6,10,2,14
29954,14995,15001,37,18,6,0,1,5,4,20,-16,1,11,1
29955,14995,15001,34,4,6,4,1,1,10,7,3,9,3,13
29956,14995,15001,22,5,6,3,2,1,18,11,7,8,4,11
29957,14995,15001,43,6,6,3,2,1,11,7,4,8,4,11
29958,14995,15001,40,17,6,0,1,5,6,21,-15,1,11,1
29959,14995,15001,28,7,6,3,2,1,14,11,3,8,4,11
29960,14995,15001,33,13,6,2,0,4,12,8,4,4,8,6
29961,14995,15001,52,16,6,0,1,5,5,12,-7,1,11,1
29962,14995,15001,12,11,6,2,1,3,7,8,-1,5,7,7
29963,14995,15001,25,15,6,1,0,5,12,15,-3,2,10,3
29964,14995,15001,4,1,6,6,0,0,15,6,9,12,0,18
29965,13602,13608,43,8,14,6,2,6,19,18,1,14,14,20
29966,13602,13608,34,13,14,4,3,7,21,25,-4,11,17,15
29967,13602,13608,4,9,14,5,5,4,23,20,3,15,13,20
29968,13602,13608,21,18,14,2,2,10,16,29,-13,6,22,8
29969,13602,13608,1,1,14,12,2,0,37,9,28,26,2,38
29970,13602,13608,28,7,14,6,3,5,15,16,-1,15,13,21
29971,13602,13608,52,14,14,4,2,8,19,34,-15,10,18,14
29972,13602,13608,33,16,14,3,4,7,12,20,-8,10,18,13
29973,13602,13608,17,6,14,6,3,5,26,19,7,15,13,21
29974,13602,13608,25,10,14,5,5,4,26,28,-2,15,13,20
29975,13602,13608,12,11,14,6,0,8,24,34,-10,12,16,18
29976,13602,13608,27,15,14,3,5,6,17,29,-12,11,17,14
29977,13602,13608,47,2,14,7,6,1,28,15,13,20,8,27
29978,13525,13531,47,11,5,1,3,1,5,5,0,5,5,6
29979,13525,13531,17,6,5,2,1,2,8,7,1,5,5,7
29980,13525,13531,6,3,5,4,1,0,16,6,10,9,1,13
29981,13525,13531,35,8,5,2,1,2,7,9,-2,5,5,7
29982,13525,13531,1,2,5,5,0,0,12,2,10,10,0,15
29983,13525,13531,27,5,5,2,2,1,5,6,-1,6,4,8
29984,13525,13531,37,13,5,1,2,2,5,7,-2,4,6,5
29985,13525,13531,49,14,5,1,1,3,7,8,-1,3,7,4
29986,13525,13531,12,9,5,2,0,3,6,12,-6,4,6,6
29987,13525,13531,25,16,5,1,1,3,7,14,-7,3,7,4
29988,13525,13531,52,7,5,2,1,2,7,7,0,5,5,7
29989,13525,13531,28,15,5,1,1,3,4,9,-5,3,7,4
29990,13525,13531,33,17,5,0,3,2,3,5,-2,3,7,3
29991,13525,13531,4,10,5,1,3,1,8,6,2,5,5,6
29992,13525,13531,21,18,5,0,0,5,2,10,-8,0,10,0
29993,13525,13531,22,1,5,5,0,0,18,5,13,10,0,15
29994,13525,13531,43,4,5,3,0,2,4,5,-1,6,4,9
29995,13525,13531,34,12,5,1,2,2,6,7,-1,4,6,5
29996,13532,13538,37,15,6,1,3,2,6,8,-2,5,7,6
29997,13532,13538,49,16,6,1,2,3,8,9,-1,4,8,5
29998,13532,13538,4,12,6,1,3,2,10,9,1,5,7,6
29999,13532,13538,21,18,6,0,0,6,4,15,-11,0,12,0
30000,13532,13538,43,6,6,3,0,3,5,7,-2,6,6,9
30001,13532,13538,34,13,6,1,3,2,7,8,-1,5,7,6
30002,13532,13538,27,8,6,2,2,2,5,11,-6,6,6,8
30003,13532,13538,12,7,6,3,0,3,9,14,-5,6,6,9
30004,13532,13538,25,9,6,2,1,3,12,16,-4,5,7,7
30005,13532,13538,52,10,6,2,1,3,7,11,-4,5,7,7
30006,13532,13538,33,14,6,1,3,2,5,6,-1,5,7,6
30007,13532,13538,28,17,6,1,1,4,4,14,-10,3,9,4
30008,13532,13538,1,1,6,6,0,0,16,2,14,12,0,18
30009,13532,13538,22,3,6,5,0,1,19,8,11,10,2,15
30010,13532,13538,17,4,6,3,1,2,13,7,6,7,5,10
30011,13532,13538,6,2,6,5,1,0,19,7,12,11,1,16
30012,13532,13538,35,5,6,3,1,2,12,9,3,7,5,10
30013,13532,13538,47,11,6,1,4,1,6,6,0,6,6,7
30014,13917,13930,47,17,10,1,3,6,8,17,-9,5,15,6
30015,13917,13930,35,13,10,3,2,5,11,18,-7,8,12,11
30016,13917,13930,6,15,10,2,2,6,10,16,-6,6,14,8
30017,13917,13930,56,18,10,1,2,7,15,29,-14,4,16,5
30018,13917,13930,1,3,10,6,2,2,17,10,7,14,6,20
30019,13917,13930,17,10,10,4,1,5,17,18,-1,9,11,13
30020,13917,13930,12,1,10,7,2,1,23,9,14,16,4,23
30021,13917,13930,25,4,10,6,1,3,28,18,10,13,7,19
30022,13917,13930,27,9,10,3,5,2,14,10,4,11,9,14
30023,13917,13930,4,7,10,4,4,2,19,14,5,12,8,16
30024,13917,13930,9,16,10,1,4,5,9,27,-18,6,14,7
30025,13917,13930,28,5,10,5,2,3,16,10,6,12,8,17
30026,13917,13930,33,11,10,3,4,3,15,18,-3,10,10,13
30027,13917,13930,49,6,10,5,1,4,18,10,8,11,9,16
30028,13917,13930,37,12,10,3,2,5,14,16,-2,8,12,11
30029,13917,13930,22,2,10,7,2,1,19,10,9,16,4,23
30030,13917,13930,34,8,10,4,2,4,16,16,0,10,10,14
30031,13917,13930,43,14,10,2,5,3,14,17,-3,9,11,11
30032,14071,14077,22,1,26,17,5,4,56,29,27,39,13,56
30033,14071,14077,43,3,26,15,5,6,52,34,18,35,17,50
30034,14071,14077,34,13,26,8,6,12,36,44,-8,22,30,30
30035,14071,14077,4,6,26,12,8,6,46,47,-1,32,20,44
30036,14071,14077,9,18,26,2,9,15,23,58,-35,13,39,15
30037,14071,14077,33,4,26,14,7,5,61,39,22,35,17,49
30038,14071,14077,28,7,26,12,7,7,41,29,12,31,21,43
30039,14071,14077,27,14,26,5,10,11,31,40,-9,20,32,25
30040,14071,14077,49,5,26,14,2,10,46,30,16,30,22,44
30041,14071,14077,37,15,26,5,5,16,26,51,-25,15,37,20
30042,14071,14077,12,8,26,12,5,9,50,47,3,29,23,41
30043,14071,14077,25,11,26,10,4,12,47,47,0,24,28,34
30044,14071,14077,1,2,26,17,4,5,50,27,23,38,14,55
30045,14071,14077,35,10,26,10,6,10,38,38,0,26,26,36
30046,18691,18704,16,11,13,4,2,7,15,24,-9,10,16,14
30047,18691,18704,12,10,13,4,3,6,19,21,-2,11,15,15
30048,18691,18704,25,16,13,1,4,8,11,24,-13,6,20,7
30049,18691,18704,28,15,13,1,4,8,19,32,-13,6,20,7
30050,18691,18704,56,6,13,6,3,4,20,14,6,15,11,21
30051,18691,18704,35,9,13,4,5,4,24,21,3,13,13,17
30052,18691,18704,42,8,13,4,5,4,25,22,3,13,13,17
30053,18691,18704,17,14,13,2,6,5,9,16,-7,10,16,12
30054,18691,18704,43,1,13,9,2,2,26,10,16,20,6,29
30055,18691,18704,57,3,13,7,5,1,18,11,7,19,7,26
30056,18691,18704,22,7,13,5,5,3,25,20,5,15,11,20
30057,18691,18704,24,12,13,4,2,7,15,26,-11,10,16,14
30058,18691,18704,45,13,13,2,6,5,11,17,-6,10,16,12
30059,18691,18704,1,4,13,6,4,3,26,18,8,16,10,22
30060,18691,18704,4,2,13,8,2,3,32,18,14,18,8,26
30061,18789,18795,4,3,25,14,4,7,54,30,24,32,18,46
30062,18789,18795,43,1,25,17,5,3,50,22,28,39,11,56
30063,18789,18795,57,6,25,11,7,7,31,28,3,29,21,40
30064,18789,18795,22,7,25,10,7,8,48,36,12,27,23,37
30065,18789,18795,24,10,25,8,7,10,34,42,-8,23,27,31
30066,18789,18795,45,14,25,4,12,9,25,32,-7,20,30,24
30067,18789,18795,42,11,25,7,8,10,42,47,-5,22,28,29
30068,18789,18795,17,12,25,6,9,10,22,33,-11,21,29,27
30069,18789,18795,56,5,25,11,7,7,30,24,6,29,21,40
30070,18789,18795,35,9,25,8,8,9,38,40,-2,24,26,32
30071,18789,18795,28,16,25,2,7,16,27,55,-28,11,39,13
30072,18789,18795,12,8,25,8,9,8,35,35,0,25,25,33
30073,18789,18795,25,15,25,4,5,16,23,45,-22,13,37,17
30074,18789,18795,49,4,25,12,8,5,35,27,8,32,18,44
30075,18789,18795,16,13,25,6,7,12,32,48,-16,19,31,25
30076,18789,18795,1,2,25,15,4,6,45,27,18,34,16,49
30077,18831,18956,1,2,30,19,4,7,51,32,19,42,18,61
30078,18831,18956,28,16,30,3,10,17,32,61,-29,16,44,19
30079,18831,18956,12,8,30,11,11,8,48,40,8,33,27,44
30080,18831,18956,25,15,30,5,5,20,29,59,-30,15,45,20
30081,18831,18956,56,6,30,13,7,10,39,36,3,33,27,46
30082,18831,18956,35,11,30,9,9,12,45,51,-6,27,33,36
30083,18831,18956,49,4,30,14,9,7,43,33,10,37,23,51
30084,18831,18956,16,14,30,7,8,15,38,58,-20,22,38,29
30085,18831,18956,42,10,30,9,9,12,50,55,-5,27,33,36
30086,18831,18956,17,12,30,6,13,11,24,36,-12,25,35,31
30087,18831,18956,45,13,30,6,12,12,32,38,-6,24,36,30
30088,18831,18956,43,1,30,20,7,3,61,26,35,47,13,67
30089,18831,18956,22,5,30,13,7,10,60,44,16,33,27,46
30090,18831,18956,57,7,30,13,7,10,36,37,-1,33,27,46
30091,18831,18956,24,9,30,10,7,13,40,50,-10,27,33,37
30092,18831,18956,4,3,30,17,5,8,63,35,28,39,21,56
30093,18642,18648,4,4,7,4,1,2,12,8,4,9,5,13
30094,18642,18648,45,12,7,1,3,3,7,12,-5,5,9,6
30095,18642,18648,43,2,7,4,2,1,11,6,5,10,4,14
30096,18642,18648,57,3,7,4,2,1,10,7,3,10,4,14
30097,18642,18648,22,6,7,3,3,1,14,9,5,9,5,12
30098,18642,18648,24,9,7,3,1,3,9,13,-4,7,7,10
30099,18642,18648,42,5,7,3,3,1,17,11,6,9,5,12
30100,18642,18648,17,14,7,0,5,2,4,6,-2,5,9,5
30101,18642,18648,35,11,7,2,3,2,11,10,1,7,7,9
30102,18642,18648,28,16,7,0,1,6,9,21,-12,1,13,1
30103,18642,18648,12,13,7,1,2,4,5,8,-3,4,10,5
30104,18642,18648,25,15,7,1,1,5,6,15,-9,3,11,4
30105,18642,18648,56,7,7,3,2,2,10,6,4,8,6,11
30106,18642,18648,49,8,7,3,2,2,10,10,0,8,6,11
30107,18642,18648,16,10,7,3,0,4,8,9,-1,6,8,9
30108,18642,18648,1,1,7,4,3,0,15,7,8,11,3,15
30109,18656,18669,1,3,9,5,4,0,18,9,9,14,4,19
30110,18656,18669,49,5,9,4,3,2,12,10,2,11,7,15
30111,18656,18669,16,9,9,3,1,5,10,16,-6,7,11,10
30112,18656,18669,12,13,9,2,3,4,10,11,-1,7,11,9
30113,18656,18669,25,14,9,1,3,5,7,16,-9,5,13,6
30114,18656,18669,28,16,9,0,2,7,14,27,-13,2,16,2
30115,18656,18669,56,6,9,4,2,3,11,7,4,10,8,14
30116,18656,18669,35,11,9,2,4,3,14,14,0,8,10,10
30117,18656,18669,42,7,9,3,4,2,21,16,5,10,8,13
30118,18656,18669,17,15,9,0,6,3,4,8,-4,6,12,6
30119,18656,18669,43,1,9,6,2,1,15,8,7,14,4,20
30120,18656,18669,57,4,9,4,4,1,12,9,3,12,6,16
30121,18656,18669,22,8,9,3,4,2,15,11,4,10,8,13
30122,18656,18669,24,10,9,3,1,5,9,16,-7,7,11,10
30123,18656,18669,45,12,9,2,4,3,9,13,-4,8,10,10
30124,18656,18669,4,2,9,6,1,2,22,12,10,13,5,19
30125,19062,19068,4,10,15,5,5,5,20,23,-3,15,15,20
30126,14596,14602,22,5,2,1,1,0,3,1,2,3,1,4
30127,14596,14602,43,7,2,1,1,0,3,2,1,3,1,4
30128,14596,14602,24,12,2,0,1,1,1,2,-1,1,3,1
30129,14596,14602,40,14,2,0,1,1,0,3,-3,1,3,1
30130,14596,14602,34,16,2,0,0,2,2,6,-4,0,4,0
30131,14596,14602,33,8,2,1,0,1,4,2,2,2,2,3
30132,14596,14602,28,13,2,0,1,1,0,1,-1,1,3,1
30133,14596,14602,17,4,2,2,0,0,4,1,3,4,0,6
30134,14596,14602,27,1,2,2,0,0,7,1,6,4,0,6
30135,14596,14602,49,3,2,2,0,0,7,3,4,4,0,6
30136,14596,14602,37,10,2,1,0,1,2,2,0,2,2,3
30137,14596,14602,47,18,2,0,0,2,3,9,-6,0,4,0
30138,14596,14602,35,17,2,0,0,2,0,5,-5,0,4,0
30139,14596,14602,4,11,2,1,0,1,4,7,-3,2,2,3
30140,14596,14602,21,15,2,0,0,2,1,3,-2,0,4,0
30141,14596,14602,1,2,2,2,0,0,8,3,5,4,0,6
30142,15086,15106,4,3,17,11,3,3,32,21,11,25,9,36
30143,15086,15106,21,15,17,4,4,9,22,29,-7,12,22,16
30144,15086,15106,35,7,17,7,5,5,35,24,11,19,15,26
30145,15086,15106,6,12,17,4,6,7,28,36,-8,14,20,18
30146,15086,15106,12,6,17,8,5,4,25,17,8,21,13,29
30147,15086,15106,25,11,17,5,3,9,28,32,-4,13,21,18
30148,15086,15106,1,1,17,12,1,4,38,19,19,25,9,37
30149,15086,15106,37,18,17,1,5,11,16,43,-27,7,27,8
30150,15086,15106,27,10,17,6,3,8,15,29,-14,15,19,21
30151,15086,15106,17,14,17,4,5,8,25,29,-4,13,21,17
30152,15086,15106,33,8,17,7,1,9,34,27,7,15,19,22
30153,15086,15106,28,9,17,6,4,7,26,27,-1,16,18,22
30154,15086,15106,52,13,17,5,2,10,23,32,-9,12,22,17
30155,15086,15106,22,4,17,10,6,1,48,23,25,26,8,36
30156,15086,15106,43,5,17,10,5,2,36,18,18,25,9,35
30157,15086,15106,34,16,17,4,3,10,17,40,-23,11,23,15
30158,15086,15106,40,17,17,3,5,9,20,36,-16,11,23,14
30159,15086,15106,49,2,17,11,4,2,32,18,14,26,8,37
30160,14960,14966,4,2,2,2,0,0,5,2,3,4,0,6
30161,14960,14966,21,10,2,1,0,1,3,3,0,2,2,3
30162,14960,14966,33,6,2,1,0,1,5,1,4,2,2,3
30163,14960,14966,28,11,2,1,0,1,6,7,-1,2,2,3
30164,14960,14966,52,16,2,0,0,2,0,2,-2,0,4,0
30165,14960,14966,43,1,2,2,0,0,6,1,5,4,0,6
30166,14960,14966,22,8,2,1,0,1,5,4,1,2,2,3
30167,14960,14966,34,12,2,1,0,1,1,5,-4,2,2,3
30168,14960,14966,40,18,2,0,0,2,3,11,-8,0,4,0
30169,14960,14966,12,14,2,0,1,1,1,2,-1,1,3,1
30170,14960,14966,25,17,2,0,0,2,2,5,-3,0,4,0
30171,14960,14966,49,4,2,1,1,0,3,0,3,3,1,4
30172,14960,14966,37,15,2,0,1,1,2,6,-4,1,3,1
30173,14960,14966,35,7,2,1,0,1,8,5,3,2,2,3
30174,14960,14966,6,9,2,1,0,1,4,4,0,2,2,3
30175,14960,14966,17,13,2,0,2,0,2,2,0,2,2,2
30176,14960,14966,27,5,2,1,1,0,1,0,1,3,1,4
30177,14960,14966,1,2,2,2,0,0,5,2,3,4,0,6
30178,15191,15197,4,7,30,13,10,7,51,44,7,36,24,49
30179,15191,15197,21,16,30,6,9,15,41,61,-20,21,39,27
30180,15191,15197,1,1,30,21,2,7,67,34,33,44,16,65
30181,15191,15197,49,5,30,14,10,6,53,34,19,38,22,52
30182,15191,15197,37,18,30,2,8,20,29,77,-48,12,48,14
30183,15191,15197,17,15,30,8,8,14,51,59,-8,24,36,32
30184,15191,15197,27,10,30,10,6,14,36,52,-16,26,34,36
30185,15191,15197,12,6,30,14,8,8,39,29,10,36,24,50
30186,15191,15197,25,13,30,9,7,14,45,53,-8,25,35,34
30187,15191,15197,35,9,30,8,15,7,55,45,10,31,29,39
30188,15191,15197,6,14,30,9,7,14,46,58,-12,25,35,34
30189,15191,15197,22,2,30,18,10,2,78,39,39,46,14,64
30190,15191,15197,43,3,30,16,10,4,63,33,30,42,18,58
30191,15191,15197,40,11,30,9,8,13,34,51,-17,26,34,35
30192,15191,15197,34,17,30,4,8,18,26,64,-38,16,44,20
30193,15191,15197,33,4,30,16,4,10,64,34,30,36,24,52
30194,15191,15197,28,8,30,14,4,12,44,42,2,32,28,46
30195,15191,15197,52,12,30,10,4,16,39,52,-13,24,36,34
30196,15212,15218,33,5,33,17,5,11,68,38,30,39,27,56
30197,15212,15218,28,8,33,16,4,13,51,46,5,36,30,52
30198,15212,15218,52,10,33,12,5,16,45,56,-11,29,37,41
30199,15212,15218,22,1,33,20,11,2,82,40,42,51,15,71
30200,15212,15218,43,3,33,17,12,4,68,37,31,46,20,63
30201,15212,15218,40,11,33,11,8,14,38,52,-14,30,36,41
30202,15212,15218,34,17,33,4,8,21,31,72,-41,16,50,20
30203,15212,15218,35,9,33,10,16,7,64,50,14,36,30,46
30204,15212,15218,6,13,33,10,8,15,53,65,-12,28,38,38
30205,15212,15218,27,12,33,11,6,16,39,59,-20,28,38,39
30206,18334,18340,25,9,15,6,4,5,16,16,0,16,14,22
30207,18334,18340,56,8,15,7,3,5,18,14,4,17,13,24
30208,18334,18340,35,12,15,3,4,8,10,24,-14,10,20,13
30209,18355,18361,56,9,18,7,4,7,19,18,1,18,18,25
30210,18355,18361,35,13,18,3,5,10,11,27,-16,11,25,14
30211,18355,18361,12,4,18,9,6,3,28,22,6,24,12,33
30212,18355,18361,25,10,18,6,6,6,24,25,-1,18,18,24
30213,18355,18361,17,15,18,2,6,10,15,35,-20,10,26,12
30214,18355,18361,49,5,18,9,3,6,36,24,12,21,15,30
30215,18355,18361,43,1,18,12,4,2,38,14,24,28,8,40
30216,18355,18361,22,2,18,12,3,3,45,17,28,27,9,39
30217,18355,18361,24,6,18,8,5,5,24,22,2,21,15,29
30218,18355,18361,57,7,18,8,5,5,23,22,1,21,15,29
30219,18355,18361,1,8,18,8,3,7,37,27,10,19,17,27
30220,18355,18361,28,12,18,6,2,10,14,34,-20,14,22,20
30221,18355,18361,4,3,18,11,2,5,37,27,10,24,12,35
30222,18355,18361,45,11,18,4,9,5,25,23,2,17,19,21
30223,18355,18361,15,14,18,3,3,12,20,33,-13,9,27,12
30224,18355,18361,27,16,18,1,4,13,11,37,-26,6,30,7
30225,18460,18592,4,3,30,17,6,7,59,42,17,40,20,57
30226,18460,18592,49,6,30,15,4,11,50,38,12,34,26,49
30227,18460,18592,45,11,30,7,12,11,39,41,-2,26,34,33
30228,18460,18592,15,15,30,5,8,17,28,50,-22,18,42,23
30229,18460,18592,27,16,30,4,7,19,20,54,-34,15,45,19
30230,18460,18592,1,4,30,16,5,9,60,35,25,37,23,53
30231,18460,18592,43,1,30,19,8,3,58,20,38,46,14,65
30232,18460,18592,22,2,30,19,7,4,64,27,37,45,15,64
30233,18460,18592,24,7,30,13,9,8,34,30,4,35,25,48
30234,18460,18592,57,9,30,11,6,13,33,34,-1,28,32,39
30235,18460,18592,12,5,30,13,11,6,43,36,7,37,23,50
30236,18460,18592,25,8,30,11,8,11,41,40,1,30,30,41
30237,18460,18592,17,14,30,4,12,14,26,58,-32,20,40,24
30238,18460,18592,28,12,30,8,5,17,20,51,-31,21,39,29
30239,18460,18592,56,10,30,11,5,14,36,39,-3,27,33,38
30240,18460,18592,35,13,30,5,11,14,24,40,-16,21,39,26
30241,18810,18823,12,8,28,10,10,8,45,38,7,30,26,40
30242,18810,18823,25,16,28,4,5,19,25,55,-30,13,43,17
30243,18810,18823,56,7,28,12,7,9,36,33,3,31,25,43
30244,18810,18823,35,10,28,9,8,11,43,47,-4,26,30,35
30245,18810,18823,42,11,28,8,8,12,47,53,-6,24,32,32
30246,18810,18823,17,12,28,6,12,10,23,34,-11,24,32,30
30247,18810,18823,43,1,28,19,6,3,57,23,34,44,12,63
30248,18810,18823,57,4,28,13,7,8,35,34,1,33,23,46
30249,18810,18823,22,6,28,12,7,9,55,40,15,31,25,43
30250,18810,18823,24,9,28,10,7,11,39,46,-7,27,29,37
30251,18810,18823,1,2,28,17,4,7,48,31,17,38,18,55
30252,18810,18823,28,15,28,3,9,16,29,56,-27,15,41,18
30253,18810,18823,45,13,28,5,12,11,29,36,-7,22,34,27
30254,18810,18823,49,5,28,12,9,7,37,32,5,33,23,45
30255,18810,18823,16,14,28,6,8,14,35,53,-18,20,36,26
30256,18810,18823,4,3,28,16,5,7,59,31,28,37,19,53
30257,19055,19061,4,10,14,5,4,5,18,21,-3,14,14,19
30258,19055,19061,45,1,14,9,1,4,26,17,9,19,9,28
30259,19055,19061,27,13,14,4,1,9,14,29,-15,9,19,13
30260,19055,19061,10,15,14,2,4,8,13,26,-13,8,20,10
30261,19055,19061,16,6,14,6,5,3,31,22,9,17,11,23
30262,19055,19061,49,7,14,7,1,6,27,22,5,15,13,22
30263,19055,19061,43,2,14,8,4,2,29,13,16,20,8,28
30264,19055,19061,22,3,14,6,7,1,23,16,7,19,9,25
30265,19055,19061,24,11,14,5,2,7,23,24,-1,12,16,17
30266,19055,19061,57,16,14,2,1,11,15,32,-17,5,23,7
30267,19055,19061,56,5,14,7,3,4,18,13,5,17,11,24
30268,19055,19061,35,12,14,4,2,8,18,26,-8,10,18,14
30269,19055,19061,1,8,14,6,4,4,30,23,7,16,12,22
30270,19055,19061,42,9,14,6,3,5,26,25,1,15,13,21
30271,19055,19061,17,14,14,2,7,5,15,23,-8,11,17,13
30272,19055,19061,12,4,14,7,3,4,24,18,6,17,11,24
30273,19083,19089,12,3,18,10,3,5,32,24,8,23,13,33
30274,19083,19089,56,7,18,8,4,6,21,17,4,20,16,28
30275,19083,19089,35,12,18,5,3,10,22,32,-10,13,23,18
30276,19083,19089,42,8,18,8,3,7,34,33,1,19,17,27
30277,19083,19089,17,14,18,3,7,8,18,32,-14,13,23,16
30278,19083,19089,1,6,18,8,5,5,39,32,7,21,15,29
30279,19083,19089,16,9,18,6,8,4,34,27,7,20,16,26
30280,19083,19089,49,5,18,9,2,7,33,24,9,20,16,29
30281,19083,19089,43,1,18,12,4,2,42,16,26,28,8,40
30282,19083,19089,22,4,18,8,8,2,34,24,10,24,12,32
30283,19083,19089,45,2,18,10,4,4,28,18,10,24,12,34
30284,14995,15001,21,14,6,1,1,4,7,10,-3,3,9,4
30285,15401,15407,43,5,11,6,2,3,25,15,10,14,8,20
30286,15401,15407,22,6,10,5,4,1,23,13,10,14,6,19
30287,15401,15407,40,11,10,2,4,4,11,11,0,8,12,10
30288,15401,15407,24,16,10,1,3,6,8,23,-15,5,15,6
30289,15401,15407,28,4,10,6,3,1,33,17,16,15,5,21
30290,15401,15407,33,8,11,3,4,4,22,27,-5,10,12,13
30291,15401,15407,37,12,10,3,0,7,10,24,-14,6,14,9
30292,15401,15407,49,13,10,2,3,5,12,19,-7,7,13,9
30293,15401,15407,27,17,11,0,4,7,12,27,-15,4,18,4
30294,15401,15407,35,10,10,3,2,5,18,24,-6,8,12,11
30295,15401,15407,17,3,10,7,2,1,21,7,14,16,4,23
30296,15401,15407,42,7,11,5,1,5,19,13,6,11,11,16
30297,15401,15407,1,1,11,10,1,0,28,8,20,21,1,31
30298,15401,15407,21,9,11,3,3,5,18,23,-5,9,13,12
30299,15401,15407,4,14,10,2,2,6,15,21,-6,6,14,8
30300,15401,15407,12,2,10,7,3,0,24,13,11,17,3,24
30301,15401,15407,25,15,10,2,1,7,6,20,-14,5,15,7
30302,15520,15526,4,9,23,10,2,11,34,37,-3,22,24,32
30303,15520,15526,21,14,23,6,4,13,30,44,-14,16,30,22
30304,15520,15526,1,1,23,21,1,1,75,19,56,43,3,64
30305,15520,15526,27,16,23,3,5,15,26,54,-28,11,35,14
30306,15520,15526,17,4,22,12,6,4,38,26,12,30,14,42
30307,15520,15526,42,6,23,11,3,9,35,26,9,25,21,36
30308,15520,15526,35,13,22,6,4,12,35,43,-8,16,28,22
30309,15520,15526,49,8,23,9,7,7,38,31,7,25,21,34
30310,15520,15526,37,11,22,9,1,12,36,52,-16,19,25,28
30311,15520,15526,28,5,22,12,5,5,50,29,21,29,15,41
30312,15520,15526,33,10,23,8,5,10,35,46,-11,21,25,29
30313,15520,15526,43,2,23,15,2,6,51,26,25,32,14,47
30314,15520,15526,22,7,22,10,6,6,49,37,12,26,18,36
30315,15520,15526,40,15,22,4,6,12,24,34,-10,14,30,18
30316,15520,15526,24,17,23,1,5,17,10,65,-55,7,39,8
30317,15520,15526,12,3,22,14,4,4,51,30,21,32,12,46
30318,15520,15526,25,12,23,7,2,14,19,37,-18,16,30,23
30319,15527,15533,12,3,23,15,4,4,53,31,22,34,12,49
30320,15527,15533,25,12,23,7,2,14,19,37,-18,16,30,23
30321,15527,15533,43,2,24,16,2,6,52,26,26,34,14,50
30322,15527,15533,22,7,23,10,6,7,49,38,11,26,20,36
30323,15527,15533,40,15,23,5,6,12,27,34,-7,16,30,21
30324,15527,15533,24,17,24,2,5,17,12,65,-53,9,39,11
30325,15527,15533,28,5,23,12,5,6,50,32,18,29,17,41
30326,15527,15533,33,10,24,8,5,11,35,50,-15,21,27,29
30327,15527,15533,49,9,24,9,7,8,39,33,6,25,23,34
30328,15527,15533,37,11,23,9,1,13,36,55,-19,19,27,28
30329,15527,15533,35,14,23,6,4,13,35,45,-10,16,30,22
30330,15527,15533,17,4,23,12,7,4,40,28,12,31,15,43
30331,15527,15533,42,6,24,11,3,10,36,28,8,25,23,36
30332,15527,15533,27,16,24,4,5,15,28,55,-27,13,35,17
30333,15527,15533,1,1,24,22,1,1,79,19,60,45,3,67
30334,15527,15533,4,8,24,11,2,11,37,37,0,24,24,35
30335,15527,15533,21,13,24,6,5,13,32,46,-14,17,31,23
30336,15555,15568,4,8,26,12,2,12,39,42,-3,26,26,38
30337,15555,15568,21,14,27,6,6,15,34,50,-16,18,36,24
30338,15555,15568,17,5,26,14,7,5,42,29,13,35,17,49
30339,15555,15568,42,9,27,11,3,13,39,36,3,25,29,36
30340,15555,15568,1,1,27,23,1,3,85,28,57,47,7,70
30341,15555,15568,27,16,27,5,5,17,31,59,-28,15,39,20
30342,15555,15568,35,15,26,6,5,15,36,48,-12,17,35,23
30343,15555,15568,49,7,26,11,7,8,42,33,9,29,23,40
30344,15555,15568,37,10,26,10,1,15,43,61,-18,21,31,31
30345,15555,15568,28,4,26,15,5,6,55,34,21,35,17,50
30346,15555,15568,33,12,27,8,5,14,38,56,-18,21,33,29
30347,15555,15568,43,2,27,19,2,6,60,28,32,40,14,59
30348,15555,15568,22,6,26,12,6,8,56,42,14,30,22,42
30349,15555,15568,40,13,26,6,7,13,28,36,-8,19,33,25
30350,15555,15568,24,17,26,2,5,19,12,72,-60,9,43,11
30351,15555,15568,12,3,26,18,4,4,63,35,28,40,12,58
30352,15555,15568,25,11,26,9,3,14,24,38,-14,21,31,30
30353,15331,15337,40,15,3,0,1,2,3,5,-2,1,5,1
30354,15331,15337,33,5,3,2,0,1,6,4,2,4,2,6
30355,15331,15337,28,11,2,1,0,1,4,4,0,2,2,3
30356,15331,15337,43,1,3,3,0,0,8,1,7,6,0,9
30357,15331,15337,22,3,3,2,0,1,11,7,4,4,2,6
30358,15331,15337,24,9,3,1,1,1,2,4,-2,3,3,4
30359,15331,15337,27,14,3,0,1,2,4,6,-2,1,5,1
30360,15331,15337,37,13,3,1,0,2,3,8,-5,2,4,3
30361,15331,15337,49,16,3,0,1,2,3,8,-5,1,5,1
30362,15331,15337,17,6,2,1,1,0,6,1,5,3,1,4
30363,19062,19068,43,1,15,9,4,2,35,14,21,22,8,31
30364,19062,19068,22,3,15,7,7,1,28,17,11,21,9,28
30365,19062,19068,24,11,15,5,3,7,24,25,-1,13,17,18
30366,19062,19068,57,16,15,2,2,11,17,34,-17,6,24,8
30367,19062,19068,42,9,15,6,3,6,27,30,-3,15,15,21
30368,19062,19068,17,14,15,2,7,6,16,26,-10,11,19,13
30369,19062,19068,16,6,15,6,6,3,31,22,9,18,12,24
30370,19062,19068,49,7,15,7,1,7,28,24,4,15,15,22
30371,19062,19068,35,12,15,5,2,8,21,27,-6,12,18,17
30372,19062,19068,56,5,15,7,4,4,18,13,5,18,12,25
30373,19062,19068,12,4,15,8,3,4,26,19,7,19,11,27
30374,19062,19068,45,2,15,9,2,4,27,18,9,20,10,29
30375,19062,19068,27,13,15,4,2,9,14,29,-15,10,20,14
30376,19062,19068,10,15,15,2,5,8,13,26,-13,9,21,11
30377,19062,19068,1,8,15,6,4,5,31,29,2,16,14,22
30378,19097,19103,45,2,20,12,4,4,33,21,12,28,12,40
30379,19097,19103,27,12,20,6,3,11,19,37,-18,15,25,21
30380,19097,19103,10,13,20,5,5,10,19,34,-15,15,25,20
30381,19097,19103,12,6,20,10,4,6,35,28,7,24,16,34
30382,19097,19103,56,7,20,8,4,8,22,20,2,20,20,28
30383,19097,19103,35,14,20,5,3,12,23,40,-17,13,27,18
30384,19097,19103,49,3,20,11,2,7,41,25,16,24,16,35
30385,19097,19103,16,9,20,6,9,5,36,30,6,21,19,27
30386,19097,19103,42,8,20,8,3,9,34,40,-6,19,21,27
30387,19097,19103,17,15,20,3,8,9,20,37,-17,14,26,17
30388,19097,19103,43,1,20,14,4,2,49,17,32,32,8,46
30389,19097,19103,22,5,20,9,8,3,40,28,12,26,14,35
30390,19097,19103,24,10,20,6,5,9,28,31,-3,17,23,23
30391,19097,19103,57,16,20,3,4,13,24,42,-18,10,30,13
30392,19097,19103,4,11,20,5,7,8,23,31,-8,17,23,22
30393,19097,19103,1,4,20,10,5,5,48,33,15,25,15,35
30394,19416,19418,22,2,13,9,2,2,25,10,15,20,6,29
30395,19416,19418,43,5,13,8,1,4,34,16,18,17,9,25
30396,19416,19418,24,8,13,4,3,6,18,21,-3,11,15,15
30397,19416,19418,57,11,13,3,5,5,11,21,-10,11,15,14
30398,19416,19418,17,12,13,3,2,8,9,22,-13,8,18,11
30399,19416,19418,42,16,13,0,3,10,9,23,-14,3,23,3
30400,19416,19418,56,7,13,7,1,5,18,14,4,15,11,22
30401,19416,19418,12,6,13,7,2,4,25,19,6,16,10,23
30402,19416,19418,45,3,13,8,4,1,27,19,8,20,6,28
30403,19416,19418,27,9,13,3,6,4,16,19,-3,12,14,15
30404,19416,19418,10,15,13,1,6,6,11,19,-8,8,18,9
30405,19416,19418,49,1,13,9,3,1,28,9,19,21,5,30
30406,19416,19418,16,13,13,2,5,6,16,23,-7,9,17,11
30407,19416,19418,4,10,13,3,6,4,16,21,-5,12,14,15
30408,19416,19418,9,14,13,2,3,8,9,23,-14,7,19,9
30409,19416,19418,1,4,13,8,2,3,21,14,7,18,8,26
30410,19475,19495,1,3,21,13,4,4,36,19,17,30,12,43
30411,19475,19495,49,1,21,14,6,1,44,12,32,34,8,48
30412,19475,19495,16,14,21,4,7,10,24,34,-10,15,27,19
30413,19475,19495,45,4,21,11,8,2,41,27,14,30,12,41
30414,19475,19495,27,10,21,5,9,7,25,28,-3,19,23,24
30415,19475,19495,10,15,21,3,8,10,16,28,-12,14,28,17
30416,19475,19495,12,5,21,11,3,7,36,24,12,25,17,36
30417,19475,19495,56,7,21,8,5,8,27,30,-3,21,21,29
30418,19475,19495,17,12,21,6,2,13,20,41,-21,14,28,20
30419,19475,19495,42,16,21,3,4,14,17,32,-15,10,32,13
30420,19475,19495,43,2,21,14,2,5,47,22,25,30,12,44
30421,19475,19495,22,6,21,11,2,8,32,26,6,24,18,35
30422,19475,19495,57,9,21,7,5,9,21,34,-13,19,23,26
30423,19475,19495,24,13,21,5,5,11,26,39,-13,15,27,20
30424,19475,19495,4,8,21,7,6,8,25,29,-4,20,22,27
30425,19475,19495,9,11,21,6,4,11,21,33,-12,16,26,22
30426,19531,19537,4,7,27,10,8,9,33,34,-1,28,26,38
30427,19531,19537,9,9,27,9,6,12,28,39,-11,24,30,33
30428,19531,19537,43,3,27,16,3,8,55,30,25,35,19,51
30429,19531,19537,22,6,27,13,2,12,37,34,3,28,26,41
30430,19531,19537,57,10,27,9,6,12,28,45,-17,24,30,33
30431,19531,19537,24,13,27,7,7,13,33,46,-13,21,33,28
30432,19531,19537,17,11,27,9,3,15,34,50,-16,21,33,30
30433,19531,19537,42,16,27,4,4,19,22,48,-26,12,42,16
30434,19531,19537,56,8,27,9,7,11,36,42,-6,25,29,34
30435,19531,19537,12,5,27,14,5,8,46,29,17,33,21,47
30436,19531,19537,49,1,27,19,6,2,56,15,41,44,10,63
30437,19531,19537,16,15,27,5,8,14,27,44,-17,18,36,23
30438,19531,19537,45,4,27,13,9,5,47,35,12,35,19,48
30439,19531,19537,27,12,27,7,9,11,31,38,-7,23,31,30
30440,19531,19537,10,14,27,6,10,11,25,32,-7,22,32,28
30441,19895,19901,24,10,27,7,11,9,30,35,-5,25,29,32
30442,19895,19901,57,14,27,6,6,15,19,40,-21,18,36,24
30443,19895,19901,27,6,27,12,7,8,41,30,11,31,23,43
30444,19895,19901,45,11,27,8,7,12,36,44,-8,23,31,31
30445,19895,19901,10,13,27,7,4,16,27,44,-17,18,36,25
30446,19895,19901,1,1,27,14,10,3,62,27,35,38,16,52
30447,19895,19901,17,16,27,5,6,16,29,59,-30,16,38,21
30448,19706,19712,17,10,4,1,1,2,4,5,-1,3,5,4
30449,19706,19712,1,3,4,2,2,0,5,2,3,6,2,8
30450,19706,19712,43,1,4,3,1,0,8,3,5,7,1,10
30451,19706,19712,24,12,4,1,0,3,5,8,-3,2,6,3
30452,19706,19712,57,13,4,0,3,1,2,3,-1,3,5,3
30453,19706,19712,22,14,4,0,3,1,3,5,-2,3,5,3
30454,19706,19712,45,9,4,1,1,2,5,6,-1,3,5,4
30455,19706,19712,10,15,4,0,2,2,3,6,-3,2,6,2
30456,19706,19712,27,16,4,0,1,3,4,9,-5,1,7,1
30457,19706,19712,4,2,4,3,1,0,7,2,5,7,1,10
30458,19706,19712,9,8,4,2,0,2,3,4,-1,4,4,6
30459,19706,19712,38,5,4,2,1,1,9,7,2,5,3,7
30460,19706,19712,49,7,4,2,0,2,8,8,0,4,4,6
30461,19706,19712,56,11,4,1,1,2,5,7,-2,3,5,4
30462,19706,19712,25,4,4,2,2,0,7,5,2,6,2,8
30463,19706,19712,12,6,4,2,1,1,4,2,2,5,3,7
30464,19748,19754,25,3,9,4,4,1,21,16,5,12,6,16
30465,19748,19754,12,4,9,4,3,2,12,9,3,11,7,15
30466,19748,19754,56,12,9,3,1,5,11,17,-6,7,11,10
30467,19748,19754,49,8,9,3,3,3,18,18,0,9,9,12
30468,19748,19754,38,10,9,3,2,4,15,14,1,8,10,11
30469,19748,19754,4,2,9,5,2,2,14,8,6,12,6,17
30470,19748,19754,9,5,9,4,2,3,14,13,1,10,8,14
30471,19748,19754,43,1,9,6,3,0,18,9,9,15,3,21
30472,19748,19754,24,7,9,4,0,5,17,16,1,8,10,12
30473,19748,19754,27,11,9,3,2,4,11,12,-1,8,10,11
30474,19748,19754,10,14,9,2,2,5,9,12,-3,6,12,8
30475,19748,19754,45,15,9,1,3,5,10,17,-7,5,13,6
30476,19748,19754,22,9,9,2,6,1,11,11,0,10,8,12
30477,19748,19754,57,13,9,2,3,4,7,12,-5,7,11,9
30478,19748,19754,1,6,9,3,5,1,16,10,6,11,7,14
30479,19748,19754,17,16,9,1,3,5,9,19,-10,5,13,6
30480,20133,20139,56,7,11,4,4,3,9,7,2,12,10,16
30481,20133,20139,1,5,11,6,1,4,22,13,9,13,9,19
30482,20133,20139,45,6,11,5,2,4,17,17,0,12,10,17
30483,20133,20139,24,12,11,3,3,5,15,19,-4,9,13,12
30484,20133,20139,27,9,11,3,5,3,10,11,-1,11,11,14
30485,20133,20139,10,10,11,4,1,6,17,25,-8,9,13,13
30486,20133,20139,43,3,11,6,4,1,18,8,10,16,6,22
30487,20133,20139,22,4,11,6,2,3,15,9,6,14,8,20
30488,20133,20139,9,1,11,7,2,2,21,11,10,16,6,23
30489,20133,20139,4,2,11,6,5,0,20,9,11,17,5,23
30490,20133,20139,16,11,11,3,3,5,14,17,-3,9,13,12
30491,20133,20139,49,16,11,2,2,7,12,25,-13,6,16,8
30492,20133,20139,28,8,11,4,2,5,13,13,0,10,12,14
30493,20133,20139,38,13,11,2,4,5,14,19,-5,8,14,10
30494,20133,20139,25,14,11,2,4,5,13,21,-8,8,14,10
30495,20133,20139,12,15,11,2,2,7,9,15,-6,6,16,8
30496,20175,20181,12,12,17,5,4,8,18,21,-3,14,20,19
30497,20175,20181,25,16,17,2,6,9,18,35,-17,10,24,12
30498,20175,20181,28,9,17,6,3,8,18,22,-4,15,19,21
30499,20175,20181,38,14,17,4,6,7,23,26,-3,14,20,18
30500,20175,20181,49,10,17,6,3,8,22,32,-10,15,19,21
30501,20175,20181,16,15,17,3,3,11,17,32,-15,9,25,12
30502,20175,20181,45,5,17,7,4,6,31,30,1,18,16,25
30503,20175,20181,27,7,17,6,6,5,19,18,1,18,16,24
30504,20175,20181,10,11,17,6,2,9,24,34,-10,14,20,20
30505,20175,20181,43,4,17,9,6,2,28,14,14,24,10,33
30506,20175,20181,22,8,17,7,2,8,20,21,-1,16,18,23
30507,20175,20181,24,13,17,5,3,9,24,31,-7,13,21,18
30508,20175,20181,1,2,17,11,1,5,35,17,18,23,11,34
30509,20175,20181,56,6,17,6,7,4,18,14,4,19,15,25
30510,20175,20181,4,1,17,10,6,1,33,15,18,26,8,36
30511,20175,20181,9,3,17,10,4,3,32,18,14,24,10,34
30512,20056,20062,1,6,2,1,0,1,4,2,2,2,2,3
30513,20056,20062,43,1,2,2,0,0,5,2,3,4,0,6
30514,20056,20062,22,8,2,1,0,1,3,2,1,2,2,3
30515,20056,20062,24,16,2,0,0,2,1,6,-5,0,4,0
30516,20056,20062,27,4,2,1,1,0,4,3,1,3,1,4
30517,20056,20062,45,7,2,1,0,1,4,3,1,2,2,3
30518,20056,20062,10,9,2,1,0,1,4,4,0,2,2,3
30519,20056,20062,9,1,2,2,0,0,5,2,3,4,0,6
30520,20056,20062,4,5,2,1,1,0,2,1,1,3,1,4
30521,20056,20062,49,10,2,1,0,1,3,3,0,2,2,3
30522,14071,14077,6,16,26,5,4,17,23,43,-20,14,38,19
30523,14071,14077,56,17,26,3,6,17,35,65,-30,12,40,15
30524,14071,14077,47,12,26,8,9,9,33,37,-4,25,27,33
30525,14071,14077,17,9,26,12,4,10,51,40,11,28,24,40
30526,14078,14084,17,8,27,13,4,10,57,40,17,30,24,43
30527,14078,14084,47,12,27,8,9,10,34,39,-5,25,29,33
30528,14078,14084,35,10,27,11,6,10,39,38,1,28,26,39
30529,14078,14084,6,16,27,5,4,18,24,45,-21,14,40,19
30530,14078,14084,56,17,27,4,6,17,36,65,-29,14,40,18
30531,14078,14084,1,2,27,17,4,6,50,30,20,38,16,55
30532,14078,14084,12,7,27,13,5,9,52,48,4,31,23,44
30533,14078,14084,25,11,27,10,4,13,47,49,-2,24,30,34
30534,14078,14084,49,5,27,15,2,10,49,30,19,32,22,47
30535,14078,14084,27,14,27,5,11,11,33,42,-9,21,33,26
30536,14078,14084,33,4,27,14,7,6,61,42,19,35,19,49
30537,14078,14084,28,9,27,12,7,8,41,35,6,31,23,43
30538,14078,14084,9,18,27,2,9,16,23,59,-36,13,41,15
30539,14078,14084,4,6,27,13,8,6,48,47,1,34,20,47
30540,14078,14084,22,1,27,18,5,4,59,29,30,41,13,59
30541,14078,14084,43,3,27,16,5,6,54,35,19,37,17,53
30542,14078,14084,34,13,27,8,7,12,38,46,-8,23,31,31
30543,14078,14084,37,15,27,5,5,17,26,52,-26,15,39,20
30544,14127,14133,49,6,33,17,3,13,55,44,11,37,29,54
30545,14127,14133,37,15,33,8,5,20,32,59,-27,21,45,29
30546,14127,14133,4,9,33,13,10,10,51,58,-7,36,30,49
30547,14127,14133,9,18,33,4,10,19,27,75,-48,18,48,22
30548,14127,14133,22,1,33,21,7,5,72,37,35,49,17,70
30549,14127,14133,43,3,33,20,7,6,73,38,35,47,19,67
30550,14127,14133,34,13,33,8,8,17,44,66,-22,24,42,32
30551,14127,14133,1,2,33,21,5,7,60,35,25,47,19,68
30552,14127,14133,33,4,33,19,8,6,75,46,29,46,20,65
30553,14127,14133,28,8,33,14,8,11,51,45,6,36,30,50
30554,14127,14133,27,14,33,7,11,15,39,52,-13,25,41,32
30555,14127,14133,12,5,33,17,6,10,68,57,11,40,26,57
30556,14127,14133,25,12,33,11,7,15,53,57,-4,29,37,40
30557,14127,14133,35,10,33,14,6,13,47,45,2,34,32,48
30558,14127,14133,6,16,33,6,7,20,31,55,-24,19,47,25
30559,14127,14133,56,17,33,6,7,20,48,78,-30,19,47,25
30560,14127,14133,47,11,33,10,11,12,43,44,-1,31,35,41
30561,14127,14133,17,7,33,15,6,12,69,47,22,36,30,51
30562,14302,14308,17,2,11,8,2,1,23,11,12,18,4,26
30563,14302,14308,47,14,11,1,4,6,10,18,-8,6,16,7
30564,14302,14308,6,16,11,1,4,6,14,26,-12,6,16,7
30565,14302,14308,35,5,11,6,2,3,21,17,4,14,8,20
30566,14302,14308,27,9,11,4,4,3,16,14,2,12,10,16
30567,14302,14308,33,11,11,4,2,5,21,19,2,10,12,14
30568,14302,14308,28,13,11,2,2,7,13,29,-16,6,16,8
30569,14302,14308,1,6,11,6,1,4,26,12,14,13,9,19
30570,14302,14308,43,1,11,9,2,0,32,14,18,20,2,29
30571,14302,14308,22,4,11,6,4,1,29,14,15,16,6,22
30572,14302,14308,4,3,11,8,0,3,35,18,17,16,6,24
30573,14302,14308,24,7,11,6,0,5,15,21,-6,12,10,18
30574,14302,14308,34,8,11,5,2,4,21,16,5,12,10,17
30575,14302,14308,49,12,11,4,1,6,16,21,-5,9,13,13
30576,14302,14308,37,17,11,1,3,7,14,28,-14,5,17,6
30577,14302,14308,25,10,11,4,3,4,22,24,-2,11,11,15
30578,14302,14308,12,15,11,1,4,6,12,23,-11,6,16,7
30579,14302,14308,58,18,11,0,6,5,6,21,-15,6,16,6
30580,14393,14399,49,4,21,12,2,7,46,35,11,26,16,38
30581,14393,14399,37,13,21,6,6,9,32,38,-6,18,24,24
30582,14393,14399,43,1,21,15,5,1,54,22,32,35,7,50
30583,14393,14399,22,3,21,11,6,4,46,29,17,28,14,39
30584,14393,14399,34,10,21,8,2,11,39,43,-4,18,24,26
30585,14393,14399,24,11,21,8,2,11,33,50,-17,18,24,26
30586,14393,14399,4,6,21,12,1,8,53,41,12,25,17,37
30587,14393,14399,33,8,21,10,4,7,43,32,11,24,18,34
30588,14393,14399,28,14,21,5,4,12,22,43,-21,14,28,19
30589,14393,14399,27,15,21,4,6,11,24,40,-16,14,28,18
30590,14393,14399,25,9,21,8,6,7,41,44,-3,22,20,30
30591,14393,14399,12,12,21,7,5,9,37,44,-7,19,23,26
30592,14393,14399,58,17,21,2,9,10,16,37,-21,13,29,15
30593,14393,14399,35,7,21,10,5,6,38,32,6,25,17,35
30594,14393,14399,6,18,21,1,10,10,21,42,-21,12,30,13
30595,14393,14399,47,16,21,4,4,13,32,46,-14,12,30,16
30596,14393,14399,17,5,21,11,5,5,38,25,13,27,15,38
30597,14393,14399,1,2,21,13,2,6,50,22,28,28,14,41
30598,14232,14238,1,1,3,3,0,0,11,2,9,6,0,9
30599,14232,14238,17,5,3,2,0,1,6,6,0,4,2,6
30600,19083,19089,27,13,18,5,3,10,17,31,-14,13,23,18
30601,19083,19089,10,15,18,3,5,10,16,34,-18,11,25,14
30602,19083,19089,4,10,18,5,6,7,21,27,-6,16,20,21
30603,19083,19089,24,11,18,5,5,8,26,28,-2,15,21,20
30604,19083,19089,57,16,18,3,2,13,22,40,-18,8,28,11
30605,19146,19152,43,1,25,17,5,3,61,23,38,39,11,56
30606,19146,19152,22,6,25,11,9,5,51,37,14,31,19,42
30607,19146,19152,24,8,25,10,5,10,37,36,1,25,25,35
30608,19146,19152,57,16,25,3,5,17,28,54,-26,11,39,14
30609,19146,19152,4,12,25,6,9,10,26,35,-9,21,29,27
30610,19146,19152,45,2,25,16,5,4,41,24,17,37,13,53
30611,19146,19152,27,11,25,8,3,14,25,45,-20,19,31,27
30612,19146,19152,10,13,25,6,8,11,24,40,-16,20,30,26
30613,19146,19152,49,4,25,13,4,8,49,30,19,30,20,43
30614,19146,19152,16,10,25,7,10,8,42,42,0,24,26,31
30615,19146,19152,1,5,25,12,7,6,55,38,17,31,19,43
30616,19146,19152,42,9,25,10,5,10,42,45,-3,25,25,35
30617,19146,19152,17,14,25,3,11,11,24,46,-22,17,33,20
30618,19146,19152,12,3,25,13,5,7,48,35,13,31,19,44
30619,19146,19152,56,7,25,10,5,10,30,26,4,25,25,35
30620,19146,19152,35,15,25,5,4,16,24,51,-27,14,36,19
30621,19468,19474,12,6,20,10,3,7,33,24,9,23,17,33
30622,19468,19474,1,2,20,13,4,3,35,17,18,30,10,43
30623,19468,19474,17,13,20,5,2,13,17,41,-24,12,28,17
30624,19468,19474,42,16,20,2,4,14,16,32,-16,8,32,10
30625,19468,19474,56,7,20,8,5,7,26,25,1,21,19,29
30626,19468,19474,16,14,20,3,7,10,21,34,-13,13,27,16
30627,19468,19474,49,1,20,13,6,1,39,11,28,32,8,45
30628,19468,19474,43,3,20,13,2,5,46,22,24,28,12,41
30629,19468,19474,4,8,20,7,6,7,25,28,-3,20,20,27
30630,19468,19474,9,10,20,6,4,10,21,30,-9,16,24,22
30631,19468,19474,22,5,20,11,2,7,32,23,9,24,16,35
30632,19468,19474,57,9,20,7,5,8,21,31,-10,19,21,26
30633,19468,19474,24,12,20,5,5,10,26,36,-10,15,25,20
30634,19468,19474,45,4,20,11,8,1,41,26,15,30,10,41
30635,19468,19474,27,11,20,4,9,7,22,28,-6,17,23,21
30636,19468,19474,10,15,20,2,8,10,14,27,-13,12,28,14
30637,19349,19355,43,2,5,4,0,1,18,6,12,8,2,12
30638,19349,19355,22,6,5,3,0,2,9,6,3,6,4,9
30639,19349,19355,57,9,5,1,2,2,4,7,-3,4,6,5
30640,19349,19355,24,10,5,1,1,3,4,7,-3,3,7,4
30641,19349,19355,1,3,5,3,2,0,8,4,4,8,2,11
30642,19349,19355,4,7,5,2,2,1,7,8,-1,6,4,8
30643,19349,19355,9,15,5,0,2,3,3,9,-6,2,8,2
30644,19349,19355,49,1,5,5,0,0,10,0,10,10,0,15
30645,19349,19355,16,11,5,1,1,3,4,8,-4,3,7,4
30646,19349,19355,45,4,5,3,2,0,7,3,4,8,2,11
30647,19349,19355,27,13,5,1,1,3,6,11,-5,3,7,4
30648,19349,19355,10,14,5,0,3,2,2,6,-4,3,7,3
30649,19349,19355,17,11,5,1,1,3,4,8,-4,3,7,4
30650,19349,19355,42,16,5,0,1,4,3,9,-6,1,9,1
30651,19349,19355,12,5,5,3,1,1,12,9,3,7,3,10
30652,19349,19355,56,8,5,2,1,2,7,7,0,5,5,7
30653,19356,19369,56,8,6,2,1,3,7,9,-2,5,7,7
30654,19356,19369,12,4,6,4,1,1,13,9,4,9,3,13
30655,19356,19369,17,12,6,1,2,3,4,8,-4,4,8,5
30656,19356,19369,42,16,6,0,1,5,3,10,-7,1,11,1
30657,19356,19369,45,2,6,4,2,0,11,6,5,10,2,14
30658,19356,19369,27,13,6,1,2,3,7,12,-5,4,8,5
30659,19356,19369,10,14,6,0,3,3,3,8,-5,3,9,3
30660,19356,19369,49,1,6,6,0,0,12,0,12,12,0,18
30661,19356,19369,16,11,6,1,2,3,5,9,-4,4,8,5
30662,19356,19369,4,6,6,3,2,1,8,8,0,8,4,11
30663,19356,19369,9,15,6,0,2,4,3,10,-7,2,10,2
30664,19356,19369,1,3,6,4,2,0,10,5,5,10,2,14
30665,19356,19369,43,5,6,4,0,2,21,10,11,8,4,12
30666,19356,19369,22,7,6,3,1,2,10,7,3,7,5,10
30667,19356,19369,57,9,6,1,3,2,5,8,-3,5,7,6
30668,19356,19369,24,10,6,1,2,3,4,7,-3,4,8,5
30669,19370,19376,43,4,7,5,0,2,26,10,16,10,4,15
30670,19370,19376,22,6,7,4,1,2,15,9,6,9,5,13
30671,19370,19376,27,10,7,1,3,3,7,12,-5,5,9,6
30672,19370,19376,10,14,7,0,4,3,4,9,-5,4,10,4
30673,19370,19376,1,2,7,5,2,0,14,6,8,12,2,17
30674,19370,19376,57,11,7,1,3,3,5,11,-6,5,9,6
30675,19370,19376,24,13,7,1,2,4,4,12,-8,4,10,5
30676,19370,19376,4,7,7,3,2,2,8,11,-3,8,6,11
30677,19370,19376,9,16,7,0,2,5,5,14,-9,2,12,2
30678,19370,19376,49,1,7,7,0,0,16,2,14,14,0,21
30679,19370,19376,16,9,7,1,3,3,5,9,-4,5,9,6
30680,20056,20062,16,15,2,0,0,2,1,5,-4,0,4,0
30681,20056,20062,28,3,2,2,0,0,4,1,3,4,0,6
30682,20056,20062,38,14,2,0,0,2,1,4,-3,0,4,0
30683,20056,20062,25,12,2,0,1,1,2,3,-1,1,3,1
30684,20056,20062,12,13,2,0,1,1,3,5,-2,1,3,1
30685,20056,20062,56,10,2,1,0,1,3,3,0,2,2,3
30686,20224,20230,12,9,22,7,6,9,26,28,-2,20,24,27
30687,20224,20230,25,16,22,4,7,11,25,45,-20,15,29,19
30688,20224,20230,28,10,22,7,5,10,22,30,-8,19,25,26
30689,20224,20230,38,15,22,5,6,11,28,37,-9,16,28,21
30690,20224,20230,49,7,22,9,4,9,30,36,-6,22,22,31
30691,20224,20230,16,14,22,6,4,12,29,38,-9,16,28,22
30692,20224,20230,45,5,22,9,6,7,38,36,2,24,20,33
30693,20224,20230,27,8,22,8,7,7,24,23,1,23,21,31
30694,20224,20230,10,12,22,7,4,11,31,42,-11,18,26,25
30695,20224,20230,43,3,22,11,8,3,35,19,16,30,14,41
30696,20224,20230,22,6,22,9,4,9,25,23,2,22,22,31
30697,20224,20230,24,11,22,7,4,11,33,40,-7,18,26,25
30698,20224,20230,1,2,22,14,1,7,45,25,20,29,15,43
30699,20224,20230,56,13,22,6,7,9,21,28,-7,19,25,25
30700,20224,20230,4,1,22,13,7,2,42,19,23,33,11,46
30701,20224,20230,9,4,22,11,6,5,41,26,15,28,16,39
30702,20231,20237,4,1,23,14,7,2,45,19,26,35,11,49
30703,20231,20237,9,4,23,11,6,6,42,28,14,28,18,39
30704,20231,20237,56,10,23,7,7,9,23,29,-6,21,25,28
30705,20231,20237,1,2,23,15,1,7,47,26,21,31,15,46
30706,20231,20237,43,3,23,12,8,3,37,20,17,32,14,44
30707,20231,20237,22,6,23,9,5,9,26,24,2,23,23,32
30708,20231,20237,24,11,23,7,5,11,34,41,-7,19,27,26
30709,20231,20237,45,5,23,9,7,7,40,38,2,25,21,34
30710,20231,20237,27,8,23,8,7,8,25,25,0,23,23,31
30711,20231,20237,10,13,23,7,4,12,32,44,-12,18,28,25
30712,20231,20237,28,12,23,7,5,11,23,32,-9,19,27,26
30713,20231,20237,38,15,23,5,7,11,29,38,-9,17,29,22
30714,20231,20237,49,7,23,9,4,10,30,39,-9,22,24,31
30715,20231,20237,16,14,23,6,5,12,31,40,-9,17,29,23
30716,20231,20237,12,9,23,7,7,9,27,29,-2,21,25,28
30717,20231,20237,25,16,23,5,7,11,27,46,-19,17,29,22
30718,20238,20244,12,9,24,7,7,10,28,31,-3,21,27,28
30719,20238,20244,25,16,24,5,7,12,28,48,-20,17,31,22
30720,20238,20244,38,15,24,5,8,11,32,41,-9,18,30,23
30721,20238,20244,49,7,24,10,4,10,32,39,-7,24,24,34
30722,20238,20244,16,14,24,6,5,13,31,42,-11,17,31,23
30723,20238,20244,4,1,24,15,7,2,47,20,27,37,11,52
30724,20238,20244,9,4,24,11,7,6,45,31,14,29,19,40
30725,20238,20244,28,12,24,7,5,12,24,34,-10,19,29,26
30726,20238,20244,45,5,24,10,7,7,42,39,3,27,21,37
30727,20238,20244,27,8,24,9,7,8,28,27,1,25,23,34
30728,20238,20244,10,13,24,7,4,13,33,46,-13,18,30,25
30729,20238,20244,43,3,24,13,8,3,39,21,18,34,14,47
30730,20238,20244,22,6,24,10,5,9,27,24,3,25,23,35
30731,20238,20244,24,11,24,7,5,12,36,44,-8,19,29,26
30732,20238,20244,1,2,24,16,1,7,49,27,22,33,15,49
30733,20238,20244,56,10,24,7,7,10,23,30,-7,21,27,28
30734,20105,20111,43,2,8,4,3,1,12,7,5,11,5,15
30735,20105,20111,22,5,8,4,2,2,11,7,4,10,6,14
30736,20105,20111,24,12,8,2,2,4,11,17,-6,6,10,8
30737,20105,20111,45,4,8,4,2,2,13,8,5,10,6,14
30738,20105,20111,10,8,8,3,1,4,13,20,-7,7,9,10
30739,20105,20111,27,13,8,1,5,2,6,9,-3,7,9,8
30740,20105,20111,16,14,8,2,1,5,9,13,-4,5,11,7
30741,20105,20111,49,15,8,2,1,5,8,18,-10,5,11,7
30742,20105,20111,9,1,8,6,1,1,17,8,9,13,3,19
30743,20105,20111,4,6,8,3,5,0,11,6,5,11,5,14
30744,20105,20111,28,3,8,4,2,2,12,6,6,10,6,14
30745,20105,20111,38,11,8,2,2,4,10,14,-4,6,10,8
30746,20105,20111,12,10,8,2,2,4,8,10,-2,6,10,8
30747,20105,20111,25,16,8,1,3,4,8,15,-7,5,11,6
30748,20105,20111,56,9,8,2,3,3,5,6,-1,7,9,9
30749,20105,20111,1,7,8,4,1,3,19,9,10,9,7,13
30750,20420,20426,25,7,1,0,1,0,2,2,0,1,1,1
30751,20420,20426,12,13,1,0,0,1,0,1,-1,0,2,0
30752,20420,20426,45,1,1,1,0,0,3,0,3,2,0,3
30753,20420,20426,27,5,1,1,0,0,1,0,1,2,0,3
30754,20420,20426,10,13,1,0,0,1,0,1,-1,0,2,0
30755,20420,20426,15,16,1,0,0,1,0,3,-3,0,2,0
30756,20420,20426,28,5,1,1,0,0,1,0,1,2,0,3
30757,20420,20426,38,11,1,0,0,1,1,2,-1,0,2,0
30758,20420,20426,49,7,1,0,1,0,2,2,0,1,1,1
30759,20420,20426,4,9,1,0,1,0,1,1,0,1,1,1
30760,15331,15337,42,9,3,1,1,1,2,4,-2,3,3,4
30761,15331,15337,35,12,3,1,0,2,6,10,-4,2,4,3
30762,15331,15337,1,2,3,3,0,0,7,1,6,6,0,9
30763,15331,15337,21,7,3,1,1,1,5,5,0,3,3,4
30764,15331,15337,4,8,3,1,1,1,3,3,0,3,3,4
30765,15331,15337,12,4,2,2,0,0,6,3,3,4,0,6
30766,15331,15337,25,17,3,0,0,3,1,6,-5,0,6,0
30767,15359,15365,12,3,5,4,1,0,12,4,8,9,1,13
30768,15359,15365,25,13,6,1,0,5,2,13,-11,2,10,3
30769,15359,15365,28,4,5,4,0,1,18,6,12,8,2,12
30770,15359,15365,33,6,6,3,1,2,18,13,5,7,5,10
30771,15359,15365,21,10,6,2,2,2,8,10,-2,6,6,8
30772,15359,15365,4,9,6,2,2,2,7,7,0,6,6,8
30773,15359,15365,35,11,5,2,1,2,9,12,-3,5,5,7
30774,15359,15365,17,5,5,3,1,1,10,2,8,7,3,10
30775,15359,15365,42,7,6,3,1,2,7,6,1,7,5,10
30776,15359,15365,1,1,6,6,0,0,14,2,12,12,0,18
30777,15359,15365,37,14,6,1,0,5,5,17,-12,2,10,3
30778,15359,15365,49,17,6,0,1,5,4,13,-9,1,11,1
30779,15359,15365,27,16,6,0,3,3,5,13,-8,3,9,3
30780,15359,15365,43,2,6,4,1,1,17,8,9,9,3,13
30781,15359,15365,22,8,5,2,2,1,14,10,4,6,4,8
30782,15359,15365,24,12,6,1,1,4,3,15,-12,3,9,4
30783,15359,15365,40,15,5,0,3,2,5,7,-2,3,7,3
30784,15765,15771,43,1,11,10,1,0,32,6,26,21,1,31
30785,15765,15771,22,2,11,7,2,2,24,14,10,16,6,23
30786,15765,15771,33,4,11,5,4,2,19,11,8,14,8,19
30787,15765,15771,28,7,11,4,4,3,15,14,1,12,10,16
30788,15765,15771,25,6,11,5,3,3,16,17,-1,13,9,18
30789,15765,15771,12,15,11,2,3,6,12,20,-8,7,15,9
30790,15765,15771,37,14,11,3,0,8,11,25,-14,6,16,9
30791,15765,15771,49,3,11,7,1,3,20,9,11,15,7,22
30792,15765,15771,17,10,11,3,5,3,12,13,-1,11,11,14
30793,15765,15771,42,16,11,1,6,4,10,17,-7,8,14,9
30794,15765,15771,40,8,11,3,6,2,16,11,5,12,10,15
30795,15765,15771,57,11,11,3,5,3,8,12,-4,11,11,14
30796,15765,15771,27,17,11,1,4,6,5,11,-6,6,16,7
30797,15765,15771,35,12,11,3,4,4,9,12,-3,10,12,13
30798,15765,15771,1,5,11,5,3,3,23,14,9,13,9,18
30799,15765,15771,4,9,11,3,6,2,13,11,2,12,10,15
30800,15765,15771,21,13,11,3,1,7,8,23,-15,7,15,10
30801,15765,15771,31,18,11,1,2,8,7,20,-13,4,18,5
30802,15884,15890,25,6,24,11,8,5,37,28,9,30,18,41
30803,15884,15890,12,16,24,5,7,12,29,42,-13,17,31,22
30804,15884,15890,1,2,24,14,4,6,51,25,26,32,16,46
30805,15884,15890,4,11,24,6,10,8,23,25,-2,22,26,28
30806,15884,15890,21,17,24,5,4,15,20,47,-27,14,34,19
30807,15884,15890,31,18,24,4,6,14,22,47,-25,14,34,18
30808,15884,15890,35,7,24,8,9,7,22,25,-3,25,23,33
30809,15884,15890,42,12,24,5,9,10,23,32,-9,19,29,24
30810,15884,15890,17,14,24,4,11,9,22,32,-10,19,29,23
30811,15884,15890,49,3,24,13,7,4,50,23,27,33,15,46
30812,15884,15890,37,9,24,9,2,13,34,41,-7,20,28,29
30813,15884,15890,27,15,24,5,7,12,23,32,-9,17,31,22
30814,15884,15890,43,1,24,21,2,1,63,18,45,44,4,65
30815,15884,15890,22,4,24,12,6,6,45,30,15,30,18,42
30816,15884,15890,40,10,24,6,11,7,31,34,-3,23,25,29
30817,15884,15890,57,13,24,5,9,10,20,42,-22,19,29,24
30818,15884,15890,33,5,24,11,9,4,47,32,15,31,17,42
30819,15884,15890,28,8,24,8,7,9,28,35,-7,23,25,31
30820,15926,15932,27,17,29,6,8,15,30,41,-11,20,38,26
30821,15926,15932,43,1,29,22,4,3,67,23,44,48,10,70
30822,15926,15932,22,5,29,13,8,8,49,36,13,34,24,47
30823,15926,15932,40,11,29,7,12,10,34,39,-5,26,32,33
30824,15926,15932,57,15,29,6,11,12,23,46,-23,23,35,29
30825,15926,15932,25,6,29,13,8,8,46,38,8,34,24,47
30826,15926,15932,12,14,29,8,7,14,37,49,-12,23,35,31
30827,15926,15932,49,3,29,15,10,4,57,25,32,40,18,55
30828,15926,15932,37,9,29,10,4,15,37,50,-13,24,34,34
30829,15926,15932,4,10,29,7,12,10,26,29,-3,26,32,33
30830,15926,15932,21,16,29,7,5,17,25,53,-28,19,39,26
30831,15926,15932,31,18,29,6,6,17,30,56,-26,18,40,24
30832,15926,15932,33,4,29,14,11,4,58,36,22,39,19,53
30833,15926,15932,28,8,29,8,11,10,32,40,-8,27,31,35
30834,15926,15932,1,2,29,18,5,6,61,29,32,41,17,59
30835,15926,15932,42,12,29,7,11,11,28,36,-8,25,33,32
30836,15926,15932,17,13,29,6,14,9,26,34,-8,26,32,32
30837,15926,15932,35,7,29,9,11,9,25,31,-6,29,29,38
30838,15933,15939,35,7,30,9,11,10,26,33,-7,29,31,38
30839,15933,15939,17,10,30,7,14,9,27,34,-7,28,32,35
30840,15212,15218,17,15,33,8,8,17,51,64,-13,24,42,32
30841,15212,15218,49,6,33,15,11,7,56,37,19,41,25,56
30842,15212,15218,37,18,33,2,8,23,30,88,-58,12,54,14
30843,15212,15218,4,4,33,16,10,7,59,46,13,42,24,58
30844,15212,15218,21,16,33,7,10,16,47,64,-17,24,42,31
30845,15212,15218,1,2,33,21,4,8,72,41,31,46,20,67
30846,15212,15218,12,7,33,15,9,9,40,30,10,39,27,54
30847,15212,15218,25,14,33,9,9,15,48,57,-9,27,39,36
30848,14988,14994,4,2,5,5,0,0,12,4,8,10,0,15
30849,14988,14994,21,13,5,1,1,3,5,7,-2,3,7,4
30850,14988,14994,1,1,5,5,0,0,15,5,10,10,0,15
30851,14988,14994,17,7,5,2,3,0,6,3,3,7,3,9
30852,14988,14994,49,3,5,3,2,0,8,3,5,8,2,11
30853,14988,14994,37,18,5,0,1,4,4,18,-14,1,9,1
30854,14988,14994,27,6,5,3,1,1,6,5,1,7,3,10
30855,14988,14994,6,10,5,2,0,3,10,16,-6,4,6,6
30856,14988,14994,35,11,5,1,3,1,12,9,3,5,5,6
30857,14988,14994,12,12,5,1,1,3,6,8,-2,3,7,4
30858,14988,14994,25,15,5,1,0,4,11,13,-2,2,8,3
30859,14988,14994,28,4,5,3,1,1,12,9,3,7,3,10
30860,14988,14994,33,14,5,1,0,4,8,7,1,2,8,3
30861,14988,14994,52,16,5,0,1,4,4,8,-4,1,9,1
30862,14988,14994,34,5,5,3,1,1,7,6,1,7,3,10
30863,14988,14994,22,8,5,2,2,1,14,9,5,6,4,8
30864,14988,14994,43,9,5,2,2,1,10,7,3,6,4,8
30865,14988,14994,40,17,5,0,1,4,5,18,-13,1,9,1
30866,15002,15011,22,3,7,4,2,1,20,12,8,10,4,14
30867,15002,15011,43,4,7,4,2,1,16,8,8,10,4,14
30868,15002,15011,34,6,7,4,1,2,11,12,-1,9,5,13
30869,15002,15011,40,18,7,0,1,6,7,23,-16,1,13,1
30870,15002,15011,28,7,7,3,2,2,15,13,2,8,6,11
30871,15002,15011,33,12,7,3,0,4,14,9,5,6,8,9
30872,15002,15011,52,17,7,0,1,6,5,13,-8,1,13,1
30873,15002,15011,12,9,7,3,1,3,9,8,1,7,7,10
30874,15002,15011,25,14,7,2,0,5,13,15,-2,4,10,6
30875,15002,15011,6,10,7,3,1,3,14,18,-4,7,7,10
30876,15002,15011,35,11,7,2,4,1,16,11,5,8,6,10
30877,15002,15011,27,8,7,3,2,2,7,7,0,8,6,11
30878,15002,15011,49,5,7,4,2,1,10,6,4,10,4,14
30879,15002,15011,37,16,7,0,2,5,5,21,-16,2,12,2
30880,15002,15011,17,13,7,2,3,2,8,9,-1,7,7,9
30881,15002,15011,1,2,7,5,0,2,16,8,8,10,4,15
30882,15002,15011,4,1,7,7,0,0,17,7,10,14,0,21
30883,15002,15011,21,15,7,1,2,4,9,12,-3,4,10,5
30884,15576,15582,4,8,28,14,2,12,45,44,1,30,26,44
30885,15576,15582,21,15,28,6,7,15,35,51,-16,19,37,25
30886,15576,15582,28,4,28,15,5,8,58,40,18,35,21,50
30887,15576,15582,33,12,28,8,5,15,39,62,-23,21,35,29
30888,15576,15582,1,1,29,24,2,3,89,29,60,50,8,74
30889,15576,15582,17,5,28,14,8,6,44,32,12,36,20,50
30890,15576,15582,42,9,29,13,3,13,45,40,5,29,29,42
30891,15576,15582,49,6,28,13,7,8,47,35,12,33,23,46
30892,15576,15582,37,11,28,10,1,17,43,66,-23,21,35,31
30893,15576,15582,27,16,29,6,6,17,36,63,-27,18,40,24
30894,15576,15582,35,13,28,7,6,15,43,50,-7,20,36,27
30895,15576,15582,12,3,28,18,4,6,66,44,22,40,16,58
30896,15576,15582,25,10,28,10,3,15,30,41,-11,23,33,33
30897,15576,15582,43,2,29,21,2,6,67,28,39,44,14,65
30898,15576,15582,22,7,28,13,6,9,62,47,15,32,24,45
30899,15576,15582,40,14,28,6,8,14,31,40,-9,20,36,26
30900,15576,15582,24,17,28,2,5,21,14,82,-68,9,47,11
30901,15807,15813,25,8,16,6,5,5,19,23,-4,17,15,23
30902,15807,15813,12,14,16,3,4,9,18,27,-9,10,22,13
30903,15807,15813,43,1,16,14,1,1,41,13,28,29,3,43
30904,15807,15813,22,3,16,8,4,4,31,20,11,20,12,28
30905,15807,15813,40,11,16,4,8,4,20,18,2,16,16,20
30906,15807,15813,57,12,16,4,7,5,13,21,-8,15,17,19
30907,15807,15813,33,5,16,7,6,3,29,19,10,20,12,27
30908,15807,15813,28,6,16,6,6,4,20,21,-1,18,14,24
30909,15807,15813,27,18,16,2,4,10,7,17,-10,8,24,10
30910,15807,15813,42,17,16,2,6,8,12,25,-13,10,22,12
30911,15807,15813,17,13,16,4,6,6,16,19,-3,14,18,18
30912,15807,15813,49,2,16,11,2,3,32,12,20,24,8,35
30913,15807,15813,37,10,16,7,0,9,21,27,-6,14,18,21
30914,15807,15813,35,7,16,6,5,5,15,16,-1,17,15,23
30915,15807,15813,31,15,16,3,4,9,13,24,-11,10,22,13
30916,15807,15813,21,16,16,3,3,10,12,32,-20,9,23,12
30917,15807,15813,1,4,16,8,3,5,31,21,10,19,13,27
30918,15807,15813,4,9,16,5,8,3,19,14,5,18,14,23
30919,15849,15855,4,8,19,6,8,5,21,18,3,20,18,26
30920,19370,19376,45,5,7,4,2,1,13,11,2,10,4,14
30921,19370,19376,12,3,7,5,1,1,16,9,7,11,3,16
30922,19370,19376,17,12,7,1,2,4,5,12,-7,4,10,5
30923,19370,19376,42,15,7,0,2,5,4,11,-7,2,12,2
30924,19370,19376,56,8,7,3,1,3,10,9,1,7,7,10
30925,20266,20272,12,12,28,7,9,12,32,38,-6,23,33,30
30926,20266,20272,25,16,28,6,9,13,33,57,-24,21,35,27
30927,20266,20272,28,13,28,8,5,15,27,43,-16,21,35,29
30928,20266,20272,38,15,28,6,9,13,37,47,-10,21,35,27
30929,20266,20272,1,1,28,19,1,8,60,30,30,39,17,58
30930,20266,20272,56,9,28,9,9,10,30,32,-2,27,29,36
30931,20266,20272,49,7,28,11,5,12,39,46,-7,27,29,38
30932,20266,20272,16,14,28,7,7,14,41,51,-10,21,35,28
30933,20266,20272,43,3,28,14,10,4,47,27,20,38,18,52
30934,20266,20272,22,5,28,13,6,9,37,27,10,32,24,45
30935,20266,20272,24,10,28,9,6,13,44,50,-6,24,32,33
30936,20266,20272,4,2,28,17,7,4,54,27,27,41,15,58
30937,20266,20272,9,4,28,13,7,8,52,39,13,33,23,46
30938,20266,20272,45,6,28,11,7,10,48,49,-1,29,27,40
30939,20266,20272,27,8,28,10,8,10,34,36,-2,28,28,38
30940,20266,20272,10,11,28,9,5,14,40,56,-16,23,33,32
30941,20280,20419,45,6,30,12,7,11,51,50,1,31,29,43
30942,20280,20419,27,8,30,10,9,11,36,39,-3,29,31,39
30943,20280,20419,10,12,30,9,6,15,40,57,-17,24,36,33
30944,20280,20419,4,2,30,17,9,4,56,29,27,43,17,60
30945,20280,20419,9,4,30,14,7,9,55,44,11,35,25,49
30946,20280,20419,43,3,30,15,10,5,51,29,22,40,20,55
30947,20280,20419,22,5,30,14,6,10,42,30,12,34,26,48
30948,20280,20419,24,10,30,10,7,13,48,50,-2,27,33,37
30949,20280,20419,49,7,30,12,5,13,41,51,-10,29,31,41
30950,20280,20419,16,16,30,7,8,15,42,53,-11,22,38,29
30951,20280,20419,1,1,30,21,1,8,64,30,34,43,17,64
30952,20280,20419,28,13,30,8,6,16,28,47,-19,22,38,30
30953,20280,20419,38,14,30,7,9,14,39,51,-12,23,37,30
30954,20280,20419,56,9,30,10,9,11,31,35,-4,29,31,39
30955,20280,20419,12,11,30,8,10,12,35,40,-5,26,34,34
30956,20280,20419,25,15,30,7,9,14,35,59,-24,23,37,30
30957,20098,20104,28,4,7,3,2,2,9,6,3,8,6,11
30958,20098,20104,38,16,7,1,2,4,8,13,-5,4,10,5
30959,20098,20104,12,10,7,2,2,3,7,8,-1,6,8,8
30960,20098,20104,25,15,7,1,3,3,8,12,-4,5,9,6
30961,20098,20104,56,9,7,2,3,2,5,5,0,7,7,9
30962,20098,20104,43,2,7,4,2,1,11,6,5,10,4,14
30963,20098,20104,22,5,7,3,2,2,8,6,2,8,6,11
30964,20098,20104,24,11,7,2,2,3,10,14,-4,6,8,8
30965,20098,20104,1,7,7,3,1,3,14,8,6,7,7,10
30966,20098,20104,16,12,7,2,1,4,7,10,-3,5,9,7
30967,20098,20104,49,13,7,2,1,4,7,14,-7,5,9,7
30968,20098,20104,45,3,7,3,2,2,10,6,4,8,6,11
30969,20098,20104,10,8,7,3,1,3,12,15,-3,7,7,10
30970,20098,20104,27,14,7,1,4,2,5,8,-3,6,8,7
30971,20098,20104,9,1,7,5,1,1,16,8,8,11,3,16
30972,20098,20104,4,6,7,2,5,0,7,5,2,9,5,11
30973,20553,20559,45,1,18,10,5,3,30,19,11,25,11,35
30974,20553,20559,27,7,18,8,7,3,23,19,4,23,13,31
30975,20553,20559,15,12,18,4,5,9,28,41,-13,13,23,17
30976,20553,20559,10,14,18,3,7,8,16,28,-12,13,23,16
30977,20553,20559,28,13,18,4,4,10,18,26,-8,12,24,16
30978,20553,20559,38,15,18,3,2,13,17,39,-22,8,28,11
30979,20553,20559,43,3,18,9,5,4,36,19,17,23,13,32
30980,20553,20559,24,8,18,8,4,6,25,23,2,20,16,28
30981,20553,20559,22,9,18,7,4,7,21,27,-6,18,18,25
30982,20553,20559,12,11,18,5,4,9,16,23,-7,14,22,19
30983,20553,20559,25,16,18,2,5,11,19,42,-23,9,27,11
30984,20553,20559,56,10,18,6,6,6,27,29,-2,18,18,24
30985,20553,20559,49,6,18,9,4,5,34,19,15,22,14,31
30986,20553,20559,9,4,18,9,5,4,35,21,14,23,13,32
30987,20553,20559,4,5,18,9,5,4,28,15,13,23,13,32
30988,20553,20559,1,2,18,10,4,4,29,12,17,24,12,34
30989,20630,20636,1,1,28,18,4,6,53,20,33,40,16,58
30990,20630,20636,49,9,28,10,11,7,45,35,10,31,25,41
30991,20630,20636,12,13,28,7,8,13,24,34,-10,22,34,29
30992,20630,20636,25,15,28,5,7,16,31,59,-28,17,39,22
30993,20630,20636,56,10,28,8,6,14,37,52,-15,22,34,30
30994,20630,20636,43,2,28,17,7,4,62,27,35,41,15,58
30995,20630,20636,24,6,28,13,6,9,38,31,7,32,24,45
30996,20630,20636,22,8,28,12,6,10,34,34,0,30,26,42
30997,20630,20636,28,14,28,7,5,16,31,45,-14,19,37,26
30998,20630,20636,38,16,28,5,3,20,26,53,-27,13,43,18
30999,20420,20426,43,3,1,1,0,0,2,1,1,2,0,3
31000,20420,20426,22,3,1,1,0,0,2,1,1,2,0,3
31001,20420,20426,24,15,1,0,0,1,0,2,-2,0,2,0
31002,20420,20426,56,9,1,0,1,0,1,1,0,1,1,1
31003,20420,20426,9,11,1,0,0,1,1,2,-1,0,2,0
31004,20420,20426,1,2,1,1,0,0,2,0,2,2,0,3
31005,20595,20597,43,2,22,13,5,4,48,22,26,31,13,44
31006,20595,20597,24,6,22,10,5,7,29,25,4,25,19,35
31007,20595,20597,22,9,22,9,5,8,26,30,-4,23,21,32
31008,20595,20597,1,1,22,14,4,4,43,15,28,32,12,46
31009,20595,20597,9,4,22,11,6,5,40,25,15,28,16,39
31010,20595,20597,4,5,22,10,5,7,32,23,9,25,19,35
31011,20595,20597,45,3,22,12,7,3,35,22,13,31,13,43
31012,20595,20597,27,8,22,9,7,6,25,23,2,25,19,34
31013,20595,20597,15,13,22,5,5,12,32,51,-19,15,29,20
31014,20595,20597,10,14,22,4,8,10,19,32,-13,16,28,20
31015,20595,20597,49,7,22,9,7,6,39,27,12,25,19,34
31016,20595,20597,28,12,22,5,5,12,25,35,-10,15,29,20
31017,20595,20597,38,16,22,4,3,15,20,44,-24,11,33,15
31018,20595,20597,12,10,22,6,6,10,21,27,-6,18,26,24
31019,20595,20597,25,15,22,4,6,12,26,47,-21,14,30,18
31020,20595,20597,56,11,22,6,6,10,31,43,-12,18,26,24
31021,20598,20601,56,11,23,6,6,11,31,46,-15,18,28,24
31022,20598,20601,12,10,23,6,7,10,21,27,-6,19,27,25
31023,20598,20601,25,15,23,4,6,13,28,51,-23,14,32,18
31024,20598,20601,28,12,23,6,5,12,27,36,-9,17,29,23
31025,20598,20601,38,16,23,4,3,16,20,45,-25,11,35,15
31026,20598,20601,49,9,23,9,8,6,41,29,12,26,20,35
31027,20598,20601,45,3,23,13,7,3,36,22,14,33,13,46
31028,20598,20601,27,5,23,10,7,6,27,24,3,27,19,37
31029,20598,20601,15,13,23,5,6,12,34,53,-19,16,30,21
31030,20598,20601,10,14,23,4,8,11,20,34,-14,16,30,20
31031,20598,20601,9,4,23,11,6,6,41,27,14,28,18,39
31032,20598,20601,4,6,23,10,6,7,32,23,9,26,20,36
31033,20598,20601,1,1,23,15,4,4,45,16,29,34,12,49
31034,20598,20601,43,2,23,14,5,4,52,24,28,33,13,47
31035,20598,20601,24,7,23,10,5,8,30,27,3,25,21,35
31036,20598,20601,22,8,23,10,5,8,29,30,-1,25,21,35
31037,21001,21007,1,1,29,19,7,3,67,33,34,45,13,64
31038,21001,21007,4,4,29,13,8,8,43,26,17,34,24,47
31039,21001,21007,21,7,29,10,11,8,37,38,-1,31,27,41
31040,21001,21007,9,10,29,10,6,13,40,38,2,26,32,36
31041,21001,21007,56,8,29,11,6,12,40,39,1,28,30,39
31042,21001,21007,43,2,29,15,7,7,47,41,6,37,21,52
31043,21001,21007,22,5,29,11,11,7,43,34,9,33,25,44
31044,21001,21007,24,15,29,5,9,15,29,49,-20,19,39,24
31045,21001,21007,49,6,29,10,11,8,40,39,1,31,27,41
31046,21001,21007,28,9,29,9,10,10,29,40,-11,28,30,37
31047,21001,21007,38,14,29,8,6,15,40,55,-15,22,36,30
31048,21001,21007,27,3,29,13,12,4,46,28,18,38,20,51
31049,21001,21007,10,11,29,9,8,12,50,49,1,26,32,35
31050,21001,21007,45,12,29,10,4,15,45,52,-7,24,34,34
31051,21001,21007,15,16,29,5,9,15,36,57,-21,19,39,24
31052,21001,21007,12,13,29,8,7,14,33,47,-14,23,35,31
31053,21218,21231,12,14,10,1,2,7,8,20,-12,4,16,5
31054,21218,21231,56,11,10,3,2,5,13,17,-4,8,12,11
31055,21218,21231,27,10,10,3,2,5,13,14,-1,8,12,11
31056,21218,21231,15,12,10,3,1,6,13,22,-9,7,13,10
31057,21218,21231,10,13,10,1,6,3,12,14,-2,8,12,9
31058,21218,21231,45,15,10,1,2,7,13,27,-14,4,16,5
31059,21218,21231,49,5,10,5,3,2,17,10,7,13,7,18
31060,21218,21231,28,6,10,4,5,1,14,9,5,13,7,17
31061,21218,21231,38,16,10,1,1,8,4,16,-12,3,17,4
31062,21218,21231,22,1,10,8,2,0,31,10,21,18,2,26
31063,21218,21231,43,3,10,6,2,2,19,10,9,14,6,20
31064,21218,21231,57,9,10,3,3,4,11,18,-7,9,11,12
31065,21218,21231,21,4,10,5,4,1,14,8,6,14,6,19
31066,21218,21231,4,7,10,4,2,4,19,21,-2,10,10,14
31067,21218,21231,9,8,10,4,2,4,14,17,-3,10,10,14
31068,21218,21231,1,2,10,8,1,1,28,10,18,17,3,25
31069,21155,21161,1,2,2,2,0,0,6,2,4,4,0,6
31070,21155,21161,21,6,2,1,1,0,1,0,1,3,1,4
31071,21155,21161,9,8,2,1,0,1,4,6,-2,2,2,3
31072,21155,21161,4,12,2,0,1,1,3,4,-1,1,3,1
31073,21155,21161,56,13,2,0,1,1,1,4,-3,1,3,1
31074,21155,21161,49,4,2,1,1,0,3,2,1,3,1,4
31075,21155,21161,43,1,2,2,0,0,9,3,6,4,0,6
31076,21155,21161,22,3,2,1,1,0,5,1,4,3,1,4
31077,21155,21161,57,4,2,1,1,0,3,2,1,3,1,4
31078,19531,19537,1,2,27,17,5,5,50,27,23,39,15,56
31079,19755,19768,17,15,10,2,3,5,12,20,-8,7,13,9
31080,19755,19768,4,2,10,5,3,2,14,8,6,13,7,18
31081,19755,19768,9,6,10,4,2,4,15,16,-1,10,10,14
31082,19755,19768,10,12,10,3,2,5,10,12,-2,8,12,11
31083,19755,19768,27,13,10,3,2,5,11,14,-3,8,12,11
31084,19755,19768,45,16,10,1,3,6,11,20,-9,5,15,6
31085,19755,19768,12,3,10,5,3,2,15,10,5,13,7,18
31086,19755,19768,25,5,10,4,5,1,21,16,5,13,7,17
31087,19755,19768,56,8,10,4,1,5,13,17,-4,9,11,13
31088,19755,19768,38,10,10,3,3,4,16,15,1,9,11,12
31089,19755,19768,49,11,10,3,3,4,18,21,-3,9,11,12
31090,19755,19768,43,1,10,6,4,0,18,9,9,16,4,22
31091,19755,19768,24,7,10,4,1,5,18,17,1,9,11,13
31092,19755,19768,22,9,10,2,7,1,11,11,0,11,9,13
31093,19755,19768,57,14,10,2,3,5,7,13,-6,7,13,9
31094,19755,19768,1,4,10,4,5,1,19,10,9,13,7,17
31095,19839,19859,4,5,21,9,7,5,32,21,11,25,17,34
31096,19839,19859,49,6,21,10,3,8,34,32,2,23,19,33
31097,19839,19859,9,8,21,8,5,8,28,29,-1,21,21,29
31098,19839,19859,17,16,21,3,5,13,20,47,-27,11,31,14
31099,19839,19859,43,2,21,11,7,3,39,24,15,29,13,40
31100,19839,19859,22,7,21,8,9,4,27,21,6,25,17,33
31101,19839,19859,24,11,21,6,7,8,24,29,-5,19,23,25
31102,19839,19859,57,15,21,5,5,11,14,30,-16,15,27,20
31103,19839,19859,38,12,21,6,5,10,30,33,-3,17,25,23
31104,19839,19859,56,3,21,11,1,9,35,31,4,23,19,34
31105,19839,19859,12,9,21,7,8,6,29,24,5,22,20,29
31106,19839,19859,25,13,21,5,8,8,32,45,-13,18,24,23
31107,19839,19859,27,4,21,10,4,7,37,27,10,24,18,34
31108,19839,19859,45,10,21,7,4,10,27,34,-7,18,24,25
31109,19839,19859,10,14,21,6,2,13,20,34,-14,14,28,20
31110,19839,19859,1,1,21,12,8,1,54,21,33,32,10,44
31111,20508,20510,1,4,12,7,1,4,19,10,9,15,9,22
31112,20508,20510,45,1,12,8,2,2,22,10,12,18,6,26
31113,20508,20510,27,3,12,6,5,1,14,9,5,17,7,23
31114,20508,20510,15,12,12,3,2,7,17,29,-12,8,16,11
31115,20508,20510,10,14,12,2,4,6,12,22,-10,8,16,10
31116,20508,20510,25,16,12,2,3,7,13,27,-14,7,17,9
31117,20508,20510,12,13,12,3,1,8,9,17,-8,7,17,10
31118,20508,20510,38,11,12,3,2,7,15,22,-7,8,16,11
31119,20508,20510,28,15,12,2,3,7,12,18,-6,7,17,9
31120,20508,20510,56,9,12,4,5,3,22,20,2,13,11,17
31121,20508,20510,49,7,12,5,4,3,20,10,10,14,10,19
31122,20508,20510,4,5,12,6,3,3,20,12,8,15,9,21
31123,20508,20510,9,6,12,6,3,3,19,16,3,15,9,21
31124,20508,20510,43,2,12,7,3,2,22,12,10,17,7,24
31125,20508,20510,22,8,12,5,2,5,15,17,-2,12,12,17
31126,20508,20510,24,10,12,4,3,5,15,15,0,11,13,15
31127,20609,20615,24,7,25,11,5,9,31,29,2,27,23,38
31128,20609,20615,22,8,25,11,5,9,30,31,-1,27,23,38
31129,20609,20615,9,4,25,12,6,7,43,30,13,30,20,42
31130,20609,20615,4,5,25,11,7,7,35,24,11,29,21,40
31131,20609,20615,43,2,25,14,7,4,52,24,28,35,15,49
31132,20609,20615,49,9,25,9,9,7,41,32,9,27,23,36
31133,20609,20615,45,3,25,13,8,4,38,25,13,34,16,47
31134,20609,20615,27,6,25,11,7,7,29,26,3,29,21,40
31135,20609,20615,28,11,25,7,5,13,30,37,-7,19,31,26
31136,20609,20615,38,16,25,5,3,17,23,46,-23,13,37,18
31137,20609,20615,56,10,25,8,6,11,36,47,-11,22,28,30
31138,20609,20615,12,12,25,6,8,11,22,29,-7,20,30,26
31139,20609,20615,25,14,25,5,7,13,29,51,-22,17,33,22
31140,20609,20615,10,13,25,5,9,11,22,34,-12,19,31,24
31141,20609,20615,15,15,25,5,6,14,34,58,-24,16,34,21
31142,20609,20615,1,1,25,16,4,5,46,18,28,36,14,52
31143,20644,20783,1,2,30,18,5,7,56,24,32,41,19,59
31144,20644,20783,45,3,30,15,9,6,49,38,11,39,21,54
31145,20644,20783,27,6,30,13,10,7,34,29,5,36,24,49
31146,20644,20783,15,13,30,8,6,16,40,64,-24,22,38,30
31147,20644,20783,10,14,30,7,9,14,28,43,-15,23,37,30
31148,20644,20783,12,11,30,7,10,13,24,34,-10,24,36,31
31149,20644,20783,25,16,30,5,8,17,33,65,-32,18,42,23
31150,20644,20783,56,10,30,8,7,15,38,55,-17,23,37,31
31151,20644,20783,28,12,30,8,6,16,35,48,-13,22,38,30
31152,20644,20783,38,15,30,7,3,20,29,53,-24,17,43,24
31153,20644,20783,49,9,30,10,12,8,47,38,9,32,28,42
31154,20644,20783,43,1,30,18,7,5,67,30,37,43,17,61
31155,20644,20783,24,7,30,14,6,10,41,36,5,34,26,48
31156,20644,20783,22,8,30,14,6,10,40,35,5,34,26,48
31157,14232,14238,47,14,3,0,2,1,4,5,-1,2,4,2
31158,14232,14238,6,9,3,1,1,1,5,6,-1,3,3,4
31159,14232,14238,35,11,3,1,0,2,4,6,-2,2,4,3
31160,14232,14238,25,3,3,2,1,0,10,8,2,5,1,7
31161,14232,14238,58,15,3,0,2,1,3,7,-4,2,4,2
31162,14232,14238,12,17,3,0,1,2,3,7,-4,1,5,1
31163,14232,14238,27,10,3,1,0,2,4,5,-1,2,4,3
31164,14232,14238,33,8,3,1,1,1,5,4,1,3,3,4
31165,14232,14238,28,16,3,0,2,1,2,6,-4,2,4,2
31166,14232,14238,43,2,3,3,0,0,11,4,7,6,0,9
31167,14232,14238,22,6,3,1,2,0,9,7,2,4,2,5
31168,14232,14238,34,7,3,1,1,1,7,6,1,3,3,4
31169,14232,14238,24,12,3,1,0,2,3,5,-2,2,4,3
31170,14232,14238,4,4,3,2,0,1,7,3,4,4,2,6
31171,14232,14238,49,12,3,1,0,2,3,5,-2,2,4,3
31172,14232,14238,37,18,3,0,1,2,4,9,-5,1,5,1
31173,14253,14259,37,14,5,1,1,3,9,12,-3,3,7,4
31174,14253,14259,49,15,5,1,1,3,3,9,-6,3,7,4
31175,14253,14259,43,1,5,4,1,0,16,7,9,9,1,13
31176,14253,14259,22,6,5,2,2,1,14,9,5,6,4,8
31177,14253,14259,34,7,5,2,1,2,12,9,3,5,5,7
31178,14253,14259,24,11,5,2,0,3,7,11,-4,4,6,6
31179,14253,14259,33,8,5,2,1,2,10,10,0,5,5,7
31180,14253,14259,28,18,5,0,2,3,4,14,-10,2,8,2
31181,14253,14259,1,2,5,4,0,1,13,4,9,8,2,12
31182,14253,14259,4,5,5,3,0,2,13,10,3,6,4,9
31183,14253,14259,27,10,5,2,0,3,8,9,-1,4,6,6
31184,14253,14259,25,4,5,3,1,1,13,12,1,7,3,10
31185,14253,14259,58,16,5,0,4,1,3,7,-4,4,6,4
31186,14253,14259,12,17,5,0,3,2,4,8,-4,3,7,3
31187,14253,14259,35,9,5,2,1,2,8,8,0,5,5,7
31188,14253,14259,6,13,5,1,2,2,8,11,-3,4,6,5
31189,14253,14259,47,12,5,1,2,2,6,8,-2,4,6,5
31190,14253,14259,17,3,5,4,0,1,14,7,7,8,2,12
31191,14694,14700,47,17,14,2,1,11,19,45,-26,5,23,7
31192,14694,14700,35,9,14,6,0,8,21,23,-2,12,16,18
31193,14694,14700,17,8,14,7,2,5,25,21,4,16,12,23
31194,14694,14700,27,5,14,8,0,6,25,29,-4,16,12,24
31195,14694,14700,25,7,14,7,3,4,23,22,1,17,11,24
31196,14694,14700,12,10,14,4,6,4,15,21,-6,14,14,18
31197,14694,14700,37,11,14,4,4,6,13,28,-15,12,16,16
31198,14694,14700,4,6,14,7,3,4,30,23,7,17,11,24
31199,14694,14700,21,13,14,4,1,9,13,23,-10,9,19,13
31200,14694,14700,1,1,14,14,0,0,53,8,45,28,0,42
31201,14694,14700,33,4,14,8,1,5,32,17,15,17,11,25
31202,14694,14700,28,14,14,3,3,8,16,26,-10,9,19,12
31203,14694,14700,43,2,14,11,3,0,42,14,28,25,3,36
31204,14694,14700,22,12,14,3,6,5,16,16,0,12,16,15
31205,14694,14700,34,15,14,3,3,8,17,34,-17,9,19,12
31206,14694,14700,24,16,14,2,3,9,19,32,-13,7,21,9
31207,14694,14700,40,18,14,1,4,9,11,29,-18,6,22,7
31208,14694,14700,49,3,14,9,3,2,37,16,21,21,7,30
31209,14722,14749,43,2,18,15,3,0,52,16,36,33,3,48
31210,14722,14749,22,13,18,5,6,7,21,23,-2,16,20,21
31211,14722,14749,34,15,18,3,4,11,17,43,-26,10,26,13
31212,14722,14749,24,16,18,2,4,12,22,41,-19,8,28,10
31213,14722,14749,40,17,18,1,6,11,13,34,-21,8,28,9
31214,14722,14749,4,5,18,9,4,5,36,28,8,22,14,31
31215,14722,14749,21,12,18,7,1,10,23,27,-4,15,21,22
31216,14722,14749,33,7,18,9,3,6,38,25,13,21,15,30
31217,14722,14749,28,14,18,3,4,11,19,34,-15,10,26,13
31218,14722,14749,27,4,18,10,2,6,35,32,3,22,14,32
31219,14722,14749,49,3,18,10,4,4,45,23,22,24,12,34
31220,14722,14749,37,11,18,6,5,7,17,35,-18,17,19,23
31221,14722,14749,35,10,18,8,1,9,32,29,3,17,19,25
31222,14722,14749,25,6,18,9,4,5,33,27,6,22,14,31
31223,14722,14749,12,9,18,7,6,5,27,26,1,20,16,27
31224,14722,14749,47,18,18,2,1,15,21,60,-39,5,31,7
31225,14722,14749,17,8,18,8,4,6,29,24,5,20,16,28
31226,14722,14749,1,1,18,17,0,1,57,10,47,34,2,51
31227,14778,14791,17,9,23,10,5,8,35,29,6,25,21,35
31228,14778,14791,47,15,23,5,1,17,28,66,-38,11,35,16
31229,14778,14791,35,7,23,11,3,9,42,34,8,25,21,36
31230,14778,14791,27,8,23,11,3,9,38,41,-3,25,21,36
31231,14778,14791,25,5,23,12,5,6,44,33,11,29,17,41
31232,14778,14791,12,10,23,9,7,7,34,32,2,25,21,34
31233,14778,14791,33,6,23,11,4,8,45,31,14,26,20,37
31234,14778,14791,28,16,23,4,4,15,22,41,-19,12,34,16
31235,14778,14791,1,2,23,17,5,1,65,18,47,39,7,56
31236,14778,14791,4,4,23,12,6,5,45,33,12,30,16,42
31237,20630,20636,9,4,28,14,6,8,50,35,15,34,22,48
31238,20630,20636,4,7,28,12,8,8,39,27,12,32,24,44
31239,20630,20636,15,11,28,8,6,14,38,59,-21,22,34,30
31240,20630,20636,10,12,28,7,9,12,26,37,-11,23,33,30
31241,20630,20636,45,3,28,14,8,6,44,35,9,36,20,50
31242,20630,20636,27,5,28,13,8,7,33,28,5,34,22,47
31243,20469,20475,45,1,7,5,1,1,14,4,10,11,3,16
31244,20469,20475,27,7,7,3,3,1,8,6,2,9,5,12
31245,20469,20475,15,12,7,2,1,4,10,15,-5,5,9,7
31246,20469,20475,10,15,7,1,2,4,7,13,-6,4,10,5
31247,20469,20475,9,3,7,4,1,2,9,7,2,9,5,13
31248,20469,20475,4,4,7,3,3,1,12,7,5,9,5,12
31249,20469,20475,43,2,7,4,3,0,16,8,8,11,3,15
31250,20469,20475,24,6,7,3,3,1,8,5,3,9,5,12
31251,20469,20475,22,10,7,3,1,3,8,8,0,7,7,10
31252,20469,20475,28,11,7,2,1,4,7,9,-2,5,9,7
31253,20469,20475,38,13,7,2,0,5,9,14,-5,4,10,6
31254,20469,20475,56,8,7,3,2,2,11,11,0,8,6,11
31255,20469,20475,12,14,7,2,0,5,5,10,-5,4,10,6
31256,20469,20475,25,16,7,0,1,6,8,20,-12,1,13,1
31257,20469,20475,49,5,7,3,3,1,9,5,4,9,5,12
31258,20469,20475,1,9,7,3,1,3,9,8,1,7,7,10
31259,20924,20930,1,1,19,15,2,2,46,17,29,32,6,47
31260,20924,20930,56,12,19,5,5,9,23,31,-8,15,23,20
31261,20924,20930,28,6,19,7,7,5,23,25,-2,21,17,28
31262,20924,20930,38,10,19,6,5,8,25,31,-6,17,21,23
31263,20924,20930,12,15,19,4,6,9,20,30,-10,14,24,18
31264,20924,20930,43,3,19,10,4,5,29,26,3,24,14,34
31265,20924,20930,22,9,19,5,9,5,25,24,1,19,19,24
31266,20924,20930,24,14,19,4,6,9,21,30,-9,14,24,18
31267,20924,20930,49,8,19,6,7,6,19,22,-3,19,19,25
31268,20924,20930,21,4,19,8,7,4,26,22,4,23,15,31
31269,20924,20930,4,5,19,8,5,6,26,17,9,21,17,29
31270,20924,20930,9,13,19,5,4,10,22,25,-3,14,24,19
31271,20924,20930,27,2,19,11,6,2,33,19,14,28,10,39
31272,20924,20930,10,7,19,7,4,8,36,33,3,18,20,25
31273,20924,20930,45,11,19,6,2,11,30,34,-4,14,24,20
31274,20924,20930,15,16,19,2,7,10,26,44,-18,11,27,13
31275,21274,21280,27,6,17,8,2,7,28,24,4,18,16,26
31276,21274,21280,15,11,17,6,1,10,20,34,-14,13,21,19
31277,21274,21280,45,13,17,4,4,9,27,37,-10,12,22,16
31278,21274,21280,10,16,17,1,8,8,17,25,-8,10,24,11
31279,21274,21280,22,1,17,11,5,1,41,17,24,27,7,38
31280,21274,21280,43,4,17,9,3,5,31,21,10,21,13,30
31281,21274,21280,57,10,17,6,4,7,21,30,-9,16,18,22
31282,21274,21280,28,5,17,8,6,3,30,20,10,22,12,30
31283,21274,21280,38,14,17,3,4,10,12,23,-11,10,24,13
31284,21274,21280,12,15,17,2,5,10,16,31,-15,9,25,11
31285,21274,21280,56,9,17,6,4,7,23,27,-4,16,18,22
31286,21274,21280,49,7,17,7,5,5,24,19,5,19,15,26
31287,21274,21280,21,3,17,9,5,3,24,16,8,23,11,32
31288,21274,21280,4,8,17,7,4,6,31,30,1,18,16,25
31289,21274,21280,9,12,17,5,4,8,18,31,-13,14,20,19
31290,21274,21280,1,2,17,10,4,3,41,19,22,24,10,34
31291,21302,21322,1,2,21,12,5,4,48,22,26,29,13,41
31292,21302,21322,21,3,21,11,5,5,30,24,6,27,15,38
31293,21302,21322,4,7,21,9,4,8,38,36,2,22,20,31
31294,21302,21322,9,12,21,6,5,10,21,37,-16,17,25,23
31295,21302,21322,22,1,21,14,6,1,49,19,30,34,8,48
31296,21302,21322,43,5,21,10,4,7,37,27,10,24,18,34
31297,21302,21322,57,11,21,7,4,10,24,39,-15,18,24,25
31298,21302,21322,49,4,21,10,6,5,33,22,11,26,16,36
31299,21302,21322,56,9,21,7,7,7,28,30,-2,21,21,28
31300,21302,21322,12,16,21,3,5,13,19,35,-16,11,31,14
31301,21302,21322,27,8,21,9,3,9,32,29,3,21,21,30
31302,21302,21322,15,10,21,8,1,12,22,38,-16,17,25,25
31303,21302,21322,45,13,21,5,5,11,33,46,-13,15,27,20
31304,21302,21322,10,14,21,4,8,9,23,30,-7,16,26,20
31305,21302,21322,28,6,21,8,9,4,32,24,8,25,17,33
31306,21302,21322,38,15,21,4,5,12,16,27,-11,13,29,17
31307,21323,21329,38,14,22,5,5,12,18,28,-10,15,29,20
31308,21323,21329,57,11,22,7,5,10,25,40,-15,19,25,26
31309,21323,21329,10,13,22,4,9,9,24,31,-7,17,27,21
31310,21323,21329,45,15,22,5,5,12,34,48,-14,15,29,20
31311,21323,21329,9,12,22,6,5,11,22,39,-17,17,27,23
31312,21323,21329,27,7,22,10,3,9,33,29,4,23,21,33
31313,21323,21329,15,9,22,9,1,12,26,39,-13,19,25,28
31314,21323,21329,28,8,22,8,9,5,34,27,7,25,19,33
31315,21323,21329,12,16,22,3,5,14,20,39,-19,11,33,14
31316,15849,15855,31,15,19,4,4,11,18,33,-15,12,26,16
31317,15849,15855,21,18,19,3,3,13,13,39,-26,9,29,12
31318,15849,15855,25,7,19,7,7,5,22,25,-3,21,17,28
31319,15849,15855,12,14,19,4,5,10,21,32,-11,13,25,17
31320,15849,15855,1,5,19,9,4,6,37,23,14,22,16,31
31321,15849,15855,49,2,19,12,4,3,38,17,21,28,10,40
31322,15849,15855,37,9,19,8,1,10,26,30,-4,17,21,25
31323,15849,15855,17,12,19,4,9,6,19,22,-3,17,21,21
31324,15849,15855,42,16,19,3,7,9,19,30,-11,13,25,16
31325,15849,15855,27,17,19,3,6,10,14,23,-9,12,26,15
31326,15849,15855,33,4,19,9,7,3,38,24,14,25,13,34
31327,15849,15855,28,6,19,7,7,5,23,24,-1,21,17,28
31328,15849,15855,43,1,19,17,1,1,49,14,35,35,3,52
31329,15849,15855,22,3,19,10,4,5,39,25,14,24,14,34
31330,15849,15855,40,11,19,5,9,5,25,24,1,19,19,24
31331,15849,15855,57,13,19,4,8,7,15,29,-14,16,22,20
31332,15849,15855,35,10,19,6,6,7,17,22,-5,18,20,24
31333,15688,15694,35,6,2,1,1,0,1,0,1,3,1,4
31334,15688,15694,25,13,2,0,1,1,1,2,-1,1,3,1
31335,15688,15694,12,14,2,0,1,1,0,1,-1,1,3,1
31336,15688,15694,28,3,2,1,1,0,4,1,3,3,1,4
31337,15688,15694,33,11,2,0,2,0,5,5,0,2,2,2
31338,15688,15694,27,17,2,0,0,2,0,3,-3,0,4,0
31339,15688,15694,17,6,2,1,1,0,1,0,1,3,1,4
31340,15688,15694,42,12,2,0,1,1,3,4,-1,1,3,1
31341,15688,15694,49,5,2,1,1,0,3,2,1,3,1,4
31342,15688,15694,37,18,2,0,0,2,3,8,-5,0,4,0
31343,15688,15694,43,1,2,2,0,0,6,2,4,4,0,6
31344,15688,15694,40,4,2,1,1,0,2,0,2,3,1,4
31345,15688,15694,22,8,2,1,0,1,2,1,1,2,2,3
31346,15688,15694,57,15,2,0,1,1,0,2,-2,1,3,1
31347,15688,15694,1,2,2,2,0,0,3,0,3,4,0,6
31348,15688,15694,4,9,2,1,0,1,5,5,0,2,2,3
31349,15688,15694,21,10,2,1,0,1,3,4,-1,2,2,3
31350,15688,15694,31,15,2,0,1,1,0,2,-2,1,3,1
31351,15695,15701,4,8,3,1,1,1,7,7,0,3,3,4
31352,15695,15701,21,10,3,1,1,1,3,4,-1,3,3,4
31353,15695,15701,31,14,3,0,2,1,0,2,-2,2,4,2
31354,15695,15701,1,3,3,2,1,0,6,3,3,5,1,7
31355,15695,15701,43,1,3,3,0,0,9,2,7,6,0,9
31356,15695,15701,40,4,3,1,2,0,5,3,2,4,2,5
31357,15695,15701,22,7,3,1,1,1,4,3,1,3,3,4
31358,15695,15701,57,14,3,0,2,1,0,2,-2,2,4,2
31359,15695,15701,49,2,3,2,1,0,7,2,5,5,1,7
31360,15695,15701,37,11,3,1,0,2,5,9,-4,2,4,3
31361,15695,15701,17,6,3,1,2,0,2,1,1,4,2,5
31362,15695,15701,42,18,3,0,1,2,3,8,-5,1,5,1
31363,15695,15701,27,17,3,0,1,2,0,3,-3,1,5,1
31364,15695,15701,28,9,3,1,1,1,4,4,0,3,3,4
31365,15695,15701,33,12,3,0,3,0,6,6,0,3,3,3
31366,15695,15701,25,13,3,0,2,1,3,4,-1,2,4,2
31367,15695,15701,12,16,3,0,1,2,1,3,-2,1,5,1
31368,15695,15701,35,5,3,1,2,0,3,2,1,4,2,5
31369,15947,15953,43,1,32,24,5,3,74,26,48,53,11,77
31370,15947,15953,33,4,32,14,13,5,60,39,21,41,23,55
31371,15947,15953,27,16,32,7,8,17,33,46,-13,22,42,29
31372,15947,15953,22,5,32,15,8,9,54,38,16,38,26,53
31373,15947,15953,40,8,32,9,13,10,41,43,-2,31,33,40
31374,15947,15953,57,14,32,7,13,12,27,49,-22,27,37,34
31375,15947,15953,1,2,32,20,6,6,65,31,34,46,18,66
31376,15947,15953,35,7,32,11,11,10,31,35,-4,33,31,44
31377,15947,15953,17,11,32,7,15,10,29,37,-8,29,35,36
31378,15947,15953,42,15,32,7,12,13,29,42,-13,26,38,33
31379,15947,15953,25,6,32,14,9,9,50,43,7,37,27,51
31380,15947,15953,12,9,32,10,7,15,43,52,-9,27,37,37
31381,15947,15953,49,3,32,17,10,5,65,29,36,44,20,61
31382,15947,15953,37,12,32,10,5,17,38,53,-15,25,39,35
31383,15947,15953,28,13,32,8,11,13,34,47,-13,27,37,35
31384,15947,15953,4,10,32,7,15,10,30,33,-3,29,35,36
31385,15947,15953,31,17,32,7,7,18,34,61,-27,21,43,28
31386,15947,15953,21,18,32,7,6,19,27,60,-33,20,44,27
31387,15737,15750,4,6,8,3,4,1,13,9,4,10,6,13
31388,15737,15750,21,14,8,2,1,5,4,18,-14,5,11,7
31389,15737,15750,31,17,8,0,2,6,2,13,-11,2,14,2
31390,15737,15750,35,11,8,2,4,2,7,5,2,8,8,10
31391,15737,15750,25,9,8,3,3,2,12,12,0,9,7,12
31392,15737,15750,12,18,8,0,2,6,5,18,-13,2,14,2
31393,15737,15750,1,3,8,4,3,1,17,8,9,11,5,15
31394,15737,15750,49,4,8,4,1,3,12,8,4,9,7,13
31395,15737,15750,37,13,8,3,0,5,10,16,-6,6,10,9
31396,15737,15750,27,16,8,0,4,4,2,7,-5,4,12,4
31397,21155,21161,28,11,2,0,2,0,1,1,0,2,2,2
31398,21155,21161,38,14,2,0,0,2,1,3,-2,0,4,0
31399,21155,21161,27,7,2,1,0,1,4,2,2,2,2,3
31400,21155,21161,45,9,2,0,2,0,3,3,0,2,2,2
31401,21155,21161,10,10,2,0,2,0,2,2,0,2,2,2
31402,21155,21161,15,16,2,0,0,2,3,9,-6,0,4,0
31403,21155,21161,12,15,2,0,0,2,2,7,-5,0,4,0
31404,21358,21364,27,8,27,11,5,11,39,39,0,27,27,38
31405,21358,21364,45,11,27,8,7,12,44,53,-9,23,31,31
31406,21358,21364,15,12,27,9,2,16,31,50,-19,20,34,29
31407,21358,21364,10,15,27,5,10,12,32,44,-12,20,34,25
31408,21358,21364,56,9,27,10,7,10,40,39,1,27,27,37
31409,21358,21364,28,5,27,12,10,5,46,32,14,34,20,46
31410,21358,21364,38,10,27,10,5,12,29,30,-1,25,29,35
31411,21358,21364,12,16,27,4,5,18,24,49,-25,13,41,17
31412,21358,21364,49,3,27,13,7,7,42,30,12,33,21,46
31413,21358,21364,21,4,27,13,7,7,36,29,7,33,21,46
31414,21358,21364,4,7,27,12,5,10,46,43,3,29,25,41
31415,21358,21364,9,14,27,6,8,13,27,47,-20,20,34,26
31416,21358,21364,1,2,27,14,8,5,58,30,28,36,18,50
31417,21358,21364,22,1,27,17,7,3,58,27,31,41,13,58
31418,21358,21364,43,6,27,12,6,9,43,33,10,30,24,42
31419,21358,21364,57,13,27,7,7,13,32,52,-20,21,33,28
31420,21596,21602,24,5,11,6,2,3,19,17,2,14,8,20
31421,21596,21602,22,6,11,5,2,4,18,15,3,12,10,17
31422,21596,21602,43,11,11,3,3,5,12,13,-1,9,13,12
31423,21596,21602,1,1,11,8,3,0,26,3,23,19,3,27
31424,21596,21602,4,3,11,6,2,3,24,15,9,14,8,20
31425,21596,21602,21,4,11,6,2,3,23,16,7,14,8,20
31426,21596,21602,9,13,11,3,2,6,15,23,-8,8,14,11
31427,21596,21602,56,10,11,4,2,5,20,17,3,10,12,14
31428,21596,21602,49,2,11,7,2,2,24,9,15,16,6,23
31429,21596,21602,38,9,11,4,4,3,14,13,1,12,10,16
31430,21596,21602,28,12,11,3,3,5,12,22,-10,9,13,12
31431,21596,21602,45,7,11,4,4,3,18,14,4,12,10,16
31432,21596,21602,27,8,11,4,4,3,16,13,3,12,10,16
31433,21596,21602,15,14,11,2,3,6,9,24,-15,7,15,9
31434,21596,21602,10,15,11,1,4,6,8,22,-14,6,16,7
31435,21596,21602,57,16,11,1,0,10,8,30,-22,2,20,3
31436,21617,21630,24,5,15,8,3,4,27,23,4,19,11,27
31437,21617,21630,22,8,15,6,3,6,21,21,0,15,15,21
31438,21617,21630,43,10,15,5,5,5,19,18,1,15,15,20
31439,21617,21630,57,16,15,2,1,12,13,36,-23,5,25,7
31440,21617,21630,49,3,15,8,3,4,29,15,14,19,11,27
31441,21617,21630,4,2,15,8,4,3,32,19,13,20,10,28
31442,21617,21630,21,4,15,8,3,4,31,23,8,19,11,27
31443,21617,21630,27,6,15,7,5,3,21,15,6,19,11,26
31444,21617,21630,45,7,15,6,4,5,23,19,4,16,14,22
31445,21617,21630,15,12,15,4,4,7,13,26,-13,12,18,16
31446,21617,21630,10,15,15,2,4,9,13,30,-17,8,22,10
31447,21617,21630,56,13,15,4,2,9,23,28,-5,10,20,14
31448,21617,21630,38,9,15,5,6,4,21,19,2,16,14,21
31449,21617,21630,28,11,15,5,4,6,16,25,-9,14,16,19
31450,21617,21630,9,14,15,3,3,9,17,29,-12,9,21,12
31451,21617,21630,1,1,15,10,4,1,33,6,27,24,6,34
31452,21631,21637,1,1,16,11,4,1,35,6,29,26,6,37
31453,21631,21637,57,16,16,2,2,12,14,37,-23,6,26,8
31454,21631,21637,4,3,16,8,5,3,33,20,13,21,11,29
31455,21631,21637,21,5,16,8,4,4,32,24,8,20,12,28
31456,21631,21637,9,14,16,3,3,10,17,31,-14,9,23,12
31457,21631,21637,38,9,16,5,7,4,23,21,2,17,15,22
31458,21631,21637,28,11,16,5,4,7,17,28,-11,14,18,19
31459,21631,21637,56,13,16,4,3,9,23,28,-5,11,21,15
31460,21631,21637,27,4,16,8,5,3,24,16,8,21,11,29
31461,21631,21637,45,7,16,7,4,5,25,19,6,18,14,25
31462,21631,21637,15,12,16,4,4,8,14,28,-14,12,20,16
31463,21631,21637,10,15,16,2,5,9,14,31,-17,9,23,11
31464,21631,21637,49,2,16,9,3,4,31,16,15,21,11,30
31465,21631,21637,24,6,16,8,3,5,27,25,2,19,13,27
31466,21631,21637,22,8,16,6,4,6,23,23,0,16,16,22
31467,21631,21637,43,10,16,5,6,5,19,18,1,16,16,21
31468,21540,21546,21,2,5,4,0,1,14,6,8,8,2,12
31469,21540,21546,22,6,5,3,0,2,8,6,2,6,4,9
31470,21540,21546,57,13,5,1,0,4,4,11,-7,2,8,3
31471,21540,21546,43,14,5,0,2,3,3,7,-4,2,8,2
31472,21540,21546,56,9,5,2,1,2,10,8,2,5,5,7
31473,21540,21546,45,10,5,2,1,2,5,7,-2,5,5,7
31474,21540,21546,27,11,5,1,3,1,5,6,-1,5,5,6
31475,21540,21546,15,15,5,0,2,3,3,13,-10,2,8,2
31476,14778,14791,21,13,23,7,3,13,25,34,-9,17,29,24
31477,14778,14791,43,1,23,19,4,0,68,19,49,42,4,61
31478,14778,14791,22,12,23,7,6,10,28,34,-6,20,26,27
31479,14778,14791,34,14,23,5,5,13,23,49,-26,15,31,20
31480,14778,14791,24,17,23,2,6,15,27,53,-26,10,36,12
31481,14778,14791,40,18,23,1,8,14,15,44,-29,10,36,11
31482,14778,14791,49,3,23,12,7,4,54,26,28,31,15,43
31483,14778,14791,37,11,23,8,6,9,22,43,-21,22,24,30
31484,14834,14840,22,11,29,10,7,12,38,39,-1,27,31,37
31485,14834,14840,34,14,29,6,7,16,27,57,-30,19,39,25
31486,14834,14840,40,17,29,4,11,14,25,48,-23,19,39,23
31487,14834,14840,43,1,29,20,8,1,73,24,49,48,10,68
31488,14834,14840,4,4,29,14,7,8,51,41,10,35,23,49
31489,14834,14840,21,12,29,10,5,14,33,40,-7,25,33,35
31490,14834,14840,1,2,29,19,9,1,73,23,50,47,11,66
31491,14834,14840,33,7,29,13,6,10,55,43,12,32,26,45
31492,14834,14840,28,16,29,6,6,17,28,47,-19,18,40,24
31493,14834,14840,12,6,29,13,8,8,44,35,9,34,24,47
31494,14834,14840,25,8,29,12,8,9,50,44,6,32,26,44
31495,14834,14840,24,18,29,4,8,17,35,61,-26,16,42,20
31496,14834,14840,27,10,29,12,5,12,45,51,-6,29,29,41
31497,14834,14840,49,3,29,14,10,5,64,34,30,38,20,52
31498,14834,14840,37,13,29,8,7,14,24,54,-30,23,35,31
31499,14834,14840,35,5,29,15,3,11,52,40,12,33,25,48
31500,14834,14840,47,15,29,7,3,19,32,71,-39,17,41,24
31501,14834,14840,17,9,29,12,6,11,40,37,3,30,28,42
31502,15065,15071,35,7,14,5,5,4,30,23,7,15,13,20
31503,15065,15071,6,13,14,3,6,5,22,30,-8,12,16,15
31504,15065,15071,1,1,14,10,1,3,33,15,18,21,7,31
31505,15065,15071,12,6,14,8,2,4,21,13,8,18,10,26
31506,15065,15071,25,11,14,4,3,7,22,24,-2,11,17,15
31507,15065,15071,27,10,14,5,3,6,13,21,-8,13,15,18
31508,15065,15071,17,15,14,3,4,7,16,21,-5,10,18,13
31509,15065,15071,28,8,14,5,4,5,23,22,1,14,14,19
31510,15065,15071,33,9,14,6,0,8,27,20,7,12,16,18
31511,15065,15071,52,14,14,4,2,8,17,26,-9,10,18,14
31512,15065,15071,4,2,14,9,3,2,26,16,10,21,7,30
31513,15065,15071,21,16,14,3,3,8,19,25,-6,9,19,12
31514,15065,15071,49,5,14,8,4,2,23,15,8,20,8,28
31515,15065,15071,37,18,14,1,5,8,11,33,-22,7,21,8
31516,15065,15071,22,3,14,8,5,1,40,19,21,21,7,29
31517,15065,15071,43,4,14,8,4,2,30,16,14,20,8,28
31518,15065,15071,34,12,14,4,3,7,14,31,-17,11,17,15
31519,15065,15071,40,17,14,2,3,9,15,32,-17,7,21,9
31520,15485,15491,49,7,18,8,5,5,33,24,9,21,15,29
31521,15485,15491,37,14,18,5,1,12,22,48,-26,11,25,16
31522,15485,15491,4,9,18,8,2,8,29,28,1,18,18,26
31523,15485,15491,21,12,18,5,4,9,26,36,-10,14,22,19
31524,15485,15491,1,1,18,16,1,1,55,16,39,33,3,49
31525,15485,15491,28,4,17,10,4,3,46,25,21,24,10,34
31526,15485,15491,33,10,18,6,5,7,29,34,-5,17,19,23
31527,15485,15491,43,3,18,11,2,5,41,23,18,24,12,35
31528,15485,15491,22,6,18,8,5,5,38,29,9,21,15,29
31529,15485,15491,40,13,18,4,5,9,19,24,-5,13,23,17
31530,15485,15491,24,17,18,1,4,13,10,47,-37,6,30,7
31531,15485,15491,12,2,18,11,4,3,38,25,13,26,10,37
31532,15485,15491,27,16,18,2,5,11,19,44,-25,9,27,11
31533,15485,15491,35,15,18,4,3,11,29,38,-9,11,25,15
31534,15485,15491,25,11,18,7,1,10,16,27,-11,15,21,22
31535,15485,15491,17,5,17,9,5,3,29,16,13,23,11,32
31536,15485,15491,42,8,18,8,2,8,30,25,5,18,18,26
31537,15597,15603,17,5,31,15,8,8,49,40,9,38,24,53
31538,15597,15603,35,13,31,8,7,16,48,55,-7,23,39,31
31539,15597,15603,1,1,32,25,4,3,96,33,63,54,10,79
31540,15597,15603,27,16,31,6,8,17,38,65,-27,20,42,26
31541,15597,15603,25,10,31,12,3,16,38,45,-7,27,35,39
31542,15597,15603,12,3,31,18,5,8,69,51,18,41,21,59
31543,15597,15603,42,9,31,13,4,14,45,44,1,30,32,43
31544,15597,15603,28,4,31,16,7,8,63,44,19,39,23,55
31545,15597,15603,33,12,31,9,5,17,40,69,-29,23,39,32
31546,15597,15603,4,8,31,15,2,14,48,52,-4,32,30,47
31547,15597,15603,21,14,31,8,7,16,41,54,-13,23,39,31
31548,15597,15603,49,7,31,14,8,9,52,36,16,36,26,50
31549,15597,15603,37,11,31,11,2,18,47,69,-22,24,38,35
31550,15597,15603,40,15,31,6,9,16,33,44,-11,21,41,27
31551,15597,15603,24,17,31,3,6,22,15,84,-69,12,50,15
31552,15597,15603,43,2,31,23,2,6,72,28,44,48,14,71
31553,15597,15603,22,6,31,15,7,9,70,51,19,37,25,52
31554,15933,15939,42,14,30,7,11,12,29,40,-11,25,35,32
31555,15933,15939,1,2,30,19,5,6,63,30,33,43,17,62
31556,15933,15939,33,4,30,14,12,4,59,37,22,40,20,54
31557,15933,15939,28,9,30,8,11,11,32,43,-11,27,33,35
31558,15933,15939,4,13,30,7,13,10,27,30,-3,27,33,34
31559,15933,15939,21,16,30,7,5,18,26,56,-30,19,41,26
31560,15933,15939,31,18,30,6,7,17,31,57,-26,19,41,25
31561,15933,15939,49,3,30,16,10,4,61,27,34,42,18,58
31562,15933,15939,37,11,30,10,4,16,37,51,-14,24,36,34
31563,15933,15939,25,6,30,13,8,9,48,42,6,34,26,47
31564,15933,15939,12,12,30,9,7,14,39,50,-11,25,35,34
31565,15933,15939,43,1,30,23,4,3,71,24,47,50,10,73
31566,15933,15939,22,5,30,14,8,8,52,36,16,36,24,50
31567,15933,15939,40,8,30,8,12,10,37,40,-3,28,32,36
31568,15933,15939,57,15,30,6,12,12,24,47,-23,24,36,30
31569,15933,15939,27,17,30,6,8,16,31,43,-12,20,40,26
31570,16157,16163,49,7,14,7,2,5,19,19,0,16,12,23
31571,16157,16163,37,13,14,4,4,6,18,18,0,12,16,16
31572,16157,16163,46,16,14,2,2,10,11,30,-19,6,22,8
31573,16157,16163,43,2,14,10,1,3,32,15,17,21,7,31
31574,16157,16163,40,4,14,8,2,4,24,12,12,18,10,26
31575,16157,16163,22,6,14,6,6,2,18,14,4,18,10,24
31576,16157,16163,57,9,14,6,2,6,24,33,-9,14,14,20
31577,16157,16163,12,10,14,5,4,5,16,18,-2,14,14,19
31578,16157,16163,25,11,14,5,2,7,12,21,-9,12,16,17
31579,16157,16163,28,14,14,4,3,7,14,19,-5,11,17,15
31580,16157,16163,33,15,14,4,3,7,13,19,-6,11,17,15
31581,16157,16163,4,3,14,9,1,4,28,19,9,19,9,28
31582,16157,16163,9,18,14,0,5,9,13,28,-15,5,23,5
31583,16157,16163,1,1,14,12,2,0,36,5,31,26,2,38
31584,16157,16163,27,5,14,8,2,4,21,17,4,18,10,26
31585,16157,16163,17,8,14,6,3,5,27,22,5,15,13,21
31586,16157,16163,42,17,14,1,3,10,12,26,-14,5,23,6
31587,16157,16163,35,12,14,5,1,8,15,18,-3,11,17,16
31588,16164,16170,35,13,15,5,1,9,15,19,-4,11,19,16
31589,16164,16170,17,9,15,6,3,6,27,25,2,15,15,21
31590,16164,16170,42,17,15,1,3,11,13,29,-16,5,25,6
31591,16164,16170,27,4,15,9,2,4,23,18,5,20,10,29
31592,16164,16170,1,1,15,13,2,0,39,6,33,28,2,41
31593,16164,16170,4,3,15,10,1,4,29,19,10,21,9,31
31594,16164,16170,9,18,15,0,5,10,13,29,-16,5,25,5
31595,16164,16170,33,12,15,5,3,7,19,19,0,13,17,18
31596,16164,16170,28,15,15,4,3,8,15,21,-6,11,19,15
31597,16164,16170,12,8,15,6,4,5,17,18,-1,16,14,22
31598,16164,16170,25,10,15,6,2,7,14,22,-8,14,16,20
31599,16164,16170,43,2,15,11,1,3,33,15,18,23,7,34
31600,16164,16170,22,5,15,7,6,2,21,14,7,20,10,27
31601,16164,16170,40,6,15,8,2,5,24,13,11,18,12,26
31602,16164,16170,57,11,15,6,2,7,24,39,-15,14,16,20
31603,16164,16170,49,7,15,8,2,5,22,19,3,18,12,26
31604,16164,16170,37,14,15,4,4,7,18,21,-3,12,18,16
31605,16164,16170,46,16,15,2,2,11,12,32,-20,6,24,8
31606,16283,16289,37,12,27,8,7,12,38,44,-6,23,31,31
31607,16283,16289,46,17,27,6,2,19,23,52,-29,14,40,20
31608,16283,16289,42,18,27,5,4,18,31,47,-16,14,40,19
31609,16283,16289,35,14,27,7,6,14,26,34,-8,20,34,27
31610,16283,16289,43,2,27,19,4,4,60,26,34,42,12,61
31611,16283,16289,22,4,27,15,6,6,42,32,10,36,18,51
31612,16283,16289,40,8,27,10,7,10,34,27,7,27,27,37
31613,16283,16289,57,11,27,9,5,13,38,62,-24,23,31,32
31614,16283,16289,33,13,27,7,6,14,35,38,-3,20,34,27
31615,16283,16289,28,15,27,7,6,14,29,42,-13,20,34,27
31616,16283,16289,25,7,27,11,4,12,28,42,-14,26,28,37
31617,16283,16289,12,9,27,8,11,8,27,28,-1,27,27,35
31618,16283,16289,17,10,27,9,5,13,43,50,-7,23,31,32
31619,16283,16289,49,3,27,17,5,5,48,22,26,39,15,56
31620,16283,16289,27,6,27,14,7,6,35,28,7,35,19,49
31621,16283,16289,4,5,27,15,4,8,40,28,12,34,20,49
31622,16283,16289,9,16,27,5,7,15,26,51,-25,17,37,22
31623,16283,16289,1,1,27,21,4,2,68,18,50,46,8,67
31624,16080,16086,1,1,5,4,1,0,10,2,8,9,1,13
31625,16080,16086,17,9,5,2,1,2,8,5,3,5,5,7
31626,16080,16086,42,14,5,1,2,2,6,8,-2,4,6,5
31627,16080,16086,27,11,5,2,0,3,5,8,-3,4,6,6
31628,16080,16086,4,6,5,3,0,2,9,9,0,6,4,9
31629,16080,16086,9,18,5,0,1,4,5,14,-9,1,9,1
31630,16080,16086,25,5,5,3,1,1,8,6,2,7,3,10
31631,16080,16086,12,7,5,2,2,1,6,5,1,6,4,8
31632,16080,16086,43,2,5,4,0,1,8,4,4,8,2,12
31633,15737,15750,17,8,8,3,3,2,10,9,1,9,7,12
31634,15737,15750,42,15,8,0,5,3,6,13,-7,5,11,5
31635,15737,15750,33,5,8,3,4,1,14,9,5,10,6,13
31636,15737,15750,28,7,8,3,4,1,9,7,2,10,6,13
31637,15737,15750,43,1,8,7,1,0,26,6,20,15,1,22
31638,15737,15750,22,2,8,5,2,1,16,7,9,12,4,17
31639,15737,15750,40,10,8,2,5,1,9,6,3,9,7,11
31640,15737,15750,57,12,8,2,4,2,3,6,-3,8,8,10
31641,16227,16233,25,8,21,9,3,9,21,31,-10,21,21,30
31642,16227,16233,12,9,21,8,6,7,26,26,0,22,20,30
31643,16227,16233,35,14,21,5,5,11,18,24,-6,15,27,20
31644,16227,16233,27,5,21,11,5,5,28,21,7,27,15,38
31645,16227,16233,43,2,21,15,3,3,46,21,25,33,9,48
31646,16227,16233,22,3,21,12,6,3,32,20,12,30,12,42
31647,16227,16233,40,6,21,10,4,7,31,20,11,24,18,34
31648,16227,16233,57,13,21,6,4,11,28,53,-25,16,26,22
31649,16227,16233,49,4,21,12,4,5,37,21,16,28,14,40
31650,16227,16233,37,11,21,7,4,10,29,35,-6,18,24,25
31651,16227,16233,46,17,21,4,2,15,18,41,-23,10,32,14
31652,16227,16233,1,1,21,18,2,1,58,13,45,38,4,56
31653,16227,16233,17,10,21,8,4,9,37,36,1,20,22,28
31654,16227,16233,42,16,21,4,3,14,24,38,-14,11,31,15
31655,16227,16233,4,7,21,10,4,7,31,24,7,24,18,34
31656,16227,16233,9,18,21,2,6,13,19,44,-25,10,32,12
31657,16227,16233,33,12,21,6,4,11,29,30,-1,16,26,22
31658,16227,16233,28,15,21,5,5,11,24,38,-14,15,27,20
31659,16297,16303,4,6,29,15,5,9,42,31,11,35,23,50
31660,16297,16303,9,18,29,5,7,17,27,55,-28,17,41,22
31661,16297,16303,12,9,29,9,11,9,31,33,-2,29,29,38
31662,16297,16303,25,10,29,11,4,14,29,46,-17,26,32,37
31663,16297,16303,35,11,29,9,6,14,28,34,-6,24,34,33
31664,16297,16303,1,1,29,22,5,2,72,20,52,49,9,71
31665,16297,16303,49,3,29,18,6,5,51,23,28,42,16,60
31666,16297,16303,37,13,29,8,7,14,39,47,-8,23,35,31
31667,16297,16303,46,16,29,7,3,19,25,53,-28,17,41,24
31668,16297,16303,27,5,29,16,7,6,38,29,9,39,19,55
31669,16297,16303,17,12,29,9,5,15,43,52,-9,23,35,32
31670,16297,16303,42,17,29,6,4,19,35,50,-15,16,42,22
31671,16297,16303,43,2,29,20,5,4,63,27,36,45,13,65
31672,16297,16303,22,4,29,17,6,6,46,33,13,40,18,57
31673,16297,16303,57,7,29,11,5,13,42,63,-21,27,31,38
31674,16297,16303,40,8,29,10,8,11,36,32,4,28,30,38
31675,16297,16303,33,14,29,8,6,15,36,39,-3,22,36,30
31676,16297,16303,28,15,29,7,6,16,32,48,-16,20,38,27
31677,16087,16093,33,5,6,3,2,1,9,4,5,8,4,11
31678,16087,16093,28,17,6,0,2,4,2,9,-7,2,10,2
31679,16087,16093,43,2,6,5,0,1,13,5,8,10,2,15
31680,16087,16093,40,3,6,4,1,1,13,6,7,9,3,13
31681,16087,16093,22,8,6,2,3,1,4,4,0,7,5,9
31682,16087,16093,57,12,6,2,1,3,8,14,-6,5,7,7
31683,16087,16093,49,9,6,2,2,2,8,8,0,6,6,8
31684,16087,16093,37,14,6,1,2,3,5,7,-2,4,8,5
31685,16087,16093,46,16,6,1,1,4,4,7,-3,3,9,4
31686,16087,16093,1,1,6,5,1,0,15,2,13,11,1,16
31687,16087,16093,35,13,6,2,0,4,7,10,-3,4,8,6
31688,16087,16093,25,6,6,3,2,1,8,6,2,8,4,11
31689,16087,16093,12,10,6,2,2,2,6,6,0,6,6,8
31690,16087,16093,17,11,6,2,1,3,9,10,-1,5,7,7
31691,16087,16093,42,15,6,1,2,3,6,9,-3,4,8,5
31692,16087,16093,4,4,6,4,0,2,11,10,1,8,4,12
31693,16087,16093,9,18,6,0,2,4,5,14,-9,2,10,2
31694,16087,16093,27,7,6,3,0,3,6,8,-2,6,6,9
31695,16486,16492,4,6,11,5,4,2,16,11,5,14,8,19
31696,16486,16492,1,7,11,5,4,2,15,12,3,14,8,19
31697,16486,16492,28,9,11,4,1,6,11,13,-2,9,13,13
31698,16486,16492,33,15,11,3,0,8,10,18,-8,6,16,9
31699,16486,16492,25,3,11,6,3,2,16,6,10,15,7,21
31700,16486,16492,12,5,11,6,2,3,15,13,2,14,8,20
31701,16486,16492,49,1,11,9,1,1,22,10,12,19,3,28
31702,16486,16492,46,10,11,3,4,4,13,13,0,10,12,13
31703,16486,16492,37,14,11,3,1,7,11,17,-6,7,15,10
31704,16486,16492,17,16,11,1,5,5,5,13,-8,7,15,8
31705,16486,16492,45,4,11,6,2,3,21,17,4,14,8,20
31706,16486,16492,27,12,11,2,6,3,12,13,-1,10,12,12
31707,16486,16492,43,2,11,7,4,0,29,9,20,18,4,25
31708,16486,16492,22,8,11,4,5,2,17,14,3,13,9,17
31709,16486,16492,51,11,11,3,3,5,15,16,-1,9,13,12
31710,16486,16492,57,13,11,3,2,6,11,18,-7,8,14,11
31711,16486,16492,40,17,11,1,4,6,9,23,-14,6,16,7
31712,16486,16492,35,18,11,1,3,7,10,22,-12,5,17,6
31713,16080,16086,40,4,5,3,1,1,10,5,5,7,3,10
31714,16080,16086,22,8,5,2,2,1,4,4,0,6,4,8
31715,16080,16086,57,10,5,2,1,2,8,9,-1,5,5,7
31716,16080,16086,33,3,5,3,2,0,8,1,7,8,2,11
31717,16080,16086,28,17,5,0,1,4,2,9,-7,1,9,1
31718,16080,16086,35,16,5,1,0,4,5,10,-5,2,8,3
31719,16080,16086,49,12,5,1,2,2,7,8,-1,4,6,5
31720,16080,16086,37,13,5,1,2,2,4,5,-1,4,6,5
31721,16080,16086,46,15,5,1,1,3,4,5,-1,3,7,4
31722,16479,16485,46,14,10,2,4,4,12,13,-1,8,12,10
31723,16479,16485,45,4,10,6,2,2,20,12,8,14,6,20
31724,16479,16485,27,9,10,2,6,2,12,12,0,10,10,12
31725,16479,16485,35,17,10,1,3,6,10,21,-11,5,15,6
31726,16479,16485,17,16,10,1,5,4,5,12,-7,7,13,8
31727,16479,16485,40,18,10,0,4,6,8,23,-15,4,16,4
31728,16479,16485,43,2,10,7,3,0,27,7,20,17,3,24
31729,16479,16485,22,8,10,3,5,2,16,14,2,11,9,14
31730,16479,16485,51,10,10,3,2,5,13,14,-1,8,12,11
31731,16479,16485,57,13,10,3,1,6,9,16,-7,7,13,10
31732,16479,16485,25,3,10,6,2,2,15,5,10,14,6,20
31733,16479,16485,12,5,10,6,1,3,14,12,2,13,7,19
31734,16479,16485,49,1,10,8,1,1,21,10,11,17,3,25
31735,16479,16485,37,11,10,3,1,6,11,14,-3,7,13,10
31736,16479,16485,33,15,10,3,0,7,10,17,-7,6,14,9
31737,16479,16485,28,12,10,3,1,6,6,12,-6,7,13,10
31738,16479,16485,4,7,10,4,4,2,13,11,2,12,8,16
31739,16479,16485,1,6,10,5,3,2,13,10,3,13,7,18
31740,16535,16541,1,3,17,9,5,3,27,17,10,23,11,32
31741,16535,16541,17,18,17,1,6,10,7,31,-24,8,26,9
31742,16535,16541,4,10,17,6,4,7,20,22,-2,16,18,22
31743,16535,16541,33,13,17,6,1,10,25,31,-6,13,21,19
31744,16535,16541,28,17,17,4,2,11,17,28,-11,10,24,14
31745,16535,16541,49,1,17,11,2,4,28,17,11,24,10,35
31746,16535,16541,25,4,17,9,4,4,25,12,13,22,12,31
31747,16535,16541,12,7,17,8,4,5,25,23,2,20,14,28
31748,16535,16541,22,6,17,8,6,3,29,19,10,22,12,30
31749,16535,16541,51,9,17,6,4,7,28,22,6,16,18,22
31750,16535,16541,35,14,17,5,3,9,22,32,-10,13,21,18
31751,16535,16541,45,5,17,9,3,5,33,26,7,21,13,30
31752,16535,16541,27,15,17,4,6,7,17,24,-7,14,20,18
31753,16535,16541,46,8,17,6,7,4,20,16,4,19,15,25
31754,16535,16541,37,12,17,6,1,10,22,27,-5,13,21,19
31755,16535,16541,57,11,17,6,2,9,21,27,-6,14,20,20
31756,16535,16541,40,16,17,4,5,8,17,32,-15,13,21,17
31757,16535,16541,43,2,17,10,5,2,40,17,23,25,9,35
31758,16591,16597,43,3,21,11,7,3,46,22,24,29,13,40
31759,16591,16597,22,6,21,9,7,5,35,27,8,25,17,34
31760,16591,16597,51,11,21,6,8,7,33,27,6,20,22,26
31761,16591,16597,57,14,21,6,4,11,27,36,-9,16,26,22
31762,16591,16597,40,16,21,4,8,9,20,38,-18,16,26,20
31763,16591,16597,49,2,21,12,4,5,32,20,12,28,14,40
31764,16591,16597,46,10,21,7,8,6,24,22,2,22,20,29
31765,16591,16597,37,15,21,6,3,12,25,34,-9,15,27,21
31766,16591,16597,45,4,21,11,4,6,41,32,9,26,16,37
31767,16591,16597,27,9,21,8,6,7,22,25,-3,22,20,30
31768,16591,16597,35,12,21,7,3,11,28,36,-8,17,25,24
31769,16591,16597,25,7,21,9,5,7,28,24,4,23,19,32
31770,16591,16597,12,8,21,8,8,5,31,29,2,24,18,32
31771,16591,16597,33,13,21,7,2,12,31,34,-3,16,26,23
31772,16591,16597,28,17,21,4,6,11,20,31,-11,14,28,18
31773,16591,16597,4,5,21,10,4,7,29,25,4,24,18,34
31774,16591,16597,1,1,21,12,6,3,35,19,16,30,12,42
31775,16591,16597,17,18,21,2,7,12,11,37,-26,11,31,13
31776,16430,16443,1,3,4,2,2,0,5,2,3,6,2,8
31777,16430,16443,28,9,4,2,0,2,2,3,-1,4,4,6
31778,16430,16443,33,16,4,1,0,3,1,5,-4,2,6,3
31779,16430,16443,4,11,4,1,1,2,4,6,-2,3,5,4
31780,16430,16443,17,12,4,1,1,2,4,8,-4,3,5,4
31781,16430,16443,35,15,4,1,0,3,3,7,-4,2,6,3
31782,16430,16443,27,3,4,2,2,0,5,2,3,6,2,8
31783,16430,16443,45,5,4,2,1,1,8,5,3,5,3,7
31784,16430,16443,49,1,4,4,0,0,10,4,6,8,0,12
31785,16430,16443,46,10,4,1,2,1,5,4,1,4,4,5
31786,16430,16443,37,14,4,1,0,3,4,5,-1,2,6,3
31787,16430,16443,40,17,4,0,2,2,3,10,-7,2,6,2
31788,16430,16443,57,18,4,0,0,4,2,9,-7,0,8,0
31789,16430,16443,43,2,4,3,1,0,14,4,10,7,1,10
31790,16430,16443,51,8,4,2,0,2,5,2,3,4,4,6
31791,16430,16443,22,13,4,0,4,0,5,5,0,4,4,4
31792,16430,16443,25,6,4,2,1,1,4,2,2,5,3,7
31793,21323,21329,56,10,22,7,7,8,29,32,-3,21,23,28
31794,21323,21329,49,4,22,11,6,5,35,23,12,28,16,39
31795,21323,21329,22,1,22,15,6,1,52,21,31,36,8,51
31796,21323,21329,43,5,22,10,4,8,37,28,9,24,20,34
31797,21323,21329,21,3,22,12,5,5,32,25,7,29,15,41
31798,21323,21329,4,6,22,10,4,8,39,36,3,24,20,34
31799,21323,21329,1,2,22,12,5,5,48,23,25,29,15,41
31800,21169,21175,1,3,4,3,1,0,10,3,7,7,1,10
31801,21169,21175,4,7,4,2,1,1,10,7,3,5,3,7
31802,21169,21175,9,8,4,2,0,2,6,9,-3,4,4,6
31803,21169,21175,56,13,4,0,1,3,2,9,-7,1,7,1
31804,21169,21175,38,15,4,0,0,4,1,6,-5,0,8,0
31805,21169,21175,12,14,4,0,1,3,3,11,-8,1,7,1
31806,21169,21175,21,6,4,2,2,0,3,1,2,6,2,8
31807,21169,21175,45,9,4,1,2,1,8,6,2,4,4,5
31808,21169,21175,27,11,4,1,0,3,6,7,-1,2,6,3
31809,21169,21175,10,12,4,0,3,1,5,8,-3,3,5,3
31810,21169,21175,15,16,4,0,0,4,5,16,-11,0,8,0
31811,21169,21175,49,4,4,2,2,0,6,2,4,6,2,8
31812,21169,21175,43,1,4,4,0,0,13,4,9,8,0,12
31813,21169,21175,22,2,4,3,1,0,10,2,8,7,1,10
31814,21169,21175,57,5,4,2,2,0,6,3,3,6,2,8
31815,21169,21175,28,10,4,0,4,0,4,4,0,4,4,4
31816,21176,21182,22,1,5,4,1,0,13,4,9,9,1,13
31817,21176,21182,43,3,5,4,0,1,14,6,8,8,2,12
31818,21176,21182,57,8,5,2,2,1,6,4,2,6,4,8
31819,21176,21182,45,9,5,1,2,2,9,9,0,4,6,5
31820,21176,21182,27,12,5,1,0,4,6,9,-3,2,8,3
31821,21176,21182,15,13,5,1,0,4,6,16,-10,2,8,3
31822,21176,21182,10,14,5,0,3,2,7,11,-4,3,7,3
31823,21176,21182,12,15,5,0,1,4,4,13,-9,1,9,1
31824,21176,21182,28,11,5,0,4,1,6,7,-1,4,6,4
31825,21176,21182,38,16,5,0,0,5,1,7,-6,0,10,0
31826,21176,21182,56,10,5,1,1,3,4,9,-5,3,7,4
31827,21176,21182,21,5,5,3,2,0,4,1,3,8,2,11
31828,21176,21182,4,6,5,3,1,1,12,8,4,7,3,10
31829,21176,21182,9,7,5,3,0,2,9,10,-1,6,4,9
31830,21176,21182,49,4,5,3,2,0,9,4,5,8,2,11
31831,21176,21182,1,2,5,4,1,0,12,4,8,9,1,13
31832,21582,21595,1,1,10,7,3,0,25,3,22,17,3,24
31833,21582,21595,22,5,10,5,2,3,18,14,4,12,8,17
31834,21582,21595,24,6,10,5,2,3,16,16,0,12,8,17
31835,21582,21595,43,13,10,2,3,5,8,12,-4,7,13,9
31836,21582,21595,57,16,10,1,0,9,8,27,-19,2,18,3
31837,21582,21595,49,2,10,6,2,2,23,9,14,14,6,20
31838,21582,21595,56,11,10,3,2,5,18,17,1,8,12,11
31839,21582,21595,38,8,10,4,4,2,14,12,2,12,8,16
31840,21582,21595,28,10,10,3,3,4,11,18,-7,9,11,12
31841,21582,21595,45,7,10,4,4,2,18,12,6,12,8,16
31842,21582,21595,27,9,10,3,4,3,13,13,0,10,10,13
31843,21582,21595,10,14,10,1,4,5,8,20,-12,6,14,7
31844,21582,21595,15,15,10,1,3,6,6,22,-16,5,15,6
31845,21582,21595,21,3,10,6,2,2,22,13,9,14,6,20
31846,21582,21595,4,4,10,5,2,3,22,15,7,12,8,17
31847,21582,21595,9,12,10,3,2,5,13,20,-7,8,12,11
31848,21652,21658,21,2,19,11,4,4,38,24,14,26,12,37
31849,21652,21658,4,4,19,10,5,4,38,22,16,25,13,35
31850,21652,21658,9,13,19,5,3,11,22,35,-13,13,25,18
31851,21652,21658,27,3,19,10,6,3,29,16,13,26,12,36
31852,21652,21658,45,6,19,9,4,6,31,22,9,22,16,31
31853,21652,21658,15,12,19,5,4,10,15,30,-15,14,24,19
31854,21652,21658,10,15,19,2,5,12,15,41,-26,9,29,11
31855,21652,21658,49,5,19,10,5,4,36,20,16,25,13,35
31856,21652,21658,22,7,19,8,4,7,30,27,3,20,18,28
31857,21652,21658,24,8,19,8,4,7,28,30,-2,20,18,28
31858,21652,21658,43,10,19,5,8,6,22,22,0,18,20,23
31859,21652,21658,57,16,19,2,2,15,16,44,-28,6,32,8
31860,21652,21658,38,9,19,6,8,5,27,25,2,20,18,26
31861,21652,21658,28,11,19,6,4,9,21,36,-15,16,22,22
31862,21652,21658,56,14,19,4,4,11,25,33,-8,12,26,16
31863,21652,21658,1,1,19,14,4,1,41,7,34,32,6,46
31864,21659,21665,1,1,20,14,5,1,42,8,34,33,7,47
31865,21659,21665,56,12,20,5,4,11,27,34,-7,14,26,19
31866,21659,21665,38,9,20,6,9,5,28,26,2,21,19,27
31867,21659,21665,28,11,20,6,5,9,22,37,-15,17,23,23
31868,21659,21665,10,15,20,3,5,12,17,42,-25,11,29,14
31869,21659,21665,24,7,20,9,4,7,29,30,-1,22,18,31
31870,21659,21665,22,8,20,8,4,8,30,29,1,20,20,28
31871,21659,21665,43,10,20,6,8,6,24,22,2,20,20,26
31872,21659,21665,57,16,20,3,2,15,18,44,-26,8,32,11
31873,21659,21665,49,5,20,10,5,5,37,22,15,25,15,35
31874,15338,15351,43,2,4,3,1,0,10,3,7,7,1,10
31875,15338,15351,22,3,4,2,1,1,14,10,4,5,3,7
31876,15338,15351,24,11,4,1,1,2,2,8,-6,3,5,4
31877,15338,15351,40,16,4,0,2,2,4,6,-2,2,6,2
31878,15338,15351,21,8,4,1,2,1,6,6,0,4,4,5
31879,15338,15351,4,9,4,1,2,1,5,5,0,4,4,5
31880,15338,15351,33,5,4,2,1,1,9,7,2,5,3,7
31881,15338,15351,28,7,3,2,0,1,10,5,5,4,2,6
31882,15338,15351,27,15,4,0,2,2,5,7,-2,2,6,2
31883,15338,15351,37,14,4,1,0,3,4,14,-10,2,6,3
31884,15338,15351,49,17,4,0,1,3,3,9,-6,1,7,1
31885,15338,15351,1,1,4,4,0,0,11,1,10,8,0,12
31886,15338,15351,12,4,3,2,1,0,7,4,3,5,1,7
31887,15338,15351,25,13,4,1,0,3,2,6,-4,2,6,3
31888,15338,15351,35,12,3,1,0,2,6,10,-4,2,4,3
31889,15338,15351,42,6,4,2,1,1,3,4,-1,5,3,7
31890,15338,15351,17,10,3,1,1,1,6,2,4,3,3,4
31891,15373,15386,17,5,7,5,1,1,16,4,12,11,3,16
31892,15373,15386,42,6,8,5,1,2,16,7,9,11,5,16
31893,15373,15386,35,10,7,2,2,3,12,16,-4,6,8,8
31894,15373,15386,12,3,7,5,2,0,18,9,9,12,2,17
31895,15373,15386,25,12,7,2,0,5,4,14,-10,4,10,6
31896,15373,15386,1,1,8,7,1,0,21,4,17,15,1,22
31897,15373,15386,27,17,8,0,3,5,7,20,-13,3,13,3
31898,15373,15386,43,2,8,5,2,1,21,10,11,12,4,17
31899,15373,15386,22,7,7,3,3,1,16,11,5,9,5,12
31900,15373,15386,40,13,7,1,3,3,7,9,-2,5,9,6
31901,15373,15386,24,14,8,1,2,5,7,20,-13,4,12,5
31902,15373,15386,28,4,7,5,1,1,26,12,14,11,3,16
31903,15373,15386,33,8,8,3,1,4,18,23,-5,7,9,10
31904,15373,15386,21,9,8,2,3,3,11,15,-4,7,9,9
31905,15373,15386,4,10,8,2,2,4,12,16,-4,6,10,8
31906,15373,15386,37,15,7,1,0,6,6,19,-13,2,12,3
31907,15373,15386,49,16,8,0,3,5,9,18,-9,3,13,3
31908,15786,15792,49,2,13,9,1,3,27,10,17,19,7,28
31909,15786,15792,37,13,13,4,0,9,13,26,-13,8,18,12
31910,15786,15792,1,5,13,6,3,4,24,16,8,15,11,21
31911,15786,15792,4,12,13,3,7,3,14,13,1,13,13,16
31912,15786,15792,21,14,13,3,3,7,11,26,-15,9,17,12
31913,15786,15792,31,18,13,2,2,9,10,22,-12,6,20,8
31914,15786,15792,33,4,13,6,5,2,22,13,9,17,9,23
31915,15786,15792,28,6,13,5,4,4,18,20,-2,14,12,19
31916,15786,15792,17,10,13,4,5,4,15,16,-1,13,13,17
31917,15786,15792,42,17,13,1,6,6,10,21,-11,8,18,9
31918,15786,15792,25,7,13,5,4,4,17,21,-4,14,12,19
31919,15786,15792,12,16,13,2,3,8,14,25,-11,7,19,9
31920,15786,15792,27,15,13,2,4,7,7,12,-5,8,18,10
31921,15786,15792,43,1,13,11,1,1,35,10,25,23,3,34
31922,15786,15792,22,3,13,8,3,2,29,15,14,19,7,27
31923,15786,15792,40,8,13,4,7,2,20,14,6,15,11,19
31924,15786,15792,57,9,13,4,6,3,11,14,-3,14,12,18
31925,15786,15792,35,11,13,4,4,5,11,14,-3,12,14,16
31926,15793,15799,35,7,14,5,4,5,12,14,-2,14,14,19
31927,15793,15799,43,1,14,12,1,1,37,11,26,25,3,37
31928,15793,15799,22,3,14,8,3,3,30,18,12,19,9,27
31929,15793,15799,40,10,14,4,7,3,20,17,3,15,13,19
31930,15793,15799,57,11,14,4,7,3,11,14,-3,15,13,19
31931,15793,15799,27,17,14,2,4,8,7,13,-6,8,20,10
31932,15793,15799,25,8,14,5,4,5,17,22,-5,14,14,19
31933,15793,15799,12,14,14,3,3,8,17,25,-8,9,19,12
31934,15793,15799,17,12,14,4,5,5,16,18,-2,13,15,17
31935,15793,15799,42,16,14,2,6,6,11,21,-10,10,18,12
31936,15793,15799,33,5,14,6,5,3,24,17,7,17,11,23
31937,15793,15799,28,6,14,5,5,4,18,20,-2,15,13,20
31938,15793,15799,4,9,14,4,7,3,17,13,4,15,13,19
31939,15793,15799,21,15,14,3,3,8,11,29,-18,9,19,12
31940,15793,15799,31,18,14,2,3,9,11,23,-12,7,21,9
31941,15793,15799,1,4,14,7,3,4,28,18,10,17,11,24
31942,15793,15799,49,2,14,9,2,3,28,11,17,20,8,29
31943,15793,15799,37,13,14,5,0,9,16,27,-11,10,18,15
31944,15898,15904,1,2,26,16,4,6,55,27,28,36,16,52
31945,15898,15904,4,10,26,6,11,9,24,27,-3,23,29,29
31946,15898,15904,21,17,26,5,5,16,20,50,-30,15,37,20
31947,15898,15904,31,18,26,4,6,16,24,51,-27,14,38,18
31948,15898,15904,42,13,26,6,10,10,24,32,-8,22,30,28
31949,15898,15904,17,14,26,5,12,9,23,32,-9,22,30,27
31950,15898,15904,25,5,26,12,8,6,40,31,9,32,20,44
31951,15898,15904,12,12,26,7,7,12,34,45,-11,21,31,28
31952,15898,15904,27,16,26,5,7,14,25,36,-11,17,35,22
31953,15898,15904,49,3,26,14,8,4,53,23,30,36,16,50
31954,16430,16443,12,7,4,2,1,1,4,5,-1,5,3,7
31955,16864,16870,25,4,11,6,2,3,18,14,4,14,8,20
31956,16864,16870,22,1,11,9,2,0,30,9,21,20,2,29
31957,16864,16870,43,2,11,7,3,1,21,11,10,17,5,24
31958,16864,16870,49,6,11,5,3,3,16,11,5,13,9,18
31959,16864,16870,46,10,11,3,4,4,12,13,-1,10,12,13
31960,16864,16870,37,16,11,3,2,6,9,17,-8,8,14,11
31961,16864,16870,35,8,11,4,3,4,12,13,-1,11,11,15
31962,16864,16870,42,11,11,3,4,4,9,11,-2,10,12,13
31963,16864,16870,17,18,11,0,2,9,4,20,-16,2,20,2
31964,16864,16870,45,14,11,3,3,5,13,16,-3,9,13,12
31965,16864,16870,33,9,11,4,3,4,18,21,-3,11,11,15
31966,16864,16870,28,17,11,2,1,8,11,20,-9,5,17,7
31967,16864,16870,51,13,11,3,3,5,18,21,-3,9,13,12
31968,16864,16870,57,15,11,3,2,6,9,12,-3,8,14,11
31969,16864,16870,4,7,11,5,3,3,18,19,-1,13,9,18
31970,16864,16870,27,5,11,5,4,2,16,13,3,14,8,19
31971,16864,16870,12,12,11,3,4,4,11,15,-4,10,12,13
31972,16864,16870,1,3,11,6,2,3,23,12,11,14,8,20
31973,16906,16940,1,4,17,9,4,4,35,19,16,22,12,31
31974,16906,16940,28,11,17,6,2,9,23,26,-3,14,20,20
31975,16906,16940,33,12,17,4,7,6,23,29,-6,15,19,19
31976,16906,16940,4,3,17,10,3,4,29,22,7,23,11,33
31977,16906,16940,42,15,17,4,4,9,14,24,-10,12,22,16
31978,16906,16940,17,18,17,1,3,13,10,33,-23,5,29,6
31979,16906,16940,35,8,17,6,5,6,20,24,-4,17,17,23
31980,16906,16940,49,5,17,9,4,4,32,20,12,22,12,31
31981,16906,16940,37,14,17,4,4,9,15,25,-10,12,22,16
31982,16906,16940,46,16,17,3,7,7,16,22,-6,13,21,16
31983,16906,16940,27,6,17,8,5,4,23,17,6,21,13,29
31984,16906,16940,45,10,17,5,6,6,20,23,-3,16,18,21
31985,16906,16940,25,7,17,7,4,6,22,22,0,18,16,25
31986,16906,16940,12,17,17,3,7,7,12,20,-8,13,21,16
31987,16906,16940,22,1,17,12,4,1,38,16,22,28,6,40
31988,16906,16940,43,2,17,11,4,2,33,17,16,26,8,37
31989,16906,16940,51,9,17,5,6,6,27,29,-2,16,18,21
31990,16906,16940,57,13,17,5,3,9,14,18,-4,13,21,18
31991,16948,16954,22,1,19,13,5,1,43,18,25,31,7,44
31992,16948,16954,43,2,19,13,4,2,38,18,20,30,8,43
31993,16948,16954,51,8,19,7,6,6,30,29,1,20,18,27
31994,16948,16954,57,12,19,6,3,10,16,21,-5,15,23,21
31995,16948,16954,25,7,19,8,4,7,24,24,0,20,18,28
31996,16948,16954,12,14,19,4,7,8,15,23,-8,15,23,19
31997,16948,16954,27,6,19,8,5,6,26,24,2,21,17,29
31998,16948,16954,45,11,19,5,7,7,22,27,-5,17,21,22
31999,16948,16954,49,3,19,11,4,4,40,23,17,26,12,37
32000,16948,16954,35,9,19,6,6,7,22,28,-6,18,20,24
32001,16948,16954,42,16,19,4,5,10,15,26,-11,13,25,17
32002,16948,16954,17,18,19,2,3,14,12,37,-25,7,31,9
32003,16948,16954,4,4,19,11,4,4,32,22,10,26,12,37
32004,16948,16954,28,10,19,7,2,10,24,28,-4,16,22,23
32005,16948,16954,33,15,19,4,7,8,24,34,-10,15,23,19
32006,16948,16954,46,13,19,4,8,7,19,23,-4,16,22,20
32007,16948,16954,37,17,19,4,5,10,16,28,-12,13,25,17
32008,16948,16954,1,5,19,9,5,5,35,20,15,23,15,32
32009,16969,16975,1,5,22,10,6,6,39,23,16,26,18,36
32010,16969,16975,27,6,22,10,6,6,30,25,5,26,18,36
32011,16969,16975,49,3,22,13,4,5,46,29,17,30,14,43
32012,16969,16975,46,13,22,5,9,8,23,29,-6,19,25,24
32013,16969,16975,37,16,22,5,5,12,21,36,-15,15,29,20
32014,16969,16975,28,12,22,7,3,12,28,35,-7,17,27,24
32015,16969,16975,33,15,22,5,7,10,30,40,-10,17,27,22
32016,16969,16975,4,4,22,12,4,6,36,27,9,28,16,40
32017,16969,16975,42,14,22,6,5,11,19,29,-10,17,27,23
32018,16969,16975,17,18,22,3,3,16,16,42,-26,9,35,12
32019,16969,16975,35,9,22,8,6,8,29,32,-3,22,22,30
32020,16969,16975,57,10,22,7,4,11,18,24,-6,18,26,25
32021,16969,16975,45,11,22,6,7,9,25,31,-6,19,25,25
32022,16969,16975,25,7,22,10,4,8,28,26,2,24,20,34
32023,16969,16975,12,17,22,4,8,10,19,30,-11,16,28,20
32024,16969,16975,22,1,22,15,5,2,50,21,29,35,9,50
32025,16969,16975,43,2,22,15,5,2,43,21,22,35,9,50
32026,16969,16975,51,8,22,8,7,7,34,34,0,23,21,31
32027,16997,17010,25,7,26,11,6,9,31,30,1,28,24,39
32028,16997,17010,12,16,26,5,10,11,23,34,-11,20,32,25
32029,16997,17010,27,6,26,12,7,7,36,30,6,31,21,43
32030,16997,17010,45,11,26,8,8,10,31,37,-6,24,28,32
32031,16997,17010,22,1,26,17,6,3,59,27,32,40,12,57
32032,16997,17010,43,2,26,16,8,2,48,25,23,40,12,56
32033,16521,16527,35,15,15,4,3,8,20,29,-9,11,19,15
32034,16521,16527,43,3,15,8,5,2,35,16,19,21,9,29
32035,16521,16527,22,6,15,7,5,3,25,17,8,19,11,26
32036,16521,16527,51,10,15,5,3,7,26,22,4,13,17,18
32037,16521,16527,57,12,15,5,2,8,18,25,-7,12,18,17
32038,16521,16527,40,16,15,3,5,7,15,29,-14,11,19,14
32039,16521,16527,45,2,15,9,2,4,30,22,8,20,10,29
32040,16521,16527,27,11,15,4,6,5,17,20,-3,14,16,18
32041,16521,16527,17,18,15,1,5,9,6,28,-22,7,23,8
32042,16521,16527,49,1,15,11,1,3,27,15,12,23,7,34
32043,16521,16527,46,8,15,6,5,4,19,15,4,17,13,23
32044,16521,16527,37,13,15,5,1,9,19,24,-5,11,19,16
32045,16521,16527,25,5,15,8,3,4,20,10,10,19,11,27
32046,16521,16527,12,7,15,7,4,4,22,20,2,18,12,25
32047,16521,16527,33,14,15,5,1,9,18,25,-7,11,19,16
32048,16521,16527,28,17,15,4,1,10,14,22,-8,9,21,13
32049,16521,16527,1,4,15,8,4,3,23,15,8,20,10,28
32050,16521,16527,4,9,15,5,4,6,18,18,0,14,16,19
32051,16577,16583,4,8,19,8,4,7,25,23,2,20,18,28
32052,16577,16583,33,14,19,6,2,11,26,33,-7,14,24,20
32053,16577,16583,28,17,19,4,4,11,19,30,-11,12,26,16
32054,16577,16583,25,5,19,9,5,5,28,17,11,23,15,32
32055,16577,16583,12,7,19,8,6,5,28,26,2,22,16,30
32056,16577,16583,1,2,19,11,5,3,31,17,14,27,11,38
32057,16577,16583,49,1,19,12,2,5,31,19,12,26,12,38
32058,16577,16583,46,9,19,7,7,5,23,20,3,21,17,28
32059,16577,16583,37,15,19,6,2,11,24,31,-7,14,24,20
32060,16577,16583,43,3,19,10,7,2,42,19,23,27,11,37
32061,16577,16583,22,6,19,8,7,4,32,23,9,23,15,31
32062,16577,16583,51,10,19,6,6,7,30,24,6,18,20,24
32063,16577,16583,57,12,19,6,4,9,25,31,-6,16,22,22
32064,16577,16583,40,16,19,4,6,9,17,35,-18,14,24,18
32065,16577,16583,17,18,19,1,7,11,8,34,-26,9,29,10
32066,16577,16583,45,4,19,10,3,6,36,29,7,23,15,33
32067,16577,16583,27,11,19,6,6,7,20,25,-5,18,20,24
32068,16577,16583,35,13,19,6,3,10,25,34,-9,15,23,21
32069,16647,16653,12,7,29,11,10,8,42,40,2,32,26,43
32070,16647,16653,25,8,29,11,7,11,38,38,0,29,29,40
32071,16647,16653,43,1,29,17,8,4,61,26,35,42,16,59
32072,16647,16653,22,6,29,13,8,8,41,32,9,34,24,47
32073,16647,16653,51,10,29,9,10,10,42,38,4,28,30,37
32074,16647,16653,57,15,29,8,6,15,33,52,-19,22,36,30
32075,16647,16653,40,18,29,4,13,12,21,43,-22,21,37,25
32076,16647,16653,49,2,29,17,7,5,48,24,24,41,17,58
32077,16647,16653,46,11,29,9,10,10,26,27,-1,28,30,37
32078,16647,16653,37,17,29,7,4,18,32,52,-20,18,40,25
32079,16647,16653,17,16,29,6,8,15,18,47,-29,20,38,26
32080,16647,16653,35,12,29,10,6,13,36,43,-7,26,32,36
32081,16647,16653,28,13,29,8,8,13,33,38,-5,24,34,32
32082,16647,16653,33,14,29,9,4,16,39,39,0,22,36,31
32083,16647,16653,45,5,29,14,6,9,48,39,9,34,24,48
32084,16647,16653,27,9,29,10,9,10,32,33,-1,29,29,39
32085,16647,16653,4,4,29,15,5,9,41,31,10,35,23,50
32086,16647,16653,1,3,29,14,9,6,42,31,11,37,21,51
32087,16675,16681,1,3,33,17,10,6,48,33,15,44,22,61
32088,16675,16681,4,4,33,17,7,9,46,34,12,41,25,58
32089,16675,16681,45,6,33,14,7,12,51,46,5,35,31,49
32090,16675,16681,27,8,33,11,12,10,39,38,1,34,32,45
32091,16675,16681,33,13,33,11,4,18,43,42,1,26,40,37
32092,16675,16681,28,15,33,8,10,15,36,48,-12,26,40,34
32093,16675,16681,35,9,33,12,8,13,43,44,-1,32,34,44
32094,16675,16681,17,17,33,7,8,18,21,52,-31,22,44,29
32095,16675,16681,49,2,33,19,8,6,51,26,25,46,20,65
32096,16675,16681,46,11,33,11,10,12,29,30,-1,32,34,43
32097,16675,16681,37,16,33,8,6,19,34,55,-21,22,44,30
32098,16675,16681,43,1,33,19,10,4,69,27,42,48,18,67
32099,16675,16681,22,5,33,16,9,8,48,35,13,41,25,57
32100,16675,16681,51,12,33,10,11,12,44,41,3,31,35,41
32101,16675,16681,57,14,33,9,8,16,37,56,-19,26,40,35
32102,16675,16681,40,18,33,4,14,15,25,50,-25,22,44,26
32103,16675,16681,12,7,33,12,11,10,47,47,0,35,31,47
32104,16675,16681,25,10,33,12,7,14,40,47,-7,31,35,43
32105,16465,16478,35,17,9,1,3,5,9,17,-8,5,13,6
32106,16465,16478,43,2,9,6,3,0,26,7,19,15,3,21
32107,16465,16478,22,8,9,3,5,1,16,13,3,11,7,14
32108,16465,16478,51,13,9,2,2,5,9,13,-4,6,12,8
32109,16465,16478,57,15,9,2,1,6,7,15,-8,5,13,7
32110,16465,16478,40,18,9,0,4,5,7,19,-12,4,14,4
32111,21659,21665,27,3,20,10,7,3,30,17,13,27,13,37
32112,21659,21665,45,6,20,9,4,7,31,24,7,22,18,31
32113,21659,21665,15,13,20,5,4,11,16,32,-16,14,26,19
32114,21659,21665,21,2,20,11,5,4,39,25,14,27,13,38
32115,21659,21665,4,4,20,10,6,4,39,23,16,26,14,36
32116,21659,21665,9,14,20,5,3,12,22,36,-14,13,27,18
32117,21687,21693,4,2,22,12,6,4,43,24,19,30,14,42
32118,21687,21693,21,3,22,12,6,4,41,26,15,30,14,42
32119,21687,21693,9,15,22,5,3,14,22,42,-20,13,31,18
32120,21687,21693,49,5,22,11,5,6,40,25,15,27,17,38
32121,21687,21693,22,6,22,10,4,8,35,30,5,24,20,34
32122,21687,21693,24,7,22,10,4,8,33,34,-1,24,20,34
32123,21687,21693,43,9,22,6,9,7,25,24,1,21,23,27
32124,21687,21693,57,16,22,3,2,17,19,47,-28,8,36,11
32125,21687,21693,27,4,22,11,8,3,36,18,18,30,14,41
32126,21687,21693,45,8,22,9,4,9,31,31,0,22,22,31
32127,21687,21693,15,13,22,5,5,12,18,35,-17,15,29,20
32128,21687,21693,10,14,22,5,5,12,19,42,-23,15,29,20
32129,21687,21693,38,10,22,6,9,7,30,31,-1,21,23,27
32130,21687,21693,28,11,22,7,5,10,24,38,-14,19,25,26
32131,21687,21693,56,12,22,6,4,12,28,36,-8,16,28,22
32132,21687,21693,1,1,22,16,5,1,48,9,39,37,7,53
32133,21533,21539,1,1,4,3,1,0,11,1,10,7,1,10
32134,21533,21539,38,7,4,2,1,1,4,5,-1,5,3,7
32135,21533,21539,28,12,4,1,0,3,2,10,-8,2,6,3
32136,21533,21539,56,6,4,2,1,1,9,6,3,5,3,7
32137,21533,21539,49,3,4,3,0,1,11,3,8,6,2,9
32138,21533,21539,24,2,4,3,1,0,8,2,6,7,1,10
32139,21533,21539,22,8,4,2,0,2,7,6,1,4,4,6
32140,21533,21539,43,13,4,0,2,2,3,6,-3,2,6,2
32141,21533,21539,57,16,4,0,0,4,3,11,-8,0,8,0
32142,21533,21539,21,4,4,3,0,1,11,4,7,6,2,9
32143,21533,21539,4,5,4,2,1,1,10,4,6,5,3,7
32144,21533,21539,9,9,4,2,0,2,5,6,-1,4,4,6
32145,21533,21539,45,10,4,2,0,2,5,7,-2,4,4,6
32146,21533,21539,27,11,4,1,2,1,5,6,-1,4,4,5
32147,21533,21539,15,14,4,0,2,2,3,11,-8,2,6,2
32148,21533,21539,10,15,4,0,1,3,3,12,-9,1,7,1
32149,22026,22029,56,11,18,6,5,7,23,27,-4,17,19,23
32150,22026,22029,16,5,18,8,5,5,33,29,4,21,15,29
32151,22026,22029,49,9,18,6,7,5,21,19,2,19,17,25
32152,22026,22029,21,7,18,8,4,6,31,26,5,20,16,28
32153,22026,22029,4,8,18,8,1,9,28,26,2,17,19,25
32154,22026,22029,9,10,18,6,5,7,23,22,1,17,19,23
32155,22026,22029,22,1,18,11,4,3,41,22,19,26,10,37
32156,22026,22029,43,6,18,7,8,3,28,22,6,22,14,29
32157,22026,22029,57,14,18,6,1,11,26,33,-7,13,23,19
32158,22026,22029,24,16,18,4,5,9,26,35,-9,13,23,17
32159,22026,22029,1,2,18,11,3,4,35,12,23,25,11,36
32160,22026,22029,28,17,18,4,5,9,21,30,-9,13,23,17
32161,22026,22029,38,18,18,4,5,9,15,28,-13,13,23,17
32162,22026,22029,27,3,18,10,3,5,29,20,9,23,13,33
32163,22026,22029,45,12,18,6,3,9,25,34,-9,15,21,21
32164,22026,22029,15,13,18,4,9,5,22,29,-7,17,19,21
32165,22026,22029,10,15,18,5,3,10,24,38,-14,13,23,18
32166,22026,22029,53,4,18,9,2,7,40,39,1,20,16,29
32167,22240,22246,28,5,1,1,0,0,2,1,1,2,0,3
32168,22240,22246,53,15,1,0,0,1,0,1,-1,0,2,0
32169,22240,22246,1,7,1,0,1,0,2,2,0,1,1,1
32170,22240,22246,24,4,1,1,0,0,3,2,1,2,0,3
32171,22240,22246,57,6,1,1,0,0,1,0,1,2,0,3
32172,22240,22246,22,9,1,0,1,0,1,1,0,1,1,1
32173,22240,22246,43,16,1,0,0,1,1,3,-2,0,2,0
32174,22240,22246,49,9,1,0,1,0,1,1,0,1,1,1
32175,22240,22246,16,9,1,0,1,0,1,1,0,1,1,1
32176,22240,22246,56,3,1,1,0,0,2,0,2,2,0,3
32177,22240,22246,13,17,1,0,0,1,0,2,-2,0,2,0
32178,22240,22246,27,1,1,1,0,0,3,0,3,2,0,3
32179,22240,22246,39,2,1,1,0,0,3,1,2,2,0,3
32180,22240,22246,15,7,1,0,1,0,2,2,0,1,1,1
32181,22240,22246,45,9,1,0,1,0,1,1,0,1,1,1
32182,22240,22246,21,13,1,0,0,1,2,3,-1,0,2,0
32183,22240,22246,4,14,1,0,0,1,1,2,-1,0,2,0
32184,22240,22246,9,18,1,0,0,1,0,3,-3,0,2,0
32185,22450,22456,21,3,28,16,5,7,48,30,18,37,19,53
32186,22450,22456,39,1,28,20,3,5,62,22,40,43,13,63
32187,22450,22456,27,7,28,12,7,9,42,38,4,31,25,43
32188,22450,22456,15,15,28,7,6,15,33,49,-16,20,36,27
32189,22450,22456,45,16,28,6,8,14,37,61,-24,20,36,26
32190,22450,22456,56,12,28,9,10,9,37,34,3,28,28,37
32191,22450,22456,13,17,28,7,2,19,26,57,-31,16,40,23
32192,15898,15904,37,8,26,10,3,13,35,41,-6,23,29,33
32193,15898,15904,43,1,26,22,2,2,66,21,45,46,6,68
32194,15898,15904,22,6,26,12,7,7,46,32,14,31,21,43
32195,15898,15904,40,11,26,6,11,9,31,36,-5,23,29,29
32196,15898,15904,57,15,26,5,11,10,20,42,-22,21,31,26
32197,15898,15904,33,4,26,12,10,4,50,34,16,34,18,46
32198,15898,15904,28,9,26,8,9,9,29,36,-7,25,27,33
32199,15898,15904,35,7,26,8,11,7,22,25,-3,27,25,35
32200,15723,15729,35,7,6,2,3,1,7,3,4,7,5,9
32201,15723,15729,25,14,6,1,3,2,7,11,-4,5,7,6
32202,15723,15729,12,18,6,0,2,4,3,12,-9,2,10,2
32203,15723,15729,17,4,6,3,2,1,7,4,3,8,4,11
32204,15723,15729,42,16,6,0,3,3,5,12,-7,3,9,3
32205,15723,15729,1,2,6,3,2,1,13,7,6,8,4,11
32206,15723,15729,43,1,6,6,0,0,21,3,18,12,0,18
32207,15723,15729,22,3,6,3,2,1,8,3,5,8,4,11
32208,15723,15729,57,10,6,2,2,2,3,6,-3,6,6,8
32209,15723,15729,40,12,6,1,4,1,6,5,1,6,6,7
32210,15723,15729,49,6,6,3,1,2,8,6,2,7,5,10
32211,15723,15729,37,13,6,2,0,4,9,13,-4,4,8,6
32212,15723,15729,27,15,6,0,3,3,1,5,-4,3,9,3
32213,15723,15729,4,9,6,2,3,1,11,9,2,7,5,9
32214,15723,15729,21,11,6,2,1,3,4,12,-8,5,7,7
32215,15723,15729,31,17,6,0,2,4,0,7,-7,2,10,2
32216,15723,15729,28,5,6,3,2,1,8,6,2,8,4,11
32217,15723,15729,33,8,6,2,3,1,12,9,3,7,5,9
32218,16171,16177,28,15,16,4,4,8,16,22,-6,12,20,16
32219,16171,16177,33,10,16,6,3,7,24,20,4,15,17,21
32220,16171,16177,1,1,16,13,2,1,40,8,32,28,4,41
32221,16171,16177,4,3,16,10,2,4,30,20,10,22,10,32
32222,16171,16177,9,17,16,1,5,10,15,30,-15,7,25,8
32223,16171,16177,49,5,16,8,3,5,23,20,3,19,13,27
32224,16171,16177,37,13,16,5,4,7,22,22,0,14,18,19
32225,16171,16177,46,16,16,3,2,11,14,33,-19,8,24,11
32226,16171,16177,27,4,16,10,2,4,25,18,7,22,10,32
32227,16171,16177,43,2,16,12,1,3,35,16,19,25,7,37
32228,16171,16177,22,6,16,7,6,3,21,16,5,20,12,27
32229,16171,16177,40,7,16,8,2,6,25,15,10,18,14,26
32230,16171,16177,25,11,16,6,2,8,15,26,-11,14,18,20
32231,16171,16177,12,9,16,6,4,6,17,20,-3,16,16,22
32232,16171,16177,57,12,16,6,2,8,25,41,-16,14,18,20
32233,16171,16177,42,18,16,1,3,12,14,34,-20,5,27,6
32234,16171,16177,17,8,16,7,3,6,29,25,4,17,15,24
32235,16171,16177,35,14,16,5,2,9,16,20,-4,12,20,17
32236,16258,16261,35,14,24,6,5,13,24,30,-6,17,31,23
32237,16258,16261,27,6,24,12,6,6,30,25,5,30,18,42
32238,16258,16261,1,1,24,20,3,1,65,16,49,43,5,63
32239,16258,16261,43,2,24,16,4,4,50,23,27,36,12,52
32240,16258,16261,22,4,24,13,6,5,36,26,10,32,16,45
32241,16258,16261,40,7,24,10,6,8,32,22,10,26,22,36
32242,16258,16261,57,11,24,8,4,12,35,58,-23,20,28,28
32243,16258,16261,17,10,24,8,5,11,39,45,-6,21,27,29
32244,16258,16261,42,17,24,5,3,16,29,43,-14,13,35,18
32245,16258,16261,25,8,24,10,4,10,25,35,-10,24,24,34
32246,16258,16261,12,9,24,8,9,7,27,27,0,25,23,33
32247,16258,16261,49,3,24,14,5,5,39,21,18,33,15,47
32248,16258,16261,37,12,24,7,6,11,33,40,-7,20,28,27
32249,16258,16261,46,18,24,5,2,17,21,47,-26,12,36,17
32250,16258,16261,33,13,24,6,6,12,32,34,-2,18,30,24
32251,16258,16261,28,15,24,6,5,13,28,41,-13,17,31,23
32252,16258,16261,4,5,24,13,4,7,35,24,11,30,18,43
32253,16258,16261,9,16,24,4,7,13,23,46,-23,15,33,19
32254,16311,16317,4,6,31,16,5,10,43,32,11,37,25,53
32255,16311,16317,9,17,31,6,8,17,30,57,-27,20,42,26
32256,16311,16317,49,3,31,19,6,6,57,27,30,44,18,63
32257,16311,16317,37,13,31,8,7,16,39,52,-13,23,39,31
32258,16311,16317,46,16,31,8,3,20,28,56,-28,19,43,27
32259,16311,16317,43,2,31,21,6,4,68,31,37,48,14,69
32260,16311,16317,22,5,31,18,7,6,49,35,14,43,19,61
32261,16311,16317,40,7,31,11,8,12,40,34,6,30,32,41
32262,16311,16317,57,10,31,11,5,15,42,69,-27,27,35,38
32263,16311,16317,1,1,31,24,5,2,79,20,59,53,9,77
32264,16311,16317,27,4,31,18,7,6,44,29,15,43,19,61
32265,16311,16317,35,11,31,10,6,15,30,40,-10,26,36,36
32266,16311,16317,12,8,31,10,11,10,33,34,-1,31,31,41
32267,16311,16317,25,9,31,11,5,15,33,51,-18,27,35,38
32268,16311,16317,33,14,31,8,6,17,36,42,-6,22,40,30
32269,16311,16317,28,15,31,8,6,17,35,53,-18,22,40,30
32270,16311,16317,17,12,31,10,5,16,47,55,-8,25,37,35
32271,16465,16478,45,4,9,5,2,2,18,12,6,12,6,17
32272,16465,16478,27,9,9,2,6,1,10,8,2,10,8,12
32273,16465,16478,17,14,9,1,5,3,5,10,-5,7,11,8
32274,16465,16478,1,7,9,4,3,2,11,9,2,11,7,15
32275,16465,16478,28,12,9,3,0,6,5,11,-6,6,12,9
32276,16465,16478,33,16,9,2,0,7,6,16,-10,4,14,6
32277,16465,16478,25,3,9,6,2,1,14,3,11,14,4,20
32278,16465,16478,12,5,9,5,1,3,10,10,0,11,7,16
32279,16465,16478,49,1,9,7,1,1,20,10,10,15,3,22
32280,16465,16478,37,10,9,3,1,5,11,13,-2,7,11,10
32281,16465,16478,46,11,9,2,4,3,11,11,0,8,10,10
32282,16465,16478,4,6,9,4,3,2,12,10,2,11,7,15
32283,16955,16961,1,5,20,10,5,5,37,20,17,25,15,35
32284,16955,16961,4,4,20,12,4,4,35,23,12,28,12,40
32285,16955,16961,28,9,20,7,3,10,26,30,-4,17,23,24
32286,16955,16961,33,16,20,4,7,9,25,36,-11,15,25,19
32287,16955,16961,35,10,20,6,6,8,23,30,-7,18,22,24
32288,16955,16961,42,14,20,5,5,10,17,27,-10,15,25,20
32289,16955,16961,17,18,20,3,3,14,13,37,-24,9,31,12
32290,16955,16961,27,7,20,8,6,6,26,24,2,22,18,30
32291,16955,16961,45,12,20,5,7,8,22,28,-6,17,23,22
32292,16955,16961,49,3,20,12,4,4,42,24,18,28,12,40
32293,16955,16961,46,13,20,4,9,7,21,25,-4,17,23,21
32294,16955,16961,37,17,20,4,5,11,16,30,-14,13,27,17
32295,16955,16961,43,1,20,14,4,2,39,18,21,32,8,46
32296,16955,16961,22,2,20,13,5,2,44,20,24,31,9,44
32297,16955,16961,51,6,20,8,6,6,32,30,2,22,18,30
32298,16955,16961,57,11,20,6,4,10,16,21,-5,16,24,22
32299,16955,16961,25,8,20,8,4,8,24,25,-1,20,20,28
32300,16955,16961,12,15,20,4,7,9,16,26,-10,15,25,19
32301,17060,17136,43,1,34,23,8,3,75,30,45,54,14,77
32302,17060,17136,22,2,34,22,6,6,71,37,34,50,18,72
32303,17060,17136,51,11,34,10,9,15,50,72,-22,29,39,39
32304,17060,17136,57,12,34,10,8,16,31,36,-5,28,40,38
32305,17060,17136,27,5,34,17,9,8,51,40,11,43,25,60
32306,17060,17136,45,14,34,9,10,15,40,54,-14,28,40,37
32307,17060,17136,35,7,34,14,9,11,52,46,6,37,31,51
32308,17060,17136,42,9,34,12,8,14,41,41,0,32,36,44
32309,17060,17136,17,17,34,6,8,20,33,66,-33,20,48,26
32310,17060,17136,1,6,34,14,9,11,58,40,18,37,31,51
32311,17060,17136,33,10,34,10,12,12,51,55,-4,32,36,42
32312,17060,17136,28,15,34,9,8,17,39,52,-13,26,42,35
32313,17060,17136,4,4,34,18,6,10,56,40,16,42,26,60
32314,17060,17136,49,3,34,19,7,8,62,38,24,45,23,64
32315,17060,17136,46,13,34,8,14,12,39,50,-11,30,38,38
32316,17060,17136,37,18,34,5,10,19,31,64,-33,20,48,25
32317,17060,17136,25,8,34,12,10,12,41,44,-3,34,34,46
32318,17060,17136,12,16,34,5,15,14,32,48,-16,25,43,30
32319,16794,16807,33,5,4,2,1,1,8,7,1,5,3,7
32320,16794,16807,28,12,4,1,1,2,6,8,-2,3,5,4
32321,16794,16807,45,13,4,1,1,2,4,6,-2,3,5,4
32322,16794,16807,4,14,4,1,1,2,4,10,-6,3,5,4
32323,16794,16807,1,7,4,2,0,2,9,4,5,4,4,6
32324,16794,16807,42,11,4,1,1,2,4,4,0,3,5,4
32325,16794,16807,17,18,4,0,1,3,1,6,-5,1,7,1
32326,16794,16807,27,6,4,2,1,1,5,4,1,5,3,7
32327,16794,16807,46,3,4,3,1,0,5,2,3,7,1,10
32328,16794,16807,37,15,4,1,0,3,3,7,-4,2,6,3
32329,16794,16807,49,16,4,0,2,2,4,6,-2,2,6,2
32330,16794,16807,43,1,4,4,0,0,10,5,5,8,0,12
32331,16794,16807,22,2,4,3,1,0,8,2,6,7,1,10
32332,16794,16807,51,10,4,1,2,1,8,8,0,4,4,5
32333,16794,16807,57,17,4,0,1,3,2,5,-3,1,7,1
32334,16794,16807,25,4,4,2,1,1,9,6,3,5,3,7
32335,16794,16807,12,9,4,1,3,0,5,4,1,5,3,6
32336,16794,16807,35,8,4,2,0,2,3,4,-1,4,4,6
32337,16808,16814,35,6,5,3,0,2,5,5,0,6,4,9
32338,16808,16814,25,3,5,3,1,1,10,6,4,7,3,10
32339,16808,16814,12,7,5,2,3,0,7,4,3,7,3,9
32340,16808,16814,51,12,5,1,2,2,9,10,-1,4,6,5
32341,16808,16814,57,13,5,1,1,3,4,6,-2,3,7,4
32342,16808,16814,22,1,5,4,1,0,11,3,8,9,1,13
32343,16808,16814,43,2,5,4,1,0,11,6,5,9,1,13
32344,16808,16814,46,5,5,3,1,1,6,4,2,7,3,10
32345,16808,16814,49,10,5,1,2,2,7,7,0,4,6,5
32346,16808,16814,37,17,5,1,0,4,3,9,-6,2,8,3
32347,16808,16814,42,11,5,1,2,2,4,4,0,4,6,5
32348,16808,16814,17,18,5,0,1,4,2,9,-7,1,9,1
32349,16808,16814,1,9,5,2,1,2,9,4,5,5,5,7
32350,16808,16814,45,15,5,1,1,3,5,8,-3,3,7,4
32351,16808,16814,27,4,5,3,1,1,7,5,2,7,3,10
32352,21540,21546,10,16,5,0,1,4,3,13,-10,1,9,1
32353,21540,21546,28,12,5,1,1,3,2,10,-8,3,7,4
32354,21540,21546,38,5,5,3,1,1,6,5,1,7,3,10
32355,21540,21546,49,1,5,4,0,1,13,4,9,8,2,12
32356,21540,21546,9,7,5,3,0,2,7,7,0,6,4,9
32357,21540,21546,4,8,5,2,1,2,12,7,5,5,5,7
32358,21540,21546,24,4,5,3,1,1,9,4,5,7,3,10
32359,21540,21546,1,3,5,3,2,0,11,1,10,8,2,11
32360,21981,21994,1,1,12,7,2,3,28,11,17,16,8,23
32361,21981,21994,22,4,12,6,4,2,22,16,6,16,8,22
32362,21981,21994,21,6,12,6,3,3,22,16,6,15,9,21
32363,21981,21994,9,11,12,4,3,5,16,14,2,11,13,15
32364,21981,21994,4,12,12,4,1,7,20,20,0,9,15,13
32365,21981,21994,49,5,12,6,4,2,15,10,5,16,8,22
32366,21981,21994,16,7,12,6,3,3,21,19,2,15,9,21
32367,21981,21994,15,13,12,2,7,3,12,18,-6,11,13,13
32368,21981,21994,10,14,12,3,2,7,18,27,-9,8,16,11
32369,21981,21994,45,15,12,3,2,7,15,26,-11,8,16,11
32370,21981,21994,27,2,12,7,2,3,21,12,9,16,8,23
32371,21981,21994,56,9,12,4,4,4,18,19,-1,12,12,16
32372,21981,21994,28,17,12,2,3,7,14,24,-10,7,17,9
32373,21981,21994,38,18,12,2,3,7,8,19,-11,7,17,9
32374,21981,21994,53,3,12,7,1,4,33,30,3,15,9,22
32375,21981,21994,43,8,12,5,6,1,22,16,6,16,8,21
32376,21981,21994,57,10,12,5,0,7,18,20,-2,10,14,15
32377,21981,21994,24,16,12,2,4,6,16,22,-6,8,16,10
32378,21995,22001,22,3,13,7,4,2,26,17,9,18,8,25
32379,21995,22001,43,8,13,5,6,2,23,18,5,16,10,21
32380,21995,22001,57,9,13,6,0,7,20,20,0,12,14,18
32381,21995,22001,24,14,13,3,4,6,18,23,-5,10,16,13
32382,21995,22001,28,17,13,2,4,7,16,26,-10,8,18,10
32383,21995,22001,38,18,13,2,3,8,9,23,-14,7,19,9
32384,21995,22001,53,2,13,8,1,4,35,31,4,17,9,25
32385,21995,22001,56,12,13,4,4,5,18,20,-2,12,14,16
32386,21995,22001,27,4,13,7,2,4,21,13,8,16,10,23
32387,21995,22001,15,13,13,2,8,3,14,20,-6,12,14,14
32388,21995,22001,10,15,13,3,2,8,18,29,-11,8,18,11
32389,21995,22001,45,16,13,3,2,8,16,28,-12,8,18,11
32390,21995,22001,49,5,13,6,5,2,17,12,5,17,9,23
32391,21995,22001,16,7,13,6,4,3,23,21,2,16,10,22
32392,21995,22001,21,6,13,6,4,3,23,17,6,16,10,22
32393,21995,22001,4,10,13,5,1,7,21,20,1,11,15,16
32394,21995,22001,9,11,13,4,4,5,17,15,2,12,14,16
32395,21995,22001,1,1,13,8,2,3,29,11,18,18,8,26
32396,22002,22008,1,3,14,8,3,3,29,11,18,19,9,27
32397,22002,22008,21,4,14,7,4,3,26,19,7,18,10,25
32398,22002,22008,4,12,14,5,1,8,21,23,-2,11,17,16
32399,22002,22008,9,13,14,4,4,6,18,18,0,12,16,16
32400,22002,22008,49,5,14,6,6,2,17,12,5,18,10,24
32401,22002,22008,16,7,14,6,4,4,25,24,1,16,12,22
32402,22002,22008,27,6,14,7,2,5,22,16,6,16,12,23
32403,22002,22008,15,11,14,3,8,3,17,21,-4,14,14,17
32404,22002,22008,45,14,14,4,2,8,19,28,-9,10,18,14
32405,22002,22008,10,16,14,3,3,8,19,30,-11,9,19,12
32406,22002,22008,56,9,14,5,4,5,21,21,0,14,14,19
32407,22002,22008,53,1,14,9,1,4,38,33,5,19,9,28
32408,22002,22008,28,17,14,2,5,7,17,27,-10,9,19,11
32409,22002,22008,38,18,14,2,4,8,9,23,-14,8,20,10
32410,22002,22008,22,2,14,8,4,2,31,18,13,20,8,28
32411,22002,22008,43,8,14,5,7,2,23,18,5,17,11,22
32412,22002,22008,57,10,14,6,0,8,21,25,-4,12,16,18
32413,22002,22008,24,15,14,3,4,7,20,26,-6,10,18,13
32414,21932,21938,22,9,6,2,2,2,9,10,-1,6,6,8
32415,21932,21938,24,16,6,1,1,4,6,10,-4,3,9,4
32416,21932,21938,43,5,6,3,3,0,14,8,6,9,3,12
32417,21932,21938,57,7,6,3,0,3,8,7,1,6,6,9
32418,21932,21938,15,12,6,1,4,1,6,9,-3,6,6,7
32419,21932,21938,45,14,6,2,0,4,7,14,-7,4,8,6
32420,21932,21938,10,17,6,1,0,5,9,18,-9,2,10,3
32421,21932,21938,27,1,6,6,0,0,12,2,10,12,0,18
32422,21932,21938,53,4,6,4,0,2,12,10,2,8,4,12
32423,21932,21938,38,18,6,0,2,4,2,8,-6,2,10,2
32424,21932,21938,16,10,6,2,2,2,8,9,-1,6,6,8
32425,21932,21938,28,15,6,1,2,3,6,11,-5,4,8,5
32426,21932,21938,9,8,6,2,2,2,7,6,1,6,6,8
32427,21932,21938,21,10,6,2,2,2,8,9,-1,6,6,8
32428,21932,21938,4,13,6,2,0,4,5,7,-2,4,8,6
32429,21932,21938,49,2,6,4,1,1,8,3,5,9,3,13
32430,21932,21938,56,6,6,3,1,2,8,6,2,7,5,10
32431,21932,21938,1,3,6,4,0,2,16,4,12,8,4,12
32432,22331,22337,1,2,12,6,5,1,21,14,7,17,7,23
32433,20644,20783,4,4,30,14,8,8,45,29,16,36,24,50
32434,20644,20783,9,5,30,14,8,8,52,37,15,36,24,50
32435,20448,20461,22,3,5,3,1,1,8,4,4,7,3,10
32436,20448,20461,43,5,5,2,3,0,11,6,5,7,3,9
32437,20448,20461,24,7,5,2,2,1,6,5,1,6,4,8
32438,20448,20461,49,11,5,1,3,1,6,5,1,5,5,6
32439,20448,20461,56,8,5,2,2,1,6,8,-2,6,4,8
32440,20448,20461,9,4,5,3,1,1,7,5,2,7,3,10
32441,20448,20461,4,6,5,2,3,0,9,6,3,7,3,9
32442,20448,20461,12,10,5,2,0,3,5,6,-1,4,6,6
32443,20448,20461,25,16,5,0,1,4,6,13,-7,1,9,1
32444,20448,20461,28,12,5,1,1,3,3,6,-3,3,7,4
32445,20448,20461,38,14,5,1,0,4,5,8,-3,2,8,3
32446,20448,20461,27,1,5,3,2,0,6,3,3,8,2,11
32447,20448,20461,45,2,5,3,1,1,7,2,5,7,3,10
32448,20448,20461,15,13,5,1,1,3,6,11,-5,3,7,4
32449,20448,20461,10,15,5,0,2,3,5,9,-4,2,8,2
32450,20448,20461,1,9,5,2,1,2,6,5,1,5,5,7
32451,20462,20468,1,10,6,2,1,3,6,6,0,5,7,7
32452,20462,20468,45,1,6,4,1,1,12,3,9,9,3,13
32453,20462,20468,27,5,6,3,2,1,8,6,2,8,4,11
32454,20462,20468,15,11,6,2,1,3,8,12,-4,5,7,7
32455,20462,20468,10,13,6,1,2,3,6,9,-3,4,8,5
32456,20462,20468,28,14,6,1,1,4,3,8,-5,3,9,4
32457,20462,20468,38,15,6,1,0,5,6,13,-7,2,10,3
32458,20462,20468,12,12,6,2,0,4,5,9,-4,4,8,6
32459,20462,20468,25,16,6,0,1,5,7,17,-10,1,11,1
32460,20462,20468,4,3,6,3,3,0,12,6,6,9,3,12
32461,20462,20468,56,6,6,3,2,1,10,9,1,8,4,11
32462,20462,20468,49,9,6,2,3,1,8,5,3,7,5,9
32463,20462,20468,43,2,6,3,3,0,14,8,6,9,3,12
32464,20462,20468,24,4,6,3,2,1,8,5,3,8,4,11
32465,20462,20468,22,7,6,3,1,2,8,6,2,7,5,10
32466,20462,20468,9,8,6,3,1,2,8,7,1,7,5,10
32467,20896,20902,43,3,15,8,4,3,22,17,5,20,10,28
32468,20896,20902,22,6,15,5,7,3,21,17,4,17,13,22
32469,20896,20902,24,15,15,2,5,8,17,26,-9,9,21,11
32470,20896,20902,56,14,15,3,5,7,16,24,-8,11,19,14
32471,20896,20902,28,4,15,7,3,5,21,23,-2,17,13,24
32472,20896,20902,38,11,15,5,4,6,22,26,-4,14,16,19
32473,20896,20902,9,13,15,4,3,8,20,22,-2,11,19,15
32474,20896,20902,12,12,15,4,4,7,17,24,-7,12,18,16
32475,20896,20902,27,2,15,9,4,2,26,16,10,22,8,31
32476,20896,20902,10,7,15,6,3,6,31,25,6,15,15,21
32477,20896,20902,45,9,15,6,1,8,26,27,-1,13,17,19
32478,20896,20902,15,16,15,2,4,9,23,40,-17,8,22,10
32479,20896,20902,49,8,15,5,5,5,15,18,-3,15,15,20
32480,20896,20902,21,5,15,6,5,4,22,20,2,17,13,23
32481,20896,20902,4,10,15,5,4,6,20,15,5,14,16,19
32482,20896,20902,1,1,15,12,1,2,33,12,21,25,5,37
32483,20980,20986,1,1,26,18,5,3,62,29,33,41,11,59
32484,20980,20986,49,8,26,9,9,8,35,35,0,27,25,36
32485,20980,20986,27,2,26,13,9,4,44,26,18,35,17,48
32486,20980,20986,10,9,26,9,7,10,47,44,3,25,27,34
32487,20980,20986,45,13,26,8,4,14,39,47,-8,20,32,28
32488,20980,20986,15,16,26,4,9,13,31,50,-19,17,35,21
32489,20980,20986,12,14,26,7,7,12,29,42,-13,21,31,28
32490,20980,20986,4,4,26,12,7,7,37,20,17,31,21,43
32491,20980,20986,21,6,26,9,10,7,35,34,1,28,24,37
32492,20980,20986,9,11,26,8,5,13,35,36,-1,21,31,29
32493,20980,20986,28,10,26,8,9,9,28,38,-10,25,27,33
32494,20980,20986,38,12,26,8,5,13,34,46,-12,21,31,29
32495,20980,20986,56,7,26,10,6,10,38,36,2,26,26,36
32496,20980,20986,43,3,26,13,7,6,39,35,4,33,19,46
32497,20980,20986,22,5,26,9,10,7,36,32,4,28,24,37
32498,20980,20986,24,15,26,5,7,14,24,43,-19,17,35,22
32499,20987,20993,43,3,27,13,7,7,39,36,3,33,21,46
32500,20987,20993,22,6,27,9,11,7,38,34,4,29,25,38
32501,20987,20993,24,15,27,5,8,14,26,45,-19,18,36,23
32502,20987,20993,56,5,27,11,6,10,39,36,3,28,26,39
32503,20987,20993,28,9,27,9,9,9,29,38,-9,27,27,36
32504,20987,20993,38,13,27,8,6,13,36,48,-12,22,32,30
32505,20987,20993,4,4,27,12,8,7,39,22,17,32,22,44
32506,20987,20993,21,7,27,9,11,7,35,34,1,29,25,38
32507,20987,20993,9,12,27,8,6,13,35,36,-1,22,32,30
32508,20987,20993,12,14,27,7,7,13,29,43,-14,21,33,28
32509,20987,20993,27,2,27,13,10,4,45,27,18,36,18,49
32510,20987,20993,10,10,27,9,8,10,49,46,3,26,28,35
32511,20987,20993,45,11,27,9,4,14,42,49,-7,22,32,31
32512,20987,20993,15,16,27,4,9,14,33,53,-20,17,37,21
32513,16311,16317,42,18,31,7,4,20,38,54,-16,18,44,25
32514,16066,16079,42,9,4,1,2,1,5,4,1,4,4,5
32515,16066,16079,17,12,4,1,1,2,4,4,0,3,5,4
32516,16066,16079,28,17,4,0,1,3,1,7,-6,1,7,1
32517,16066,16079,25,5,4,2,1,1,7,6,1,5,3,7
32518,16066,16079,12,10,4,1,2,1,5,5,0,4,4,5
32519,16066,16079,35,16,4,1,0,3,4,8,-4,2,6,3
32520,16066,16079,37,11,4,1,2,1,4,4,0,4,4,5
32521,16066,16079,46,12,4,1,1,2,4,4,0,3,5,4
32522,16066,16079,49,14,4,1,1,2,6,7,-1,3,5,4
32523,16066,16079,27,8,4,2,0,2,5,7,-2,4,4,6
32524,16066,16079,33,4,4,2,2,0,7,1,6,6,2,8
32525,16066,16079,4,7,4,2,0,2,7,8,-1,4,4,6
32526,16066,16079,9,18,4,0,1,3,4,11,-7,1,7,1
32527,16066,16079,1,1,4,3,1,0,9,2,7,7,1,10
32528,16066,16079,40,2,4,3,1,0,10,4,6,7,1,10
32529,16066,16079,43,3,4,3,0,1,5,3,2,6,2,9
32530,16066,16079,22,6,4,2,1,1,3,3,0,5,3,7
32531,16066,16079,57,15,4,1,1,2,6,8,-2,3,5,4
32532,16493,16499,43,2,12,7,5,0,31,11,20,19,5,26
32533,16493,16499,22,8,12,4,5,3,17,15,2,13,11,17
32534,16493,16499,51,10,12,4,3,5,20,17,3,11,13,15
32535,16493,16499,57,12,12,4,2,6,15,18,-3,10,14,14
32536,16493,16499,40,16,12,2,4,6,12,24,-12,8,16,10
32537,16493,16499,4,7,12,5,4,3,17,13,4,14,10,19
32538,16493,16499,1,3,12,6,4,2,17,13,4,16,8,22
32539,16493,16499,45,6,12,6,2,4,22,19,3,14,10,20
32540,16493,16499,27,11,12,3,6,3,14,14,0,12,12,15
32541,16493,16499,25,4,12,6,3,3,17,8,9,15,9,21
32542,16493,16499,49,1,12,9,1,2,23,12,11,19,5,28
32543,16493,16499,46,9,12,4,4,4,14,13,1,12,12,16
32544,16493,16499,37,14,12,4,1,7,13,18,-5,9,15,13
32545,16493,16499,17,17,12,1,5,6,5,17,-12,7,17,8
32546,16493,16499,35,18,12,1,3,8,11,27,-16,5,19,6
32547,16493,16499,12,5,12,6,3,3,17,15,2,15,9,21
32548,16493,16499,28,13,12,4,1,7,12,16,-4,9,15,13
32549,16493,16499,33,15,12,4,0,8,12,19,-7,8,16,12
32550,16444,16450,28,11,5,2,0,3,3,5,-2,4,6,6
32551,16444,16450,33,16,5,1,0,4,2,8,-6,2,8,3
32552,16444,16450,35,15,5,1,0,4,4,9,-5,2,8,3
32553,16444,16450,17,13,5,1,1,3,4,9,-5,3,7,4
32554,16444,16450,1,3,5,3,2,0,7,3,4,8,2,11
32555,16444,16450,45,5,5,3,1,1,10,6,4,7,3,10
32556,16444,16450,27,7,5,2,3,0,6,3,3,7,3,9
32557,16444,16450,25,4,5,3,1,1,7,2,5,7,3,10
32558,16444,16450,12,6,5,3,1,1,5,5,0,7,3,10
32559,16444,16450,4,9,5,2,1,2,6,6,0,5,5,7
32560,16444,16450,49,2,5,4,0,1,11,7,4,8,2,12
32561,16444,16450,37,10,5,2,0,3,7,6,1,4,6,6
32562,16444,16450,46,12,5,1,2,2,5,7,-2,4,6,5
32563,16444,16450,43,1,5,4,1,0,17,5,12,9,1,13
32564,16444,16450,51,8,5,2,1,2,6,3,3,5,5,7
32565,16444,16450,22,14,5,0,4,1,5,7,-2,4,6,4
32566,16444,16450,40,17,5,0,3,2,3,10,-7,3,7,3
32567,16444,16450,57,18,5,0,1,4,2,9,-7,1,9,1
32568,16941,16947,49,3,18,10,4,4,35,21,14,24,12,34
32569,16941,16947,37,14,18,4,5,9,16,26,-10,13,23,17
32570,16941,16947,46,16,18,3,8,7,17,23,-6,14,22,17
32571,16941,16947,1,5,18,9,5,4,35,19,16,23,13,32
32572,16941,16947,4,4,18,10,4,4,29,22,7,24,12,34
32573,16941,16947,25,7,18,7,4,7,22,24,-2,18,18,25
32574,16941,16947,12,17,18,3,7,8,13,23,-10,13,23,16
32575,16941,16947,27,6,18,8,5,5,24,19,5,21,15,29
32576,16941,16947,45,10,18,5,7,6,22,25,-3,17,19,22
32577,16941,16947,22,1,18,12,5,1,40,18,22,29,7,41
32578,16941,16947,43,2,18,12,4,2,35,17,18,28,8,40
32579,16941,16947,51,8,18,6,6,6,29,29,0,18,18,24
32580,16941,16947,57,11,18,6,3,9,16,19,-3,15,21,21
32581,16941,16947,42,15,18,4,5,9,15,25,-10,13,23,17
32582,16941,16947,17,18,18,2,3,13,12,34,-22,7,29,9
32583,16941,16947,28,12,18,6,2,10,23,28,-5,14,22,20
32584,16941,16947,33,13,18,4,7,7,24,31,-7,15,21,19
32585,16941,16947,35,9,18,6,6,6,21,25,-4,18,18,24
32586,17032,17038,25,7,30,12,7,11,37,37,0,31,29,43
32587,17032,17038,12,16,30,5,14,11,27,38,-11,24,36,29
32588,17032,17038,33,11,30,8,11,11,41,49,-8,27,33,35
32589,17032,17038,28,15,30,7,8,15,33,46,-13,22,38,29
32590,17032,17038,35,8,30,11,8,11,44,43,1,30,30,41
32591,17032,17038,43,1,30,20,8,2,55,26,29,48,12,68
32592,17032,17038,22,2,30,20,6,4,66,30,36,46,14,66
32593,17032,17038,51,10,30,9,9,12,46,56,-10,27,33,36
32594,16997,17010,51,9,26,9,7,10,40,44,-4,25,27,34
32595,16997,17010,57,10,26,9,5,12,22,26,-4,23,29,32
32596,16997,17010,35,8,26,9,7,10,35,36,-1,25,27,34
32597,16997,17010,42,12,26,8,6,12,27,32,-5,22,30,30
32598,16997,17010,28,13,26,7,6,13,31,39,-8,20,32,27
32599,16997,17010,33,14,26,6,9,11,34,44,-10,21,31,27
32600,16997,17010,49,3,26,16,4,6,54,32,22,36,16,52
32601,16997,17010,46,15,26,5,11,10,25,37,-12,21,31,26
32602,16997,17010,37,17,26,5,6,15,24,46,-22,16,36,21
32603,16997,17010,4,4,26,14,4,8,43,32,11,32,20,46
32604,16997,17010,1,5,26,13,6,7,46,28,18,32,20,45
32605,16997,17010,17,18,26,4,4,18,20,50,-30,12,40,16
32606,17053,17059,42,9,33,11,8,14,38,40,-2,30,36,41
32607,17053,17059,17,18,33,5,8,20,29,65,-36,18,48,23
32608,17053,17059,35,7,33,13,9,11,49,46,3,35,31,48
32609,17053,17059,1,6,33,14,8,11,55,37,18,36,30,50
32610,17053,17059,43,1,33,23,8,2,74,27,47,54,12,77
32611,17053,17059,22,2,33,22,6,5,70,34,36,50,16,72
32612,17053,17059,46,14,33,7,14,12,36,49,-13,28,38,35
32613,17053,17059,37,17,33,5,10,18,29,61,-32,20,46,25
32614,17053,17059,25,8,33,12,9,12,40,43,-3,33,33,45
32615,17053,17059,12,16,33,5,15,13,31,44,-13,25,41,30
32616,17053,17059,33,11,33,9,12,12,49,55,-6,30,36,39
32617,17053,17059,28,15,33,8,8,17,36,50,-14,24,42,32
32618,17053,17059,4,4,33,18,5,10,55,39,16,41,25,59
32619,17053,17059,51,10,33,10,9,14,50,69,-19,29,37,39
32620,17053,17059,57,12,33,10,7,16,28,33,-5,27,39,37
32621,17053,17059,49,3,33,19,7,7,62,36,26,45,21,64
32622,17053,17059,27,5,33,16,9,8,49,39,10,41,25,57
32623,17053,17059,45,13,33,9,10,14,39,52,-13,28,38,37
32624,17137,17143,27,9,1,0,1,0,1,1,0,1,1,1
32625,17137,17143,45,17,1,0,0,1,1,4,-3,0,2,0
32626,17137,17143,22,3,1,1,0,0,3,1,2,2,0,3
32627,17137,17143,43,7,1,1,0,0,1,0,1,2,0,3
32628,17137,17143,51,9,1,0,1,0,1,1,0,1,1,1
32629,17137,17143,24,14,1,0,0,1,0,1,-1,0,2,0
32630,17137,17143,57,16,1,0,0,1,1,3,-2,0,2,0
32631,17137,17143,4,1,1,1,0,0,4,1,3,2,0,3
32632,17137,17143,28,11,1,0,0,1,1,2,-1,0,2,0
32633,17137,17143,33,17,1,0,0,1,1,4,-3,0,2,0
32634,17137,17143,12,4,1,1,0,0,2,1,1,2,0,3
32635,17137,17143,25,7,1,1,0,0,1,0,1,2,0,3
32636,17137,17143,49,1,1,1,0,0,4,1,3,2,0,3
32637,17137,17143,23,11,1,0,0,1,1,2,-1,0,2,0
32638,17137,17143,46,14,1,0,0,1,0,1,-1,0,2,0
32639,17137,17143,1,4,1,1,0,0,2,1,1,2,0,3
32640,17137,17143,35,4,1,1,0,0,2,1,1,2,0,3
32641,17137,17143,42,11,1,0,0,1,1,2,-1,0,2,0
32642,17305,17311,42,18,18,2,4,12,18,32,-14,8,28,10
32643,17305,17311,35,4,18,11,3,4,29,14,15,25,11,36
32644,17305,17311,33,12,18,6,4,8,23,26,-3,16,20,22
32645,17305,17311,28,16,18,3,3,12,15,34,-19,9,27,12
32646,17305,17311,1,1,18,12,5,1,25,12,13,29,7,41
32647,17305,17311,4,5,18,8,6,4,36,23,13,22,14,30
32648,17305,17311,45,8,18,7,3,8,25,31,-6,17,19,24
32649,17305,17311,27,10,18,7,2,9,21,26,-5,16,20,23
32650,17305,17311,57,3,18,11,4,3,43,17,26,26,10,37
32651,17305,17311,43,6,18,8,6,4,26,20,6,22,14,30
32652,17305,17311,22,7,18,8,5,5,28,27,1,21,15,29
32653,17305,17311,51,13,18,5,6,7,25,34,-9,16,20,21
32654,17305,17311,24,15,18,3,6,9,22,32,-10,12,24,15
32655,17305,17311,49,2,18,11,7,0,39,13,26,29,7,40
32656,17305,17311,23,14,18,4,4,10,16,30,-14,12,24,16
32657,17305,17311,46,17,18,3,2,13,15,43,-28,8,28,11
32658,17305,17311,25,9,18,6,6,6,27,18,9,18,18,24
32659,17305,17311,12,11,18,5,8,5,17,18,-1,18,18,23
32660,17333,17339,25,7,22,8,8,6,33,22,11,24,20,32
32661,17333,17339,12,12,22,5,11,6,20,22,-2,21,23,26
32662,17333,17339,49,2,22,13,9,0,42,14,28,35,9,48
32663,17333,17339,23,14,22,6,4,12,22,37,-15,16,28,22
32664,17333,17339,46,18,22,3,2,17,17,51,-34,8,36,11
32665,17333,17339,57,3,22,13,5,4,52,22,30,31,13,44
32666,17333,17339,43,5,22,11,7,4,33,23,10,29,15,40
32667,17333,17339,22,8,22,8,7,7,33,35,-2,23,21,31
32668,17333,17339,51,11,22,6,8,8,28,36,-8,20,24,26
32669,17333,17339,24,15,22,5,7,10,26,35,-9,17,27,22
32670,17333,17339,35,4,22,12,5,5,33,19,14,29,15,41
32671,17333,17339,45,9,22,8,5,9,28,36,-8,21,23,29
32672,17333,17339,27,10,22,7,5,10,23,29,-6,19,25,26
32673,22450,22456,16,9,28,10,9,9,44,44,0,29,27,39
32674,22450,22456,49,13,28,8,8,12,30,43,-13,24,32,32
32675,22450,22456,4,5,28,13,7,8,43,27,16,33,23,46
32676,22450,22456,9,14,28,9,4,15,28,52,-24,22,34,31
32677,22450,22456,43,4,28,14,9,5,60,32,28,37,19,51
32678,22450,22456,24,6,28,14,3,11,48,51,-3,31,25,45
32679,22450,22456,22,8,28,12,5,11,54,41,13,29,27,41
32680,22450,22456,57,10,28,11,5,12,40,34,6,27,29,38
32681,22450,22456,1,2,28,15,9,4,52,33,19,39,17,54
32682,22450,22456,28,11,28,11,4,13,32,37,-5,26,30,37
32683,22450,22456,53,18,28,4,4,20,27,58,-31,12,44,16
32684,22478,22491,53,18,32,4,4,24,32,68,-36,12,52,16
32685,22478,22491,28,9,32,13,6,13,37,40,-3,32,32,45
32686,22478,22491,1,2,32,19,9,4,67,36,31,47,17,66
32687,22478,22491,43,5,32,16,10,6,65,34,31,42,22,58
32688,22478,22491,24,7,32,14,7,11,54,57,-3,35,29,49
32689,22478,22491,22,8,32,13,6,13,59,47,12,32,32,45
32690,22478,22491,57,10,32,12,7,13,46,43,3,31,33,43
32691,22478,22491,21,3,32,18,5,9,53,37,16,41,23,59
32692,22478,22491,4,4,32,17,7,8,49,28,21,41,23,58
32693,22478,22491,9,14,32,9,6,17,30,59,-29,24,40,33
32694,22478,22491,16,11,32,10,11,11,47,52,-5,31,33,41
32695,22478,22491,49,13,32,9,9,14,31,45,-14,27,37,36
32696,22478,22491,56,12,32,9,10,13,39,42,-3,28,36,37
32697,22478,22491,13,17,32,8,3,21,28,64,-36,19,45,27
32698,22478,22491,39,1,32,22,5,5,70,26,44,49,15,71
32699,22478,22491,27,6,32,14,9,9,52,42,10,37,27,51
32700,22478,22491,15,15,32,8,8,16,37,54,-17,24,40,32
32701,22478,22491,45,16,32,8,8,16,42,64,-22,24,40,32
32702,22779,22782,56,15,20,5,3,12,19,37,-18,13,27,18
32703,22779,22782,13,18,20,4,3,13,19,36,-17,11,29,15
32704,22779,22782,49,6,20,9,4,7,31,24,7,22,18,31
32705,22779,22782,16,9,20,8,5,7,35,31,4,21,19,29
32706,22779,22782,21,3,20,12,3,5,35,22,13,27,13,39
32707,22779,22782,4,5,20,10,4,6,34,21,13,24,16,34
32708,22779,22782,9,16,20,5,2,13,22,44,-22,12,28,17
32709,22779,22782,22,1,20,17,1,2,49,17,32,35,5,52
32710,22779,22782,57,10,20,7,5,8,26,28,-2,19,21,26
32711,22779,22782,24,12,20,7,4,9,32,34,-2,18,22,25
32712,22779,22782,43,13,20,7,3,10,28,29,-1,17,23,24
32713,22779,22782,1,4,20,10,5,5,37,25,12,25,15,35
32714,22779,22782,28,8,20,8,6,6,22,20,2,22,18,30
32715,22779,22782,39,2,20,14,3,3,43,23,20,31,9,45
32716,22779,22782,27,11,20,8,1,11,26,37,-11,17,23,25
32717,22779,22782,15,14,20,6,1,13,26,42,-16,13,27,19
32718,22779,22782,45,17,20,4,4,12,25,43,-18,12,28,16
32719,22779,22782,25,7,20,9,3,8,39,35,4,21,19,30
32720,22863,22869,39,2,32,21,6,5,64,38,26,48,16,69
32721,22863,22869,27,8,32,14,5,13,42,47,-5,33,31,47
32722,22863,22869,15,15,32,7,7,18,39,63,-24,21,43,28
32723,22863,22869,45,17,32,5,9,18,43,74,-31,19,45,24
32724,22863,22869,28,12,32,11,9,12,36,36,0,31,33,42
32725,22863,22869,25,7,32,14,7,11,60,52,8,35,29,49
32726,22863,22869,1,5,32,15,10,7,54,36,18,40,24,55
32727,22863,22869,22,1,32,22,5,5,71,33,38,49,15,71
32728,22863,22869,43,9,32,13,7,12,45,38,7,33,31,46
32729,22863,22869,57,10,32,11,11,10,44,43,1,33,31,44
32730,22863,22869,24,13,32,10,6,16,45,60,-15,26,38,36
32731,22863,22869,21,3,32,20,6,6,57,26,31,46,18,66
32732,22863,22869,4,4,32,16,7,9,62,35,27,39,25,55
32733,22863,22869,9,16,32,6,6,20,35,71,-36,18,46,24
32734,22863,22869,49,6,32,15,7,10,53,41,12,37,27,52
32735,22863,22869,16,11,32,11,9,12,49,46,3,31,33,42
32736,22863,22869,56,14,32,8,7,17,35,56,-21,23,41,31
32737,22863,22869,13,18,32,5,4,23,26,65,-39,14,50,19
32738,22877,22974,56,14,34,8,7,19,37,61,-24,23,45,31
32739,22877,22974,13,18,34,5,5,24,28,68,-40,15,53,20
32740,22877,22974,49,6,34,16,7,11,58,45,13,39,29,55
32741,22877,22974,16,10,34,13,9,12,56,48,8,35,33,48
32742,22877,22974,21,3,34,22,6,6,59,26,33,50,18,72
32743,22877,22974,4,5,34,16,8,10,64,38,26,40,28,56
32744,22877,22974,9,16,34,7,6,21,37,76,-39,20,48,27
32745,22877,22974,22,1,34,23,6,5,78,37,41,52,16,75
32746,22877,22974,57,8,34,13,11,10,50,46,4,37,31,50
32747,22877,22974,43,11,34,13,7,14,49,46,3,33,35,46
32748,22877,22974,24,13,34,11,7,16,49,63,-14,29,39,40
32749,22877,22974,1,4,34,16,11,7,61,36,25,43,25,59
32750,17032,17038,57,12,30,9,7,14,24,30,-6,25,35,34
32751,17032,17038,42,9,30,10,7,13,31,35,-4,27,33,37
32752,17032,17038,17,18,30,5,6,19,25,57,-32,16,44,21
32753,17032,17038,49,3,30,18,5,7,58,33,25,41,19,59
32754,17032,17038,46,14,30,6,14,10,34,42,-8,26,34,32
32755,17032,17038,37,17,30,5,9,16,28,51,-23,19,41,24
32756,17032,17038,27,5,30,13,9,8,42,36,6,35,25,48
32757,17032,17038,45,13,30,8,9,13,36,47,-11,25,35,33
32758,17032,17038,1,6,30,13,8,9,50,34,16,34,26,47
32759,17032,17038,4,4,30,16,5,9,49,36,13,37,23,53
32760,17039,17045,4,4,31,17,5,9,53,37,16,39,23,56
32761,17039,17045,1,6,31,13,8,10,51,36,15,34,28,47
32762,17039,17045,27,5,31,14,9,8,46,39,7,37,25,51
32763,17039,17045,45,10,31,9,9,13,38,48,-10,27,35,36
32764,17039,17045,49,3,31,18,6,7,60,35,25,42,20,60
32765,17039,17045,46,13,31,7,14,10,36,42,-6,28,34,35
32766,17039,17045,37,17,31,5,9,17,28,53,-25,19,43,24
32767,17039,17045,42,9,31,10,7,14,32,39,-7,27,35,37
32768,17039,17045,17,18,31,5,7,19,26,58,-32,17,45,22
32769,17039,17045,43,1,31,21,8,2,60,26,34,50,12,71
32770,17039,17045,22,2,31,21,6,4,69,32,37,48,14,69
32771,17039,17045,51,11,31,9,9,13,46,61,-15,27,35,36
32772,17039,17045,57,14,31,9,7,15,24,31,-7,25,37,34
32773,17039,17045,35,8,31,11,9,11,46,45,1,31,31,42
32774,17039,17045,33,12,31,8,11,12,43,52,-9,27,35,35
32775,17039,17045,28,15,31,8,8,15,34,46,-12,24,38,32
32776,17039,17045,25,7,31,12,8,11,38,38,0,32,30,44
32777,17039,17045,12,16,31,5,14,12,30,42,-12,24,38,29
32778,17235,17255,12,10,13,5,4,4,11,10,1,14,12,19
32779,17235,17255,25,13,13,4,3,6,15,13,2,11,15,15
32780,17235,17255,33,6,13,6,3,4,21,14,7,15,11,21
32781,17235,17255,28,17,13,2,1,10,10,26,-16,5,21,7
32782,17235,17255,35,7,13,6,3,4,18,13,5,15,11,21
32783,17235,17255,42,15,13,2,3,8,15,23,-8,7,19,9
32784,17235,17255,1,1,13,9,3,1,21,11,10,21,5,30
32785,17235,17255,57,3,13,7,3,3,27,13,14,17,9,24
32786,17235,17255,43,4,13,6,5,2,19,13,6,17,9,23
32787,17235,17255,22,5,13,6,5,2,16,15,1,17,9,23
32788,17235,17255,51,12,13,4,5,4,16,24,-8,13,13,17
32789,17235,17255,24,16,13,1,5,7,15,25,-10,7,19,8
32790,17235,17255,27,8,13,6,2,5,14,12,2,14,12,20
32791,17235,17255,45,11,13,5,3,5,17,19,-2,13,13,18
32792,17235,17255,4,9,13,5,5,3,26,16,10,15,11,20
32793,17235,17255,49,2,13,8,5,0,28,10,18,21,5,29
32794,17235,17255,46,14,13,3,1,9,11,25,-14,7,19,10
32795,17235,17255,23,18,13,1,3,9,8,26,-18,5,21,6
32796,17277,17304,4,6,17,7,6,4,34,23,11,20,14,27
32797,17277,17304,1,1,17,11,5,1,24,12,12,27,7,38
32798,17277,17304,33,9,17,6,4,7,23,24,-1,16,18,22
32799,17277,17304,28,16,17,3,2,12,14,33,-19,8,26,11
32800,17277,17304,45,8,17,7,3,7,24,28,-4,17,17,24
32801,17277,17304,27,13,17,6,2,9,19,25,-6,14,20,20
32802,17277,17304,49,2,17,10,7,0,36,12,24,27,7,37
32803,17277,17304,23,14,17,4,4,9,16,29,-13,12,22,16
32804,17277,17304,46,17,17,3,2,12,13,36,-23,8,26,11
32805,17277,17304,57,3,17,10,4,3,38,16,22,24,10,34
32806,17277,17304,22,5,17,8,5,4,27,22,5,21,13,29
32807,17277,17304,43,7,17,7,6,4,25,20,5,20,14,27
32808,17277,17304,51,12,17,5,6,6,24,32,-8,16,18,21
32809,17277,17304,24,15,17,3,6,8,22,31,-9,12,22,15
32810,17277,17304,12,10,17,5,7,5,16,17,-1,17,17,22
32811,17277,17304,25,11,17,5,6,6,20,16,4,16,18,21
32812,17277,17304,42,18,17,2,4,11,18,31,-13,8,26,10
32813,17277,17304,35,4,17,10,3,4,28,14,14,23,11,33
32814,17144,17150,35,8,2,1,0,1,2,2,0,2,2,3
32815,17144,17150,25,4,2,2,0,0,2,0,2,4,0,6
32816,17144,17150,12,8,2,1,0,1,2,2,0,2,2,3
32817,17144,17150,42,12,2,0,1,1,2,3,-1,1,3,1
32818,17144,17150,23,15,2,0,0,2,2,5,-3,0,4,0
32819,17144,17150,46,17,2,0,0,2,1,5,-4,0,4,0
32820,17144,17150,1,3,2,2,0,0,3,1,2,4,0,6
32821,17144,17150,43,4,2,2,0,0,2,0,2,4,0,6
32822,17144,17150,51,6,2,1,1,0,4,2,2,3,1,4
32823,17144,17150,57,7,2,1,0,1,3,3,0,2,2,3
32824,17144,17150,22,11,2,1,0,1,3,6,-3,2,2,3
32825,17144,17150,24,13,2,0,1,1,1,2,-1,1,3,1
32826,17144,17150,27,13,2,0,1,1,1,2,-1,1,3,1
32827,17144,17150,45,18,2,0,0,2,1,6,-5,0,4,0
32828,17144,17150,33,10,2,1,0,1,3,4,-1,2,2,3
32829,20987,20993,49,8,27,9,10,8,36,36,0,28,26,37
32830,20987,20993,1,1,27,18,6,3,64,31,33,42,12,60
32831,20847,20860,1,1,9,8,0,1,22,7,15,16,2,24
32832,20847,20860,49,12,9,2,3,4,6,14,-8,7,11,9
32833,20847,20860,27,2,9,6,2,1,16,8,8,14,4,20
32834,20847,20860,45,4,9,5,1,3,20,11,9,11,7,16
32835,20847,20860,10,8,9,3,3,3,21,14,7,9,9,12
32836,20847,20860,15,16,9,1,2,6,11,26,-15,4,14,5
32837,20847,20860,12,9,9,3,1,5,13,16,-3,7,11,10
32838,20847,20860,56,11,9,2,3,4,10,14,-4,7,11,9
32839,20847,20860,38,3,9,5,2,2,17,15,2,12,6,17
32840,20847,20860,28,5,9,5,1,3,11,11,0,11,7,16
32841,20847,20860,21,6,9,4,3,2,15,14,1,11,7,15
32842,20847,20860,4,14,9,1,3,5,9,12,-3,5,13,6
32843,20847,20860,9,15,9,1,2,6,8,16,-8,4,14,5
32844,20847,20860,43,7,9,4,3,2,11,10,1,11,7,15
32845,20847,20860,22,10,9,2,4,3,16,16,0,8,10,10
32846,20847,20860,24,13,9,1,5,3,10,12,-2,7,11,8
32847,21232,21238,22,1,11,9,2,0,33,11,22,20,2,29
32848,21232,21238,43,3,11,7,2,2,23,12,11,16,6,23
32849,21232,21238,57,11,11,3,3,5,13,22,-9,9,13,12
32850,21232,21238,49,5,11,5,4,2,17,10,7,14,8,19
32851,21232,21238,21,4,11,6,4,1,16,9,7,16,6,22
32852,21232,21238,4,6,11,5,2,4,23,21,2,12,10,17
32853,21232,21238,9,10,11,4,2,5,14,21,-7,10,12,14
32854,21232,21238,56,9,11,4,2,5,16,18,-2,10,12,14
32855,21232,21238,12,15,11,1,2,8,9,22,-13,4,18,5
32856,21232,21238,28,7,11,4,5,2,15,12,3,13,9,17
32857,21232,21238,38,14,11,1,2,8,4,16,-12,4,18,5
32858,21232,21238,27,8,11,4,2,5,16,16,0,10,12,14
32859,21232,21238,15,12,11,3,1,7,14,24,-10,7,15,10
32860,21232,21238,10,13,11,1,7,3,13,15,-2,9,13,10
32861,21232,21238,45,16,11,1,2,8,15,30,-15,4,18,5
32862,21232,21238,1,2,11,8,2,1,29,11,18,18,4,26
32863,21666,21686,1,1,21,15,5,1,46,8,38,35,7,50
32864,21666,21686,49,5,21,10,5,6,37,23,14,25,17,35
32865,21666,21686,4,3,21,11,6,4,40,23,17,28,14,39
32866,21666,21686,21,4,21,11,6,4,39,25,14,28,14,39
32867,21666,21686,9,14,21,5,3,13,22,41,-19,13,29,18
32868,21666,21686,56,12,21,6,4,11,28,34,-6,16,26,22
32869,21666,21686,38,10,21,6,9,6,29,28,1,21,21,27
32870,21666,21686,28,11,21,6,5,10,22,38,-16,17,25,23
32871,21666,21686,27,2,21,11,7,3,35,17,18,29,13,40
32872,21666,21686,45,7,21,9,4,8,31,28,3,22,20,31
32873,21666,21686,15,13,21,5,4,12,17,34,-17,14,28,19
32874,21666,21686,10,15,21,4,5,12,18,42,-24,13,29,17
32875,21666,21686,24,6,21,10,4,7,31,31,0,24,18,34
32876,21666,21686,22,8,21,9,4,8,32,30,2,22,20,31
32877,21666,21686,43,9,21,6,9,6,24,22,2,21,21,27
32878,21666,21686,57,16,21,3,2,16,18,45,-27,8,34,11
32879,21526,21532,21,4,3,2,0,1,9,4,5,4,2,6
32880,21526,21532,9,6,3,2,0,1,5,4,1,4,2,6
32881,21526,21532,4,8,3,1,1,1,8,4,4,3,3,4
32882,21526,21532,38,3,3,2,1,0,3,1,2,5,1,7
32883,21526,21532,28,12,3,1,0,2,2,8,-6,2,4,3
32884,21526,21532,49,5,3,2,0,1,7,2,5,4,2,6
32885,21526,21532,24,2,3,2,1,0,5,1,4,5,1,7
32886,21526,21532,22,10,3,1,0,2,3,6,-3,2,4,3
32887,21526,21532,43,13,3,0,2,1,1,2,-1,2,4,2
32888,21526,21532,57,16,3,0,0,3,2,8,-6,0,6,0
32889,21526,21532,27,7,3,1,2,0,4,3,1,4,2,5
32890,21526,21532,45,11,3,1,0,2,2,6,-4,2,4,3
32891,21526,21532,10,14,3,0,1,2,3,8,-5,1,5,1
32892,21526,21532,15,15,3,0,1,2,3,11,-8,1,5,1
32893,21526,21532,56,9,3,1,1,1,5,4,1,3,3,4
32894,21526,21532,1,1,3,3,0,0,11,1,10,6,0,9
32895,21575,21581,1,1,9,6,3,0,21,3,18,15,3,21
32896,21575,21581,24,7,9,4,2,3,14,16,-2,10,8,14
32897,21575,21581,43,13,9,1,3,5,6,11,-5,5,13,6
32898,21575,21581,57,16,9,1,0,8,8,21,-13,2,16,3
32899,21575,21581,49,2,9,6,1,2,21,7,14,13,5,19
32900,21575,21581,21,3,9,6,1,2,20,11,9,13,5,19
32901,21575,21581,4,4,9,5,2,2,22,11,11,12,6,17
32902,21575,21581,9,11,9,3,2,4,12,17,-5,8,10,11
32903,21575,21581,56,12,9,2,2,5,14,17,-3,6,12,8
32904,21575,21581,38,5,9,4,4,1,13,10,3,12,6,16
32905,21575,21581,28,10,9,3,3,3,11,14,-3,9,9,12
32906,21575,21581,27,8,9,3,4,2,12,11,1,10,8,13
32907,21575,21581,45,9,9,3,4,2,12,12,0,10,8,13
32908,21575,21581,15,14,9,1,3,5,6,20,-14,5,13,6
32909,21575,21581,10,15,9,0,4,5,5,19,-14,4,14,4
32910,22331,22337,24,5,12,6,2,4,21,21,0,14,10,20
32911,22331,22337,43,6,12,5,5,2,25,16,9,15,9,20
32912,22331,22337,22,10,12,5,2,5,21,20,1,12,12,17
32913,22331,22337,57,17,12,2,3,7,13,19,-6,7,17,9
32914,22331,22337,56,8,12,5,3,4,15,14,1,13,11,18
32915,22331,22337,13,16,12,4,0,8,16,24,-8,8,16,12
32916,22331,22337,21,3,12,6,3,3,22,16,6,15,9,21
32917,22331,22337,4,9,12,5,2,5,21,13,8,12,12,17
32918,22331,22337,9,11,12,5,2,5,16,20,-4,12,12,17
32919,22331,22337,28,12,12,4,3,5,13,18,-5,11,13,15
32920,22331,22337,39,1,12,8,1,3,27,13,14,17,7,25
32921,22331,22337,15,4,12,6,2,4,23,17,6,14,10,20
32922,22331,22337,27,7,12,5,5,2,22,14,8,15,9,20
32923,22331,22337,45,14,12,3,4,5,19,26,-7,10,14,13
32924,22331,22337,53,18,12,0,2,10,9,27,-18,2,22,2
32925,22331,22337,49,13,12,4,3,5,13,20,-7,11,13,15
32926,22331,22337,16,15,12,2,7,3,15,20,-5,11,13,13
32927,22345,22358,53,18,14,1,3,10,13,28,-15,5,23,6
32928,22345,22358,39,1,14,10,1,3,33,13,20,21,7,31
32929,22345,22358,27,5,14,6,5,3,25,18,7,17,11,23
32930,22345,22358,15,7,14,6,3,5,24,21,3,15,13,21
32931,22345,22358,45,15,14,3,5,6,22,33,-11,11,17,14
32932,22345,22358,28,11,14,5,3,6,15,20,-5,13,15,18
32933,22345,22358,49,13,14,4,5,5,16,23,-7,13,15,17
32934,22345,22358,21,2,14,8,3,3,25,16,9,19,9,27
32935,22345,22358,4,10,14,5,3,6,21,15,6,13,15,18
32936,22345,22358,9,12,14,5,2,7,18,25,-7,12,16,17
32937,22345,22358,16,14,14,3,8,3,18,22,-4,14,14,17
32938,22345,22358,56,9,14,5,5,4,17,16,1,15,13,20
32939,22345,22358,13,16,14,4,1,9,16,27,-11,9,19,13
32940,22345,22358,24,4,14,7,2,5,25,24,1,16,12,23
32941,22345,22358,22,6,14,6,3,5,28,23,5,15,13,21
32942,22345,22358,43,8,14,5,6,3,27,20,7,16,12,21
32943,22345,22358,57,17,14,2,4,8,14,21,-7,8,20,10
32944,22345,22358,1,3,14,7,6,1,25,17,8,20,8,27
32945,22422,22425,1,3,23,12,8,3,45,30,15,32,14,44
32946,22422,22425,43,4,23,11,9,3,52,27,25,31,15,42
32947,22422,22425,24,7,23,10,3,10,37,43,-6,23,23,33
32948,22422,22425,22,9,23,9,5,9,45,36,9,23,23,32
32949,22422,22425,57,10,23,9,4,10,33,29,4,22,24,31
32950,22422,22425,56,8,23,8,9,6,29,27,2,25,21,33
32951,22422,22425,13,17,23,6,1,16,24,49,-25,13,33,19
32952,22422,22425,16,11,23,7,8,8,35,37,-2,22,24,29
32953,22422,22425,49,12,23,7,7,9,26,37,-11,21,25,28
32954,22422,22425,21,2,23,14,4,5,44,25,19,32,14,46
32955,22422,22425,4,5,23,10,6,7,35,24,11,26,20,36
32956,22422,22425,9,15,23,7,3,13,24,45,-21,17,29,24
32957,22422,22425,28,13,23,8,3,12,25,34,-9,19,27,27
32958,22422,22425,53,18,23,3,3,17,19,47,-28,9,37,12
32959,22422,22425,39,1,23,17,2,4,56,21,35,36,10,53
32960,22422,22425,27,6,23,10,6,7,38,32,6,26,20,36
32961,22422,22425,15,14,23,7,5,11,31,39,-8,19,27,26
32962,22422,22425,45,16,23,6,6,11,32,48,-16,18,28,24
32963,22471,22477,53,18,31,4,4,23,30,65,-35,12,50,16
32964,22471,22477,39,1,31,22,4,5,69,25,44,48,14,70
32965,22471,22477,27,7,31,13,9,9,47,42,5,35,27,48
32966,22471,22477,45,15,31,8,8,15,42,63,-21,24,38,32
32967,22471,22477,15,16,31,8,7,16,36,53,-17,23,39,31
32968,22471,22477,28,10,31,12,6,13,34,38,-4,30,32,42
32969,22471,22477,21,4,31,17,5,9,52,37,15,39,23,56
32970,22471,22477,4,5,31,16,7,8,48,28,20,39,23,55
32971,22471,22477,9,14,31,9,5,17,29,58,-29,23,39,32
32972,22471,22477,16,11,31,10,10,11,46,51,-5,30,32,40
32973,22471,22477,49,13,31,8,9,14,30,45,-15,25,37,33
32974,22471,22477,56,12,31,9,10,12,39,41,-2,28,34,37
32975,22471,22477,13,17,31,8,2,21,27,63,-36,18,44,26
32976,22471,22477,43,3,31,16,10,5,65,33,32,42,20,58
32977,22471,22477,24,6,31,14,6,11,53,56,-3,34,28,48
32978,22471,22477,22,8,31,13,6,12,58,44,14,32,30,45
32979,22471,22477,57,9,31,12,7,12,46,38,8,31,31,43
32980,22471,22477,1,2,31,18,9,4,64,35,29,45,17,63
32981,22692,22694,1,3,13,9,1,3,26,12,14,19,7,28
32982,22692,22694,22,1,13,11,1,1,33,12,21,23,3,34
32983,22692,22694,43,9,13,5,1,7,21,16,5,11,15,16
32984,22692,22694,57,12,13,4,3,6,16,21,-5,11,15,15
32985,22692,22694,24,13,13,4,2,7,19,24,-5,10,16,14
32986,22692,22694,21,2,13,11,0,2,27,11,16,22,4,33
32987,22692,22694,4,6,13,6,2,5,23,16,7,14,12,20
32988,17333,17339,4,6,22,10,7,5,44,30,14,27,17,37
32989,17333,17339,33,13,22,6,5,11,25,32,-7,17,27,23
32990,17333,17339,28,17,22,3,6,13,18,38,-20,12,32,15
32991,17333,17339,42,16,22,4,5,13,22,35,-13,13,31,17
32992,17333,17339,1,1,22,14,6,2,32,15,17,34,10,48
32993,17347,17353,1,2,24,15,6,3,33,17,16,36,12,51
32994,17347,17353,42,16,24,4,7,13,25,38,-13,15,33,19
32995,17347,17353,33,15,24,6,6,12,25,33,-8,18,30,24
32996,17347,17353,28,17,24,4,7,13,20,39,-19,15,33,19
32997,17347,17353,4,6,24,11,8,5,45,30,15,30,18,41
32998,17347,17353,45,7,24,9,5,10,30,38,-8,23,25,32
32999,17347,17353,27,10,24,8,6,10,25,29,-4,22,26,30
33000,17347,17353,35,4,24,13,6,5,36,19,17,32,16,45
33001,17347,17353,57,3,24,13,6,5,52,25,27,32,16,45
33002,17347,17353,43,5,24,12,7,5,34,24,10,31,17,43
33003,17347,17353,22,9,24,8,7,9,33,37,-4,23,25,31
33004,17347,17353,24,11,24,7,7,10,29,36,-7,21,27,28
33005,17347,17353,51,12,24,6,9,9,28,37,-9,21,27,27
33006,17347,17353,49,1,24,14,10,0,45,15,30,38,10,52
33007,17347,17353,23,14,24,7,5,12,26,39,-13,19,29,26
33008,17347,17353,46,18,24,3,4,17,19,53,-34,10,38,13
33009,17347,17353,25,8,24,8,8,8,34,27,7,24,24,32
33010,17347,17353,12,13,24,5,12,7,20,23,-3,22,26,27
33011,17179,17185,49,1,6,5,1,0,19,5,14,11,1,16
33012,17179,17185,23,14,6,1,2,3,5,10,-5,4,8,5
33013,17179,17185,46,17,6,0,1,5,2,12,-10,1,11,1
33014,17179,17185,43,2,6,4,2,0,11,5,6,10,2,14
33015,17179,17185,22,3,6,4,1,1,8,8,0,9,3,13
33016,17179,17185,57,4,6,4,0,2,13,8,5,8,4,12
33017,17179,17185,51,13,6,1,3,2,4,8,-4,5,7,6
33018,17179,17185,24,16,6,0,3,3,5,9,-4,3,9,3
33019,17179,17185,35,11,6,2,1,3,5,6,-1,5,7,7
33020,17179,17185,27,8,6,3,1,2,8,5,3,7,5,10
33021,17179,17185,45,10,6,2,2,2,7,10,-3,6,6,8
33022,17179,17185,4,5,6,3,2,1,14,7,7,8,4,11
33023,17179,17185,1,7,6,3,2,1,9,7,2,8,4,11
33024,17179,17185,33,9,6,3,1,2,11,9,2,7,5,10
33025,17179,17185,28,18,6,0,0,6,5,13,-8,0,12,0
33026,17179,17185,12,6,6,3,2,1,7,4,3,8,4,11
33027,17179,17185,25,12,6,2,1,3,2,4,-2,5,7,7
33028,17179,17185,42,15,6,1,1,4,6,11,-5,3,9,4
33029,17627,17633,42,13,15,3,5,7,16,20,-4,11,19,14
33030,17627,17633,56,11,15,5,5,5,17,23,-6,15,15,20
33031,17627,17633,35,16,15,2,6,7,15,21,-6,10,20,12
33032,17627,17633,1,2,15,9,4,2,27,14,13,22,8,31
33033,17627,17633,12,6,15,6,7,2,19,11,8,19,11,25
33034,17627,17633,49,3,15,8,4,3,24,15,9,20,10,28
33035,17627,17633,23,14,15,3,5,7,20,30,-10,11,19,14
33036,17627,17633,33,7,15,7,3,5,22,19,3,17,13,24
33037,17627,17633,4,9,15,6,4,5,31,21,10,16,14,22
33038,17627,17633,57,8,15,7,1,7,23,24,-1,15,15,22
33039,17627,17633,24,15,15,3,5,7,15,25,-10,11,19,14
33040,17627,17633,32,17,15,3,2,10,18,33,-15,8,22,11
33041,17627,17633,51,18,15,2,4,9,10,26,-16,8,22,10
33042,17627,17633,43,1,15,10,2,3,38,17,21,22,8,32
33043,17627,17633,22,4,15,8,3,4,25,20,5,19,11,27
33044,17627,17633,45,10,15,6,2,7,21,20,1,14,16,20
33045,17627,17633,27,12,15,5,3,7,20,25,-5,13,17,18
33046,17627,17633,25,5,15,8,3,4,21,18,3,19,11,27
33047,17753,17759,45,7,29,13,6,10,45,34,11,32,26,45
33048,17753,17759,27,13,29,9,7,13,35,42,-7,25,33,34
33049,17753,17759,35,12,29,9,9,11,38,36,2,27,31,36
33050,17753,17759,4,4,29,14,7,8,58,37,21,35,23,49
33051,17753,17759,43,1,29,20,4,5,64,28,36,44,14,64
33052,17753,17759,22,5,29,14,4,11,44,42,2,32,26,46
33053,17753,17759,24,10,29,10,10,9,39,43,-4,30,28,40
33054,17753,17759,57,11,29,11,5,13,41,47,-6,27,31,38
33055,17753,17759,51,15,29,8,6,15,29,47,-18,22,36,30
33056,17753,17759,32,17,29,5,3,21,27,72,-45,13,45,18
33057,17753,17759,33,9,29,11,8,10,38,36,2,30,28,41
33058,17753,17759,49,2,29,20,4,5,56,25,31,44,14,64
33059,17753,17759,23,16,29,7,7,15,38,51,-13,21,37,28
33060,17753,17759,25,6,29,13,7,9,37,32,5,33,25,46
33061,17753,17759,12,8,29,10,12,7,33,25,8,32,26,42
33062,17753,17759,1,3,29,16,5,8,50,40,10,37,21,53
33063,17753,17759,42,18,29,3,8,18,28,48,-20,14,44,17
33064,17753,17759,56,14,29,7,10,12,30,45,-15,24,34,31
33065,17788,17864,42,18,34,3,10,21,31,57,-26,16,52,19
33066,17788,17864,1,3,34,18,5,11,59,50,9,41,27,59
33067,17144,17150,28,16,2,0,0,2,1,4,-3,0,4,0
33068,17144,17150,4,1,2,2,0,0,9,1,8,4,0,6
33069,17144,17150,49,2,2,2,0,0,8,2,6,4,0,6
33070,17319,17325,1,1,20,13,6,1,29,13,16,32,8,45
33071,17319,17325,4,5,20,9,7,4,40,26,14,25,15,34
33072,17319,17325,33,12,20,6,5,9,23,28,-5,17,23,23
33073,17319,17325,28,16,20,3,5,12,16,35,-19,11,29,14
33074,17319,17325,45,9,20,7,4,9,26,35,-9,18,22,25
33075,17319,17325,27,11,20,7,3,10,22,28,-6,17,23,24
33076,17319,17325,25,8,20,6,8,6,29,20,9,20,20,26
33077,17319,17325,12,10,20,5,10,5,18,19,-1,20,20,25
33078,17319,17325,57,3,20,12,5,3,46,17,29,29,11,41
33079,17319,17325,43,6,20,9,7,4,27,20,7,25,15,34
33080,17319,17325,22,7,20,8,7,5,31,30,1,23,17,31
33081,17319,17325,51,13,20,5,7,8,26,36,-10,17,23,22
33082,17319,17325,24,14,20,5,6,9,25,32,-7,16,24,21
33083,17319,17325,49,2,20,12,8,0,40,13,27,32,8,44
33084,17319,17325,23,15,20,5,4,11,18,32,-14,14,26,19
33085,17319,17325,46,18,20,3,2,15,15,45,-30,8,32,11
33086,17319,17325,42,17,20,3,4,13,20,34,-14,10,30,13
33087,17319,17325,35,4,20,11,4,5,30,18,12,26,14,37
33088,17417,17514,25,9,34,12,9,13,43,37,6,33,35,45
33089,17417,17514,12,12,34,9,15,10,32,33,-1,33,35,42
33090,17417,17514,33,11,34,12,6,16,38,43,-5,30,38,42
33091,17417,17514,28,17,34,6,9,19,32,58,-26,21,47,27
33092,17417,17514,35,5,34,16,7,11,46,34,12,39,29,55
33093,17417,17514,45,7,34,13,8,13,47,54,-7,34,34,47
33094,17417,17514,27,8,34,13,7,14,41,45,-4,33,35,46
33095,17417,17514,42,16,34,7,12,15,37,45,-8,26,42,33
33096,17417,17514,1,3,34,20,7,7,45,30,15,47,21,67
33097,17417,17514,43,2,34,21,7,6,59,31,28,49,19,70
33098,17417,17514,57,4,34,17,9,8,62,33,29,43,25,60
33099,17417,17514,22,10,34,12,9,13,54,55,-1,33,35,45
33100,17417,17514,24,13,34,10,10,14,45,52,-7,30,38,40
33101,17417,17514,51,14,34,9,11,14,36,55,-19,29,39,38
33102,17417,17514,49,1,34,22,11,1,61,19,42,55,13,77
33103,17417,17514,23,15,34,9,6,19,33,59,-26,24,44,33
33104,17417,17514,46,18,34,4,7,23,27,66,-39,15,53,19
33105,17417,17514,4,6,34,14,10,10,57,46,11,38,30,52
33106,17200,17213,4,10,9,3,5,1,18,11,7,11,7,14
33107,17200,17213,1,2,9,5,3,1,14,9,5,13,5,18
33108,17200,17213,49,1,9,7,2,0,24,7,17,16,2,23
33109,17200,17213,46,15,9,2,1,6,6,15,-9,5,13,7
33110,17200,17213,23,16,9,1,3,5,7,16,-9,5,13,6
33111,17200,17213,27,7,9,4,2,3,11,9,2,10,8,14
33112,17200,17213,45,9,9,4,2,3,13,14,-1,10,8,14
33113,17200,17213,22,3,9,5,3,1,12,11,1,13,5,18
33114,17200,17213,57,4,9,5,2,2,20,11,9,12,6,17
33115,17200,17213,43,6,9,4,4,1,14,9,5,12,6,16
33116,17200,17213,51,11,9,2,5,2,10,13,-3,9,9,11
33117,17200,17213,24,17,9,0,4,5,8,15,-7,4,14,4
33118,17200,17213,42,14,9,2,2,5,11,14,-3,6,12,8
33119,17200,17213,35,12,9,2,3,4,9,12,-3,7,11,9
33120,17200,17213,33,5,9,5,1,3,16,11,5,11,7,16
33121,17200,17213,28,18,9,0,1,8,6,20,-14,1,17,1
33122,17200,17213,12,8,9,4,2,3,8,7,1,10,8,14
33123,17200,17213,25,13,9,2,3,4,5,8,-3,7,11,9
33124,17529,17542,25,6,3,2,0,1,2,3,-1,4,2,6
33125,17529,17542,12,7,3,1,1,1,4,2,2,3,3,4
33126,17529,17542,33,1,3,3,0,0,7,3,4,6,0,9
33127,17529,17542,56,10,3,1,1,1,4,7,-3,3,3,4
33128,17529,17542,35,15,3,0,2,1,2,3,-1,2,4,2
33129,17529,17542,45,8,3,1,1,1,2,2,0,3,3,4
33130,17529,17542,27,11,3,1,0,2,1,3,-2,2,4,3
33131,17529,17542,42,13,3,1,0,2,4,8,-4,2,4,3
33132,17529,17542,49,4,3,2,1,0,7,2,5,5,1,7
33133,17529,17542,23,16,3,0,1,2,3,6,-3,1,5,1
33134,17529,17542,1,4,3,2,1,0,7,2,5,5,1,7
33135,17529,17542,43,2,3,2,1,0,9,2,7,5,1,7
33136,17529,17542,22,9,3,1,1,1,3,4,-1,3,3,4
33137,17529,17542,57,12,3,1,0,2,3,6,-3,2,4,3
33138,17529,17542,51,14,3,0,2,1,3,4,-1,2,4,2
33139,17529,17542,4,2,3,2,1,0,9,2,7,5,1,7
33140,17529,17542,24,17,3,0,1,2,2,6,-4,1,5,1
33141,17529,17542,32,18,3,0,0,3,3,10,-7,0,6,0
33142,17774,17780,43,1,32,22,5,5,70,29,41,49,15,71
33143,17774,17780,22,7,32,15,5,12,48,46,2,35,29,50
33144,17774,17780,1,3,32,17,5,10,55,47,8,39,25,56
33145,17774,17780,4,4,32,16,8,8,65,41,24,40,24,56
33146,17774,17780,23,15,32,8,8,16,41,56,-15,24,40,32
33147,16808,16814,4,16,5,1,1,3,5,13,-8,3,7,4
33148,16808,16814,33,8,5,2,2,1,9,8,1,6,4,8
33149,16808,16814,28,14,5,1,1,3,6,9,-3,3,7,4
33150,17375,17381,33,11,28,9,6,13,33,38,-5,24,32,33
33151,17375,17381,28,17,28,4,8,16,23,45,-22,16,40,20
33152,17375,17381,4,6,28,12,8,8,49,40,9,32,24,44
33153,17375,17381,45,8,28,11,6,11,36,44,-8,28,28,39
33154,17375,17381,27,10,28,10,6,12,28,34,-6,26,30,36
33155,17375,17381,1,3,28,16,6,6,36,26,10,38,18,54
33156,17375,17381,42,16,28,7,7,14,34,41,-7,21,35,28
33157,17375,17381,35,5,28,14,6,8,40,26,14,34,22,48
33158,17375,17381,49,1,28,18,10,0,52,17,35,46,10,64
33159,17375,17381,23,15,28,8,5,15,28,45,-17,21,35,29
33160,17375,17381,46,18,28,4,4,20,22,57,-35,12,44,16
33161,17375,17381,43,2,28,16,7,5,47,27,20,39,17,55
33162,17375,17381,57,4,28,15,7,6,56,28,28,37,19,52
33163,17375,17381,22,9,28,10,8,10,45,44,1,28,28,38
33164,17375,17381,24,12,28,8,8,12,34,41,-7,24,32,32
33165,17375,17381,51,14,28,7,9,12,30,47,-17,23,33,30
33166,17375,17381,25,7,28,11,8,9,40,28,12,30,26,41
33167,17375,17381,12,13,28,6,13,9,21,26,-5,25,31,31
33168,17165,17178,35,13,5,1,1,3,4,6,-2,3,7,4
33169,17165,17178,49,1,5,5,0,0,18,4,14,10,0,15
33170,17165,17178,23,14,5,1,1,3,5,10,-5,3,7,4
33171,17165,17178,46,17,5,0,1,4,1,10,-9,1,9,1
33172,17165,17178,43,2,5,4,1,0,9,3,6,9,1,13
33173,17165,17178,22,7,5,3,1,1,6,7,-1,7,3,10
33174,17165,17178,57,8,5,3,0,2,11,8,3,6,4,9
33175,17165,17178,51,12,5,1,3,1,4,6,-2,5,5,6
33176,17165,17178,24,15,5,0,2,3,3,7,-4,2,8,2
33177,17165,17178,42,16,5,0,1,4,4,10,-6,1,9,1
33178,17165,17178,27,4,5,3,1,1,8,4,4,7,3,10
33179,17165,17178,45,10,5,2,1,2,5,8,-3,5,5,7
33180,17165,17178,1,6,5,3,1,1,8,6,2,7,3,10
33181,17165,17178,4,3,5,3,1,1,13,6,7,7,3,10
33182,17165,17178,33,9,5,3,0,2,9,7,2,6,4,9
33183,17165,17178,28,18,5,0,0,5,4,11,-7,0,10,0
33184,17165,17178,12,5,5,3,1,1,6,3,3,7,3,10
33185,17165,17178,25,11,5,2,0,3,2,4,-2,4,6,6
33186,17620,17626,25,5,14,8,3,3,21,17,4,19,9,27
33187,17620,17626,12,8,14,5,7,2,17,11,6,17,11,22
33188,17620,17626,49,3,14,8,4,2,23,13,10,20,8,28
33189,17620,17626,23,13,14,3,5,6,18,25,-7,11,17,14
33190,17620,17626,33,6,14,7,3,4,22,16,6,17,11,24
33191,17620,17626,4,7,14,6,4,4,30,18,12,16,12,22
33192,17620,17626,1,1,14,9,4,1,27,12,15,22,6,31
33193,17620,17626,35,17,14,1,6,7,12,21,-9,8,20,9
33194,17620,17626,27,10,14,5,3,6,19,23,-4,13,15,18
33195,17620,17626,45,11,14,5,2,7,19,19,0,12,16,17
33196,17620,17626,42,15,14,2,5,7,11,18,-7,9,19,11
33197,17620,17626,56,12,14,4,5,5,14,22,-8,13,15,17
33198,17620,17626,43,2,14,9,2,3,33,16,17,20,8,29
33199,17620,17626,22,4,14,8,3,3,24,17,7,19,9,27
33200,17620,17626,57,9,14,6,1,7,20,23,-3,13,15,19
33201,17620,17626,32,14,14,3,2,9,17,28,-11,8,20,11
33202,17620,17626,24,16,14,2,5,7,13,24,-11,9,19,11
33203,17620,17626,51,18,14,1,4,9,9,26,-17,6,22,7
33204,17669,17675,43,1,18,12,2,4,44,19,25,26,10,38
33205,17669,17675,57,4,18,10,1,7,31,29,2,21,15,31
33206,17669,17675,22,6,18,9,3,6,27,26,1,21,15,30
33207,17669,17675,24,14,18,4,6,8,19,31,-12,14,22,18
33208,17669,17675,32,15,18,4,3,11,21,37,-16,11,25,15
33209,17669,17675,51,18,18,2,4,12,14,35,-21,8,28,10
33210,17669,17675,56,10,18,6,7,5,20,25,-5,19,17,25
33211,17669,17675,35,13,18,4,6,8,22,24,-2,14,22,18
33212,17669,17675,45,11,18,7,3,8,26,25,1,17,19,24
33213,17669,17675,27,12,18,6,3,9,23,28,-5,15,21,21
33214,17669,17675,49,2,18,11,4,3,33,19,14,26,10,37
33215,17669,17675,42,16,18,3,6,9,20,26,-6,12,24,15
33216,17669,17675,4,9,18,7,5,6,35,25,10,19,17,26
33217,17669,17675,1,3,18,10,4,4,32,23,9,24,12,34
33218,17669,17675,33,8,18,8,4,6,29,23,6,20,16,28
33219,17669,17675,25,5,18,9,4,5,24,21,3,22,14,31
33220,17669,17675,12,7,18,7,9,2,24,15,9,23,13,30
33221,17669,17675,23,17,18,3,6,9,23,36,-13,12,24,15
33222,17704,17710,25,6,23,10,6,7,27,25,2,26,20,36
33223,17704,17710,12,8,23,8,10,5,28,21,7,26,20,34
33224,17704,17710,49,2,23,15,4,4,45,23,22,34,12,49
33225,17704,17710,23,16,23,4,6,13,26,42,-16,14,32,18
33226,17704,17710,33,10,23,8,7,8,32,30,2,23,23,31
33227,22877,22974,25,7,34,14,9,11,61,53,8,37,31,51
33228,22877,22974,28,12,34,11,9,14,37,40,-3,31,37,42
33229,22877,22974,39,2,34,23,6,5,70,41,29,52,16,75
33230,22877,22974,27,9,34,14,6,14,45,52,-7,34,34,48
33231,22877,22974,15,15,34,7,7,20,40,75,-35,21,47,28
33232,22877,22974,45,17,34,6,9,19,50,78,-28,21,47,27
33233,22660,22673,39,6,9,5,1,3,14,14,0,11,7,16
33234,22660,22673,27,10,9,4,0,5,15,16,-1,8,10,12
33235,22660,22673,15,15,9,2,0,7,8,16,-8,4,14,6
33236,22660,22673,45,18,9,1,2,6,7,18,-11,4,14,5
33237,22660,22673,25,11,9,4,0,5,16,18,-2,8,10,12
33238,22660,22673,1,3,9,6,1,2,19,10,9,13,5,19
33239,22660,22673,22,2,9,7,1,1,22,9,13,15,3,22
33240,22660,22673,43,8,9,4,1,4,16,10,6,9,9,13
33241,22660,22673,24,12,9,3,2,4,16,15,1,8,10,11
33242,22660,22673,57,17,9,1,3,5,5,15,-10,5,13,6
33243,22660,22673,21,1,9,9,0,0,21,6,15,18,0,27
33244,22660,22673,4,7,9,4,2,3,13,10,3,10,8,14
33245,22660,22673,9,13,9,3,1,5,10,13,-3,7,11,10
33246,22660,22673,56,14,9,2,1,6,6,15,-9,5,13,7
33247,22660,22673,13,16,9,2,0,7,8,18,-10,4,14,6
33248,22660,22673,28,9,9,3,4,2,10,8,2,10,8,13
33249,22660,22673,16,4,9,5,2,2,16,13,3,12,6,17
33250,22660,22673,49,5,9,5,1,3,15,13,2,11,7,16
33251,22975,22981,56,12,1,0,0,1,2,3,-1,0,2,0
33252,22975,22981,16,8,1,0,1,0,1,1,0,1,1,1
33253,22975,22981,49,13,1,0,0,1,0,1,-1,0,2,0
33254,22975,22981,4,3,1,1,0,0,3,2,1,2,0,3
33255,22975,22981,21,4,1,1,0,0,1,0,1,2,0,3
33256,22975,22981,1,8,1,0,1,0,1,1,0,1,1,1
33257,22975,22981,22,1,1,1,0,0,4,0,4,2,0,3
33258,22975,22981,24,8,1,0,1,0,1,1,0,1,1,1
33259,22975,22981,57,13,1,0,0,1,0,1,-1,0,2,0
33260,22975,22981,43,15,1,0,0,1,0,2,-2,0,2,0
33261,22975,22981,39,2,1,1,0,0,2,0,2,2,0,3
33262,22975,22981,15,6,1,0,1,0,2,2,0,1,1,1
33263,22975,22981,27,8,1,0,1,0,1,1,0,1,1,1
33264,22975,22981,28,4,1,1,0,0,1,0,1,2,0,3
33265,22975,22981,25,6,1,0,1,0,2,2,0,1,1,1
33266,22975,22981,55,16,1,0,0,1,0,4,-4,0,2,0
33267,23010,23023,55,11,6,2,1,3,7,16,-9,5,7,7
33268,23010,23023,25,15,6,0,1,5,7,13,-6,1,11,1
33269,23010,23023,28,10,6,2,2,2,5,6,-1,6,6,8
33270,23010,23023,15,7,6,3,1,2,9,10,-1,7,5,10
33271,23010,23023,27,13,6,0,4,2,4,7,-3,4,8,4
33272,23010,23023,43,3,6,4,1,1,7,5,2,9,3,13
33273,23010,23023,57,4,6,4,0,2,7,3,4,8,4,12
33274,23010,23023,24,6,6,3,1,2,9,5,4,7,5,10
33275,23010,23023,22,9,6,2,3,1,7,3,4,7,5,9
33276,23010,23023,1,5,6,3,2,1,16,5,11,8,4,11
33277,23010,23023,16,12,6,1,2,3,8,12,-4,4,8,5
33278,23010,23023,49,14,6,0,3,3,3,6,-3,3,9,3
33279,23010,23023,56,16,6,0,1,5,4,17,-13,1,11,1
33280,23010,23023,4,1,6,4,2,0,11,6,5,10,2,14
33281,23010,23023,21,8,6,2,3,1,10,4,6,7,5,9
33282,23010,23023,39,2,6,4,1,1,13,9,4,9,3,13
33283,23031,23037,4,1,8,5,3,0,14,8,6,13,3,18
33284,23031,23037,21,5,8,3,4,1,13,4,9,10,6,13
33285,23031,23037,56,16,8,0,2,6,6,20,-14,2,14,2
33286,23031,23037,16,12,8,2,3,3,11,14,-3,7,9,9
33287,23031,23037,49,13,8,1,4,3,6,7,-1,6,10,7
33288,23031,23037,1,3,8,4,3,1,21,8,13,11,5,15
33289,23031,23037,43,4,8,4,3,1,10,8,2,11,5,15
33290,23031,23037,22,6,8,3,4,1,12,6,6,10,6,13
33291,23031,23037,57,7,8,4,0,4,8,7,1,8,8,12
33292,23031,23037,24,10,8,3,1,4,10,9,1,7,9,10
33293,23031,23037,39,2,8,5,1,2,15,11,4,11,5,16
33294,23031,23037,15,11,8,3,1,4,11,15,-4,7,9,10
33295,23031,23037,27,14,8,1,4,3,7,11,-4,6,10,7
33296,23031,23037,28,8,8,3,3,2,10,9,1,9,7,12
33297,23031,23037,55,9,8,3,2,3,9,17,-8,8,8,11
33298,23031,23037,25,15,8,0,2,6,7,16,-9,2,14,2
33299,22692,22694,9,17,13,3,2,8,13,25,-12,8,18,11
33300,22692,22694,13,15,13,3,2,8,13,22,-9,8,18,11
33301,22692,22694,56,16,13,3,2,8,12,23,-11,8,18,11
33302,22692,22694,39,4,13,9,1,3,27,16,11,19,7,28
33303,22692,22694,27,10,13,5,1,7,19,21,-2,11,15,16
33304,22692,22694,15,14,13,4,0,9,14,27,-13,8,18,12
33305,22692,22694,45,18,13,3,2,8,15,28,-13,8,18,11
33306,22692,22694,28,11,13,4,4,5,12,15,-3,12,14,16
33307,22692,22694,25,8,13,6,1,6,23,26,-3,13,13,19
33308,22692,22694,49,5,13,7,1,5,19,17,2,15,11,22
33309,22692,22694,16,7,13,6,2,5,23,23,0,14,12,20
33310,22702,22708,49,5,15,9,1,5,27,17,10,19,11,28
33311,22702,22708,16,8,15,6,4,5,24,24,0,16,14,22
33312,22702,22708,25,7,15,7,1,7,27,29,-2,15,15,22
33313,22702,22708,28,9,15,5,5,5,15,17,-2,15,15,20
33314,22702,22708,39,4,15,10,2,3,31,19,12,22,8,32
33315,22702,22708,27,11,15,6,1,8,21,25,-4,13,17,19
33316,22702,22708,15,15,15,4,0,11,17,33,-16,8,22,12
33317,22702,22708,45,18,15,3,2,10,16,33,-17,8,22,11
33318,22702,22708,56,16,15,3,3,9,13,26,-13,9,21,12
33319,22702,22708,13,17,15,3,2,10,15,26,-11,8,22,11
33320,22702,22708,21,2,15,11,0,4,28,15,13,22,8,33
33321,22702,22708,4,6,15,7,3,5,26,18,8,17,13,24
33322,22702,22708,9,14,15,4,2,9,17,30,-13,10,20,14
33323,22702,22708,22,1,15,13,1,1,39,14,25,27,3,40
33324,22702,22708,43,10,15,6,1,8,25,23,2,13,17,19
33325,22702,22708,57,12,15,5,4,6,21,23,-2,14,16,19
33326,22702,22708,24,13,15,5,2,8,22,28,-6,12,18,17
33327,22702,22708,1,3,15,10,2,3,32,16,16,22,8,32
33328,23066,23072,1,6,12,5,4,3,25,13,12,14,10,19
33329,23066,23072,43,2,12,7,3,2,23,14,9,17,7,24
33330,23066,23072,57,4,12,7,0,5,16,11,5,14,10,21
33331,23066,23072,22,5,12,5,6,1,23,10,13,16,8,21
33332,23066,23072,24,14,12,3,2,7,11,18,-7,8,16,11
33333,23066,23072,4,3,12,6,5,1,19,13,6,17,7,23
33334,23066,23072,21,7,12,4,5,3,20,10,10,13,11,17
33335,23066,23072,56,15,12,2,2,8,9,25,-16,6,18,8
33336,23066,23072,49,8,12,4,4,4,14,14,0,12,12,16
33337,23066,23072,16,13,12,3,3,6,19,24,-5,9,15,12
33338,23066,23072,39,1,12,9,1,2,29,14,15,19,5,28
33339,23066,23072,15,10,12,4,1,7,16,26,-10,9,15,13
33340,23066,23072,27,11,12,3,4,5,13,19,-6,10,14,13
33341,23066,23072,55,12,12,3,4,5,13,23,-10,10,14,13
33342,23066,23072,25,16,12,1,4,7,13,23,-10,6,18,7
33343,23066,23072,28,9,12,4,4,4,13,19,-6,12,12,16
33344,23199,23205,28,9,29,9,10,10,33,45,-12,28,30,37
33345,23199,23205,25,11,29,7,8,14,41,53,-12,22,36,29
33346,23199,23205,55,15,29,5,8,16,31,63,-32,18,40,23
33347,23199,23205,39,1,29,21,6,2,62,30,32,48,10,69
33348,23199,23205,27,12,29,7,8,14,26,43,-17,22,36,29
33349,23199,23205,15,14,29,7,3,19,24,54,-30,17,41,24
33350,23199,23205,49,10,29,7,10,12,29,41,-12,24,34,31
33351,23199,23205,16,13,29,6,8,15,33,47,-14,20,38,26
33352,23199,23205,56,16,29,5,6,18,21,57,-36,16,42,21
33353,23199,23205,21,4,29,14,9,6,54,26,28,37,21,51
33354,23199,23205,4,8,29,11,11,7,48,38,10,33,25,44
33355,23199,23205,43,2,29,18,9,2,58,29,29,45,13,63
33356,23199,23205,22,5,29,12,10,7,50,30,20,34,24,46
33357,23199,23205,24,6,29,13,6,10,39,33,6,32,26,45
33358,23199,23205,57,7,29,13,5,11,40,34,6,31,27,44
33359,23199,23205,1,3,29,14,9,6,61,27,34,37,21,51
33360,21575,21581,22,6,9,4,2,3,16,13,3,10,8,14
33361,22065,22071,27,4,23,11,4,8,36,28,8,26,20,37
33362,22065,22071,28,13,23,7,6,10,30,35,-5,20,26,27
33363,22065,22071,38,15,23,6,7,10,22,32,-10,19,27,25
33364,22065,22071,45,10,23,9,3,11,35,42,-7,21,25,30
33365,22065,22071,15,16,23,5,10,8,25,38,-13,20,26,25
33366,22065,22071,10,18,23,5,5,13,30,50,-20,15,31,20
33367,22065,22071,56,14,23,7,6,10,27,34,-7,20,26,27
33368,22065,22071,9,7,23,9,6,8,32,29,3,24,22,33
33369,22065,22071,4,9,23,9,3,11,32,29,3,21,25,30
33370,22065,22071,49,8,23,8,8,7,29,28,1,24,22,32
33371,22065,22071,16,11,23,8,6,9,36,39,-3,22,24,30
33372,22065,22071,21,3,23,12,4,7,40,31,9,28,18,40
33373,22065,22071,22,2,23,12,6,5,47,30,17,30,16,42
33374,22065,22071,43,6,23,8,11,4,31,25,6,27,19,35
33375,22065,22071,24,12,23,8,6,9,35,38,-3,22,24,30
33376,22065,22071,57,17,23,7,1,15,29,41,-12,15,31,22
33377,22065,22071,53,5,23,11,3,9,44,44,0,25,21,36
33378,22065,22071,1,1,23,16,3,4,49,16,33,35,11,51
33379,22093,22099,22,3,28,13,7,8,53,39,14,33,23,46
33380,22093,22099,43,4,28,11,12,5,39,29,10,34,22,45
33381,22093,22099,24,10,28,10,7,11,39,46,-7,27,29,37
33382,22093,22099,1,1,28,20,4,4,61,18,43,44,12,64
33383,22093,22099,53,6,28,12,4,12,51,54,-3,28,28,40
33384,22093,22099,15,14,28,7,12,9,33,43,-10,26,30,33
33385,22093,22099,10,18,28,6,7,15,33,56,-23,19,37,25
33386,22093,22099,57,16,28,9,2,17,33,44,-11,20,36,29
33387,22093,22099,16,9,28,11,7,10,45,46,-1,29,27,40
33388,22093,22099,49,11,28,9,10,9,38,36,2,28,28,37
33389,22093,22099,21,2,28,14,6,8,44,35,9,34,22,48
33390,22093,22099,9,5,28,12,7,9,42,34,8,31,25,43
33391,22093,22099,4,12,28,10,6,12,40,37,3,26,30,36
33392,22093,22099,56,13,28,9,6,13,34,41,-7,24,32,33
33393,22093,22099,45,7,28,12,4,12,45,50,-5,28,28,40
33394,22093,22099,27,8,28,11,7,10,40,36,4,29,27,40
33395,22093,22099,28,15,28,8,7,13,34,42,-8,23,33,31
33396,22093,22099,38,17,28,6,9,13,26,44,-18,21,35,27
33397,22114,22127,28,15,31,9,8,14,39,46,-7,26,36,35
33398,22114,22127,38,16,31,7,9,15,27,46,-19,23,39,30
33399,22114,22127,15,13,31,9,13,9,40,47,-7,31,31,40
33400,22114,22127,10,18,31,6,7,18,37,65,-28,19,43,25
33401,22114,22127,16,7,31,12,9,10,51,51,0,33,29,45
33402,22114,22127,49,12,31,10,11,10,43,40,3,31,31,41
33403,22114,22127,22,3,31,14,8,9,58,43,15,36,26,50
33404,22114,22127,43,5,31,12,13,6,44,32,12,37,25,49
33405,22114,22127,24,10,31,11,9,11,45,49,-4,31,31,42
33406,22114,22127,57,17,31,9,2,20,34,49,-15,20,42,29
33407,22114,22127,45,8,31,13,4,14,47,57,-10,30,32,43
33408,22114,22127,27,11,31,11,8,12,43,41,2,30,32,41
33409,22114,22127,53,6,31,14,5,12,56,57,-1,33,29,47
33410,22114,22127,56,14,31,10,6,15,38,48,-10,26,36,36
33411,22114,22127,1,1,31,22,4,5,66,21,45,48,14,70
33412,22114,22127,21,2,31,16,6,9,50,40,10,38,24,54
33413,22114,22127,9,4,31,14,7,10,46,37,9,35,27,49
33414,22114,22127,4,9,31,12,7,12,43,38,5,31,31,43
33415,22426,22428,1,3,24,12,9,3,45,30,15,33,15,45
33416,22426,22428,43,4,24,11,9,4,52,29,23,31,17,42
33417,22426,22428,22,7,24,10,5,9,49,37,12,25,23,35
33418,22426,22428,57,8,24,10,4,10,35,29,6,24,24,34
33419,22426,22428,24,10,24,10,3,11,38,47,-9,23,25,33
33420,22426,22428,53,18,24,3,3,18,20,49,-29,9,39,12
33421,22426,22428,39,1,24,17,3,4,56,21,35,37,11,54
33422,22426,22428,27,6,24,10,7,7,39,33,6,27,21,37
33423,22426,22428,15,14,24,7,5,12,31,41,-10,19,29,26
33424,22426,22428,45,16,24,6,7,11,33,49,-16,19,29,25
33425,22426,22428,21,2,24,14,5,5,45,26,19,33,15,47
33426,22426,22428,4,5,24,10,7,7,36,25,11,27,21,37
33427,22426,22428,9,15,24,7,4,13,25,46,-21,18,30,25
33428,22426,22428,49,11,24,8,7,9,28,37,-9,23,25,31
33429,22426,22428,16,12,24,7,9,8,36,38,-2,23,25,30
33430,22426,22428,56,9,24,8,10,6,30,28,2,26,22,34
33431,22426,22428,13,17,24,7,1,16,26,50,-24,15,33,22
33432,22426,22428,28,13,24,8,4,12,26,35,-9,20,28,28
33433,22457,22463,28,11,29,11,5,13,32,37,-5,27,31,38
33434,22457,22463,39,1,29,20,4,5,62,22,40,44,14,64
33435,22457,22463,27,7,29,13,7,9,45,40,5,33,25,46
33436,22457,22463,45,15,29,7,8,14,38,61,-23,22,36,29
33437,22457,22463,15,16,29,7,7,15,33,49,-16,21,37,28
33438,17704,17710,4,9,23,9,6,8,47,35,12,24,22,33
33439,17704,17710,42,18,23,3,8,12,26,36,-10,14,32,17
33440,17704,17710,56,11,23,7,9,7,24,32,-8,23,23,30
33441,17704,17710,35,12,23,7,8,8,31,29,2,22,24,29
33442,17704,17710,1,3,23,12,5,6,39,30,9,29,17,41
33443,17704,17710,43,1,23,17,2,4,57,25,32,36,10,53
33444,17704,17710,22,4,23,12,4,7,35,30,5,28,18,40
33445,17704,17710,57,7,23,10,5,8,35,34,1,25,21,35
33446,17704,17710,24,13,23,6,9,8,32,39,-7,21,25,27
33447,17704,17710,32,15,23,5,3,15,25,56,-31,13,33,18
33448,17704,17710,51,17,23,4,5,14,23,45,-22,13,33,17
33449,17704,17710,45,5,23,11,4,8,39,28,11,26,20,37
33450,17704,17710,27,14,23,6,5,12,29,40,-11,17,29,23
33451,17956,17962,22,8,12,4,5,3,17,13,4,13,11,17
33452,17956,17962,57,13,12,2,4,6,18,21,-3,8,16,10
33453,17956,17962,51,15,12,1,3,8,16,31,-15,5,19,6
33454,17956,17962,43,2,12,8,2,2,22,10,12,18,6,26
33455,17956,17962,24,3,13,7,0,6,19,19,0,14,12,21
33456,17956,17962,35,5,12,5,3,4,13,15,-2,13,11,18
33457,17956,17962,56,10,12,4,4,4,14,13,1,12,12,16
33458,17956,17962,25,11,12,3,3,6,14,22,-8,9,15,12
33459,17956,17962,12,14,12,2,2,8,12,23,-11,6,18,8
33460,17956,17962,1,1,12,9,2,1,27,14,13,20,4,29
33461,17956,17962,28,7,12,5,2,5,15,16,-1,12,12,17
33462,17956,17962,49,4,12,5,6,1,21,11,10,16,8,21
33463,17956,17962,4,6,12,5,2,5,20,15,5,12,12,17
33464,17956,17962,45,9,12,4,5,3,20,18,2,13,11,17
33465,17956,17962,27,12,13,3,5,5,16,23,-7,11,15,14
33466,17977,17983,45,7,14,5,5,4,24,21,3,15,13,20
33467,17977,17983,27,13,14,3,5,6,16,25,-9,11,17,14
33468,17977,17983,4,5,14,7,2,5,24,16,8,16,12,23
33469,17977,17983,49,4,14,6,6,2,25,14,11,18,10,24
33470,17977,17983,28,9,14,5,3,6,17,21,-4,13,15,18
33471,17977,17983,1,2,14,9,2,3,29,19,10,20,8,29
33472,17977,17983,25,10,14,4,3,7,16,24,-8,11,17,15
33473,17977,17983,12,14,14,2,3,9,12,24,-12,7,21,9
33474,17977,17983,35,3,14,7,3,4,19,17,2,17,11,24
33475,17977,17983,56,8,14,5,5,4,16,14,2,15,13,20
33476,17977,17983,43,1,14,10,2,2,27,11,16,22,6,32
33477,17977,17983,24,6,14,7,0,7,20,23,-3,14,14,21
33478,17977,17983,22,11,14,4,5,5,18,17,1,13,15,17
33479,17977,17983,57,12,14,3,5,6,21,23,-2,11,17,14
33480,17977,17983,51,15,14,2,3,9,19,34,-15,7,21,9
33481,17998,18004,43,1,17,13,2,2,33,12,21,28,6,41
33482,17998,18004,24,8,17,7,1,9,23,31,-8,15,19,22
33483,17998,18004,22,11,16,4,6,6,19,19,0,14,18,18
33484,17998,18004,25,10,17,5,4,8,18,26,-8,14,20,19
33485,17998,18004,12,15,16,2,3,11,12,26,-14,7,25,9
33486,17998,18004,1,2,17,11,3,3,32,20,12,25,9,36
33487,17998,18004,35,4,17,8,5,4,24,19,5,21,13,29
33488,17998,18004,56,6,17,7,5,5,19,15,4,19,15,26
33489,17998,18004,28,9,17,6,4,7,19,23,-4,16,18,22
33490,17998,18004,49,7,17,6,7,4,27,19,8,19,15,25
33491,17998,18004,4,3,17,10,2,5,34,20,14,22,12,32
33492,17998,18004,27,12,17,3,7,7,16,26,-10,13,21,16
33493,17998,18004,45,5,17,7,5,5,26,22,4,19,15,26
33494,17998,18004,57,13,17,3,5,9,23,30,-7,11,23,14
33495,17998,18004,51,14,16,3,3,10,20,37,-17,9,23,12
33496,18054,18060,43,1,23,17,3,3,50,19,31,37,9,54
33497,18054,18060,45,4,23,10,7,6,35,27,8,27,19,37
33498,18054,18060,27,13,24,5,7,12,27,37,-10,17,31,22
33499,18054,18060,4,3,23,12,5,6,43,26,17,29,17,41
33500,18054,18060,49,6,24,9,8,7,35,29,6,26,22,35
33501,18054,18060,28,5,24,10,5,9,30,31,-1,25,23,35
33502,18054,18060,35,8,24,9,6,9,27,35,-8,24,24,33
33503,18054,18060,56,7,23,9,7,7,29,26,3,25,21,34
33504,18054,18060,25,12,23,6,7,10,22,31,-9,19,27,25
33505,18054,18060,12,15,23,4,3,16,19,40,-21,11,35,15
33506,18054,18060,1,2,23,14,4,5,43,29,14,32,14,46
33507,18054,18060,24,9,24,10,2,12,31,41,-10,22,26,32
33508,18054,18060,22,10,23,7,9,7,28,24,4,23,23,30
33509,18054,18060,57,11,23,8,5,10,35,34,1,21,25,29
33510,18054,18060,51,14,23,4,4,15,27,52,-25,12,34,16
33511,18306,18312,45,12,11,2,5,4,17,19,-2,9,13,11
33512,18306,18312,27,15,11,1,3,7,7,21,-14,5,17,6
33513,18306,18312,15,16,11,1,1,9,10,22,-12,3,19,4
33514,18306,18312,17,14,11,1,3,7,8,19,-11,5,17,6
33515,18306,18312,1,5,11,6,1,4,26,16,10,13,9,19
33516,17788,17864,25,6,34,15,7,12,42,38,4,37,31,52
33517,17788,17864,12,7,34,13,12,9,40,32,8,38,30,51
33518,17788,17864,49,2,34,24,5,5,66,26,40,53,15,77
33519,17788,17864,23,15,34,9,8,17,44,58,-14,26,42,35
33520,17788,17864,33,11,34,12,8,14,42,49,-7,32,36,44
33521,17788,17864,57,9,34,14,5,15,48,53,-5,33,35,47
33522,17788,17864,24,10,34,12,10,12,46,52,-6,34,34,46
33523,17788,17864,51,16,34,8,6,20,33,59,-26,22,46,30
33524,17788,17864,32,17,34,7,6,21,35,77,-42,20,48,27
33525,17788,17864,4,4,34,17,8,9,67,42,25,42,26,59
33526,17788,17864,45,5,34,16,7,11,55,36,19,39,29,55
33527,17788,17864,27,12,34,12,7,15,43,48,-5,31,37,43
33528,17788,17864,35,13,34,11,9,14,44,42,2,31,37,42
33529,17788,17864,56,14,34,9,11,14,37,55,-18,29,39,38
33530,17788,17864,43,1,34,24,5,5,75,30,45,53,15,77
33531,17788,17864,22,8,34,15,5,14,48,51,-3,35,33,50
33532,17585,17591,56,10,9,3,3,3,9,14,-5,9,9,12
33533,17585,17591,35,16,9,1,5,3,8,8,0,7,11,8
33534,17585,17591,42,13,9,2,2,5,9,14,-5,6,12,8
33535,17585,17591,25,6,9,5,2,2,13,10,3,12,6,17
33536,17585,17591,12,8,9,3,5,1,11,6,5,11,7,14
33537,17585,17591,45,9,9,4,1,4,13,10,3,9,9,13
33538,17585,17591,27,11,9,3,2,4,9,12,-3,8,10,11
33539,17585,17591,43,3,9,6,1,2,23,11,12,13,5,19
33540,17585,17591,22,5,9,5,2,2,14,10,4,12,6,17
33541,17585,17591,57,12,9,3,1,5,13,16,-3,7,11,10
33542,17585,17591,24,15,9,2,2,5,11,20,-9,6,12,8
33543,17585,17591,32,17,9,1,1,7,6,18,-12,3,15,4
33544,17585,17591,51,18,9,0,2,7,3,16,-13,2,16,2
33545,17585,17591,1,1,9,6,2,1,15,7,8,14,4,20
33546,17585,17591,33,4,9,5,2,2,17,11,6,12,6,17
33547,17585,17591,4,7,9,4,3,2,19,11,8,11,7,15
33548,17585,17591,49,2,9,6,2,1,15,8,7,14,4,20
33549,17585,17591,23,14,9,2,2,5,12,18,-6,6,12,8
33550,17914,17916,49,5,7,3,4,0,16,7,9,10,4,13
33551,17914,17916,28,1,7,5,2,0,11,5,6,12,2,17
33552,17914,17916,57,12,6,1,1,4,12,13,-1,3,9,4
33553,17914,17916,51,15,6,0,1,5,7,19,-12,1,11,1
33554,17914,17916,4,2,7,4,2,1,16,7,9,10,4,14
33555,17914,17916,1,4,7,4,2,1,15,9,6,10,4,14
33556,17914,17916,27,7,7,3,2,2,8,9,-1,8,6,11
33557,17914,17916,45,11,6,1,3,2,7,10,-3,5,7,6
33558,17914,17916,35,8,7,2,3,2,8,9,-1,7,7,9
33559,17914,17916,56,9,6,2,2,2,6,6,0,6,6,8
33560,17914,17916,25,13,6,0,1,5,4,15,-11,1,11,1
33561,17914,17916,12,14,6,0,1,5,5,14,-9,1,11,1
33562,17914,17916,43,3,7,4,2,1,13,6,7,10,4,14
33563,17914,17916,24,6,7,4,0,3,13,12,1,8,6,12
33564,17914,17916,22,10,6,1,4,1,7,7,0,6,6,7
33565,17921,17927,35,7,9,3,3,3,9,10,-1,9,9,12
33566,17921,17927,56,13,8,2,2,4,6,9,-3,6,10,8
33567,17921,17927,27,8,9,3,2,4,10,15,-5,8,10,11
33568,17921,17927,45,11,8,2,3,3,11,14,-3,7,9,9
33569,17921,17927,43,2,8,5,2,1,14,6,8,12,4,17
33570,17921,17927,24,5,9,5,0,4,15,14,1,10,8,15
33571,17921,17927,22,9,8,2,5,1,12,10,2,9,7,11
33572,17921,17927,57,12,8,2,2,4,14,14,0,6,10,8
33573,17921,17927,51,15,8,0,2,6,9,22,-13,2,14,2
33574,17921,17927,1,1,8,5,2,1,18,10,8,12,4,17
33575,17921,17927,4,6,9,4,2,3,18,12,6,10,8,14
33576,17921,17927,28,3,9,5,2,2,13,11,2,12,6,17
33577,17921,17927,49,4,9,4,5,0,19,8,11,13,5,17
33578,17921,17927,25,10,8,2,1,5,8,16,-8,5,11,7
33579,17921,17927,12,14,8,2,1,5,11,16,-5,5,11,7
33580,18743,18760,49,5,19,8,7,4,23,23,0,23,15,31
33581,18743,18760,16,11,19,5,5,9,24,34,-10,15,23,20
33582,18743,18760,28,16,19,2,6,11,24,40,-16,10,28,12
33583,18743,18760,43,1,19,12,4,3,37,18,19,28,10,40
33584,18743,18760,22,6,19,8,6,5,36,26,10,22,16,30
33585,18743,18760,57,7,19,8,6,5,24,20,4,22,16,30
33586,18743,18760,24,10,19,5,6,8,24,35,-11,16,22,21
33587,18743,18760,45,14,19,2,9,8,19,28,-9,13,25,15
33588,18743,18760,4,2,19,12,3,4,42,20,22,27,11,39
33589,18743,18760,12,12,19,4,8,7,25,28,-3,16,22,20
33590,18743,18760,25,15,19,3,4,12,17,34,-17,10,28,13
33591,18743,18760,56,4,19,10,3,6,26,21,5,23,15,33
33592,18743,18760,35,9,19,6,7,6,29,26,3,19,19,25
33593,18743,18760,1,3,19,11,4,4,32,21,11,26,12,37
33594,18743,18760,42,8,19,7,6,6,35,32,3,20,18,27
33595,18743,18760,17,13,19,3,8,8,14,25,-11,14,24,17
33596,17774,17780,24,10,32,11,10,11,42,49,-7,32,32,43
33597,17774,17780,57,11,32,12,5,15,44,51,-7,29,35,41
33598,17774,17780,51,16,32,8,6,18,31,54,-23,22,42,30
33599,17774,17780,32,17,32,6,5,21,33,76,-43,17,47,23
33600,17774,17780,27,13,32,10,7,15,38,47,-9,27,37,37
33601,17774,17780,42,18,32,3,9,20,30,53,-23,15,49,18
33602,17774,17780,49,2,32,22,5,5,63,26,37,49,15,71
33603,17774,17780,45,8,32,14,7,11,50,36,14,35,29,49
33604,17774,17780,35,12,32,10,9,13,41,40,1,29,35,39
33605,17774,17780,56,14,32,8,11,13,34,52,-18,27,37,35
33606,17774,17780,33,9,32,12,8,12,41,43,-2,32,32,44
33607,17774,17780,25,5,32,15,7,10,40,33,7,37,27,52
33608,17774,17780,12,6,32,13,12,7,40,27,13,38,26,51
33609,17557,17563,56,6,6,3,1,2,7,10,-3,7,5,10
33610,17557,17563,35,15,6,1,3,2,7,6,1,5,7,6
33611,17557,17563,33,4,6,4,1,1,12,7,5,9,3,13
33612,17557,17563,42,13,6,2,0,4,7,11,-4,4,8,6
33613,17557,17563,45,12,6,2,1,3,4,7,-3,5,7,7
33614,17557,17563,27,14,6,2,0,4,5,9,-4,4,8,6
33615,17557,17563,12,7,6,2,3,1,7,4,3,7,5,9
33616,17557,17563,25,10,6,2,2,2,3,6,-3,6,6,8
33617,17557,17563,43,3,6,4,1,1,14,5,9,9,3,13
33618,17557,17563,22,5,6,3,1,2,8,7,1,7,5,10
33619,17557,17563,24,9,6,2,2,2,8,8,0,6,6,8
33620,17557,17563,57,11,6,2,1,3,7,10,-3,5,7,7
33621,17557,17563,51,17,6,0,2,4,3,10,-7,2,10,2
33622,17557,17563,32,18,6,0,1,5,3,12,-9,1,11,1
33623,17557,17563,49,1,6,5,1,0,12,3,9,11,1,16
33624,17557,17563,23,16,6,1,2,3,7,11,-4,4,8,5
33625,17557,17563,1,2,6,4,2,0,11,3,8,10,2,14
33626,17557,17563,4,8,6,2,2,2,14,10,4,6,6,8
33627,17928,17941,24,3,10,6,0,4,17,14,3,12,8,18
33628,17928,17941,43,4,9,5,2,2,16,10,6,12,6,17
33629,17928,17941,22,10,9,2,5,2,12,11,1,9,9,11
33630,17928,17941,57,13,9,2,2,5,16,17,-1,6,12,8
33631,17928,17941,51,15,9,1,2,6,12,24,-12,4,14,5
33632,17928,17941,1,1,9,6,2,1,22,12,10,14,4,20
33633,17928,17941,4,7,9,4,2,3,18,12,6,10,8,14
33634,17928,17941,45,8,9,3,3,3,13,15,-2,9,9,12
33635,17928,17941,27,9,10,3,3,4,13,18,-5,9,11,12
33636,17928,17941,49,2,10,5,5,0,20,8,12,15,5,20
33637,17928,17941,25,11,9,2,1,6,9,19,-10,5,13,7
33638,17928,17941,12,14,9,2,1,6,11,18,-7,5,13,7
33639,17928,17941,35,6,10,4,3,3,12,11,1,11,9,15
33640,17928,17941,56,12,9,2,3,4,9,12,-3,7,11,9
33641,17928,17941,28,5,10,5,2,3,14,13,1,12,8,17
33642,18005,18011,35,4,18,8,5,5,24,20,4,21,15,29
33643,18005,18011,56,7,18,7,6,5,20,16,4,20,16,27
33644,18005,18011,45,6,18,7,6,5,28,24,4,20,16,27
33645,18005,18011,27,12,18,3,7,8,18,29,-11,13,23,16
33646,18005,18011,49,5,18,7,7,4,30,21,9,21,15,28
33647,18005,18011,1,2,18,11,3,4,34,23,11,25,11,36
33648,18005,18011,25,10,18,5,5,8,19,27,-8,15,21,20
33649,18005,18011,12,15,17,2,3,12,12,27,-15,7,27,9
33650,18005,18011,43,1,18,14,2,2,36,14,22,30,6,44
33651,18005,18011,24,8,18,8,1,9,24,31,-7,17,19,25
33652,18005,18011,22,11,17,4,7,6,21,21,0,15,19,19
33653,18005,18011,57,13,17,3,5,9,23,30,-7,11,23,14
33654,18005,18011,51,14,17,3,3,11,21,39,-18,9,25,12
33655,18005,18011,28,9,18,7,4,7,21,24,-3,18,18,25
33656,18005,18011,4,3,18,11,2,5,35,20,15,24,12,35
33657,17872,17878,43,1,2,2,0,0,5,2,3,4,0,6
33658,17872,17878,24,4,2,1,0,1,5,3,2,2,2,3
33659,17872,17878,22,9,1,0,1,0,2,2,0,1,1,1
33660,17872,17878,51,10,1,0,1,0,1,1,0,1,1,1
33661,17872,17878,57,15,2,0,0,2,3,6,-3,0,4,0
33662,17872,17878,4,1,2,2,0,0,5,2,3,4,0,6
33663,17872,17878,45,5,2,0,2,0,3,3,0,2,2,2
33664,17872,17878,27,11,2,0,1,1,1,2,-1,1,3,1
33665,17872,17878,1,3,2,2,0,0,4,1,3,4,0,6
33666,17872,17878,49,5,2,0,2,0,3,3,0,2,2,2
33667,17872,17878,35,7,2,0,2,0,2,2,0,2,2,2
33668,17872,17878,56,12,2,0,1,1,1,3,-2,1,3,1
33669,17872,17878,12,12,2,0,1,1,1,3,-2,1,3,1
33670,17872,17878,25,14,2,0,1,1,2,5,-3,1,3,1
33671,17872,17878,28,7,2,0,2,0,2,2,0,2,2,2
33672,18012,18025,35,4,19,9,5,5,25,20,5,23,15,32
33673,18012,18025,56,8,18,7,6,5,20,16,4,20,16,27
33674,18012,18025,45,6,19,8,6,5,29,24,5,22,16,30
33675,18012,18025,27,12,19,4,7,8,21,29,-8,15,23,19
33676,18012,18025,49,5,19,8,7,4,32,21,11,23,15,31
33677,22457,22463,16,9,29,10,10,9,44,44,0,30,28,40
33678,22457,22463,49,14,29,8,8,13,30,44,-14,24,34,32
33679,22457,22463,56,12,29,9,10,10,37,36,1,28,30,37
33680,22457,22463,13,17,29,7,2,20,26,58,-32,16,42,23
33681,22457,22463,21,3,29,16,5,8,49,34,15,37,21,53
33682,22457,22463,4,5,29,14,7,8,44,27,17,35,23,49
33683,22457,22463,9,13,29,9,5,15,28,52,-24,23,35,32
33684,22457,22463,53,18,29,4,4,21,29,61,-32,12,46,16
33685,22457,22463,43,4,29,14,10,5,60,32,28,38,20,52
33686,22457,22463,24,6,29,14,4,11,50,53,-3,32,26,46
33687,22457,22463,22,8,29,13,5,11,56,41,15,31,27,44
33688,22457,22463,57,10,29,11,6,12,42,36,6,28,30,39
33689,22457,22463,1,2,29,16,9,4,56,34,22,41,17,57
33690,22275,22288,1,3,6,3,2,1,12,11,1,8,4,11
33691,22275,22288,53,18,6,0,1,5,6,15,-9,1,11,1
33692,22275,22288,56,5,6,3,1,2,8,6,2,7,5,10
33693,22275,22288,13,9,6,3,0,3,7,10,-3,6,6,9
33694,22275,22288,15,2,6,3,2,1,13,8,5,8,4,11
33695,22275,22288,27,7,6,2,4,0,12,6,6,8,4,10
33696,22275,22288,45,13,6,2,2,2,9,10,-1,6,6,8
33697,22275,22288,49,6,6,3,1,2,7,11,-4,7,5,10
33698,22275,22288,16,17,6,0,4,2,6,13,-7,4,8,4
33699,22275,22288,21,11,6,2,2,2,14,11,3,6,6,8
33700,22275,22288,22,4,6,3,1,2,13,10,3,7,5,10
33701,22275,22288,43,12,6,2,2,2,8,7,1,6,6,8
33702,22275,22288,24,14,6,2,1,3,9,11,-2,5,7,7
33703,22275,22288,57,16,6,1,2,3,5,7,-2,4,8,5
33704,22275,22288,39,1,6,4,0,2,13,5,8,8,4,12
33705,22275,22288,28,15,6,2,1,3,5,8,-3,5,7,7
33706,22275,22288,9,8,6,3,0,3,8,11,-3,6,6,9
33707,22275,22288,4,10,6,2,2,2,12,7,5,6,6,8
33708,22289,22295,28,10,7,3,1,3,6,8,-2,7,7,10
33709,22289,22295,43,5,7,3,2,2,15,9,6,8,6,11
33710,22289,22295,22,8,7,3,2,2,14,11,3,8,6,11
33711,22289,22295,57,14,7,2,2,3,9,9,0,6,8,8
33712,22289,22295,24,16,7,2,1,4,11,18,-7,5,9,7
33713,22289,22295,21,6,7,3,2,2,15,11,4,8,6,11
33714,22289,22295,9,12,7,3,0,4,8,14,-6,6,8,9
33715,22289,22295,4,13,7,2,2,3,14,10,4,6,8,8
33716,22289,22295,49,3,7,4,1,2,8,11,-3,9,5,13
33717,22289,22295,16,17,7,1,4,2,8,14,-6,6,8,7
33718,22289,22295,39,2,7,4,1,2,14,6,8,9,5,13
33719,22289,22295,27,4,7,3,4,0,15,8,7,10,4,13
33720,22289,22295,15,7,7,3,2,2,13,9,4,8,6,11
33721,22289,22295,45,15,7,2,2,3,11,14,-3,6,8,8
33722,22289,22295,56,9,7,3,1,3,9,8,1,7,7,10
33723,22289,22295,13,11,7,3,0,4,7,11,-4,6,8,9
33724,22289,22295,53,18,7,0,1,6,6,16,-10,1,13,1
33725,22289,22295,1,1,7,4,2,1,15,11,4,10,4,14
33726,22772,22778,1,4,19,10,4,5,36,24,12,24,14,34
33727,22772,22778,25,7,19,9,3,7,38,33,5,21,17,30
33728,22772,22778,21,3,19,12,3,4,35,20,15,27,11,39
33729,22772,22778,4,5,19,9,4,6,32,20,12,22,16,31
33730,22772,22778,9,16,19,5,2,12,21,42,-21,12,26,17
33731,22772,22778,49,6,19,9,3,7,30,23,7,21,17,30
33732,22772,22778,16,9,19,7,5,7,33,30,3,19,19,26
33733,22772,22778,22,1,19,16,1,2,48,17,31,33,5,49
33734,22772,22778,57,10,19,7,5,7,25,26,-1,19,19,26
33735,22772,22778,43,11,19,7,2,10,27,28,-1,16,22,23
33736,22772,22778,24,13,19,6,4,9,30,33,-3,16,22,22
33737,22772,22778,28,8,19,7,6,6,20,20,0,20,18,27
33738,22772,22778,39,2,19,13,3,3,41,23,18,29,9,42
33739,22772,22778,27,12,19,7,1,11,24,36,-12,15,23,22
33740,22772,22778,15,14,19,6,1,12,26,40,-14,13,25,19
33741,22772,22778,45,17,19,4,4,11,25,42,-17,12,26,16
33742,22772,22778,56,15,19,5,3,11,18,35,-17,13,25,18
33743,22772,22778,13,18,19,4,2,13,18,35,-17,10,28,14
33744,22807,22813,56,15,25,7,4,14,28,45,-17,18,32,25
33745,22807,22813,13,18,25,5,3,17,23,48,-25,13,37,18
33746,22807,22813,39,2,25,17,5,3,51,25,26,39,11,56
33747,22807,22813,27,12,25,9,4,12,33,42,-9,22,28,31
33748,22807,22813,15,14,25,7,4,14,32,49,-17,18,32,25
33749,22807,22813,45,16,25,5,6,14,31,53,-22,16,34,21
33750,22807,22813,28,9,25,9,8,8,26,28,-2,26,24,35
33751,22807,22813,22,1,25,20,2,3,60,23,37,42,8,62
33752,22807,22813,57,8,25,9,8,8,33,33,0,26,24,35
33753,22807,22813,43,10,25,10,4,11,36,33,3,24,26,34
33754,22807,22813,24,13,25,8,5,12,38,44,-6,21,29,29
33755,22807,22813,49,6,25,11,5,9,38,32,6,27,23,38
33756,22807,22813,16,11,25,8,8,9,38,36,2,24,26,32
33757,22807,22813,21,3,25,15,5,5,43,23,20,35,15,50
33758,22807,22813,4,5,25,11,6,8,44,30,14,28,22,39
33759,22807,22813,9,17,25,5,4,16,26,54,-28,14,36,19
33760,22807,22813,25,7,25,10,6,9,48,43,5,26,24,36
33761,22807,22813,1,4,25,11,9,5,43,30,13,31,19,42
33762,22835,22841,1,4,29,13,10,6,49,35,14,36,22,49
33763,22835,22841,25,6,29,13,6,10,56,48,8,32,26,45
33764,22835,22841,56,15,29,7,6,16,34,54,-20,20,38,27
33765,22835,22841,13,18,29,5,4,20,25,56,-31,14,44,19
33766,22835,22841,49,7,29,13,6,10,46,38,8,32,26,45
33767,22835,22841,16,10,29,10,9,10,44,41,3,29,29,39
33768,22835,22841,21,3,29,18,6,5,53,24,29,42,16,60
33769,22835,22841,4,5,29,14,6,9,53,34,19,34,24,48
33770,22835,22841,9,16,29,6,6,17,33,61,-28,18,40,24
33771,22835,22841,22,1,29,21,4,4,68,29,39,46,12,67
33772,22835,22841,57,8,29,10,10,9,40,40,0,30,28,40
33773,22835,22841,43,9,29,11,6,12,42,38,4,28,30,39
33774,22835,22841,24,12,29,10,6,13,43,51,-8,26,32,36
33775,22835,22841,28,13,29,9,9,11,28,33,-5,27,31,36
33776,22835,22841,39,2,29,19,5,5,59,35,24,43,15,62
33777,22835,22841,27,11,29,11,5,13,35,43,-8,27,31,38
33778,22835,22841,15,14,29,7,6,16,39,59,-20,20,38,27
33779,22835,22841,45,17,29,5,8,16,39,67,-28,18,40,23
33780,23045,23058,39,1,10,7,1,2,22,12,10,15,5,22
33781,23045,23058,15,12,10,3,1,6,13,22,-9,7,13,10
33782,23045,23058,27,13,10,2,4,4,10,15,-5,8,12,10
33783,23045,23058,28,9,10,3,4,3,11,14,-3,10,10,13
33784,23045,23058,56,16,10,1,2,7,8,22,-14,4,16,5
33785,23045,23058,21,4,10,4,5,1,17,5,12,13,7,17
33786,23045,23058,4,3,10,5,5,0,16,10,6,15,5,20
33787,23045,23058,49,8,10,3,4,3,10,9,1,10,10,13
33788,23045,23058,16,14,10,2,3,5,14,19,-5,7,13,9
33789,23045,23058,55,10,10,3,3,4,11,20,-9,9,11,12
33790,23045,23058,25,15,10,1,3,6,11,19,-8,5,15,6
33791,23045,23058,1,5,10,4,4,2,23,11,12,12,8,16
33792,23045,23058,43,2,10,6,3,1,16,10,6,15,5,21
33793,23045,23058,57,6,10,5,0,5,12,11,1,10,10,15
33794,23045,23058,22,7,10,3,6,1,16,10,6,12,8,15
33795,23045,23058,24,11,10,3,2,5,11,12,-1,8,12,11
33796,23024,23030,1,2,7,4,2,1,20,7,13,10,4,14
33797,23024,23030,55,11,7,3,1,3,9,17,-8,7,7,10
33798,23024,23030,25,16,7,0,1,6,7,16,-9,1,13,1
33799,23024,23030,49,12,7,1,3,3,6,7,-1,5,9,6
33800,23024,23030,16,13,7,1,3,3,9,13,-4,5,9,6
33801,23024,23030,4,1,7,4,3,0,12,7,5,11,3,15
33802,23024,23030,21,6,7,3,3,1,13,4,9,9,5,12
33803,23024,23030,43,3,7,4,2,1,9,7,2,10,4,14
33804,23024,23030,57,5,7,4,0,3,8,5,3,8,6,12
33805,23024,23030,22,7,7,3,3,1,9,3,6,9,5,12
33806,23024,23030,24,9,7,3,1,3,9,7,2,7,7,10
33807,23024,23030,56,15,7,0,2,5,6,19,-13,2,12,2
33808,23024,23030,39,4,7,4,1,2,13,11,2,9,5,13
33809,23024,23030,15,10,7,3,1,3,10,13,-3,7,7,10
33810,23024,23030,27,14,7,0,4,3,6,11,-5,4,10,4
33811,23024,23030,28,8,7,3,2,2,7,6,1,8,6,11
33812,18306,18312,56,9,11,5,1,5,12,13,-1,11,11,16
33813,18306,18312,35,11,11,3,3,5,9,14,-5,9,13,12
33814,18306,18312,28,13,11,2,1,8,6,24,-18,5,17,7
33815,18306,18312,12,8,11,5,3,3,16,17,-1,13,9,18
33816,18306,18312,25,10,11,4,3,4,12,12,0,11,11,15
33817,18306,18312,49,4,11,6,2,3,22,14,8,14,8,20
33818,18306,18312,22,1,11,9,2,0,35,10,25,20,2,29
33819,18306,18312,43,3,11,6,3,2,23,8,15,15,7,21
33820,18306,18312,57,6,11,5,4,2,15,14,1,14,8,19
33821,18306,18312,24,7,11,5,4,2,13,13,0,14,8,19
33822,18306,18312,4,2,11,7,1,3,22,17,5,15,7,22
33823,18362,18368,45,11,19,5,9,5,28,24,4,19,19,24
33824,18362,18368,15,14,19,3,3,13,21,38,-17,9,29,12
33825,18362,18368,27,16,19,1,4,14,12,39,-27,6,32,7
33826,18362,18368,22,1,19,13,3,3,50,18,32,29,9,42
33827,18362,18368,43,2,19,12,5,2,38,14,24,29,9,41
33828,18362,18368,24,7,19,8,5,6,24,23,1,21,17,29
33829,18362,18368,57,8,19,8,5,6,24,25,-1,21,17,29
33830,18362,18368,49,5,19,10,3,6,37,24,13,23,15,33
33831,18362,18368,28,12,19,6,2,11,14,35,-21,14,24,20
33832,18362,18368,4,3,19,12,2,5,39,28,11,26,12,38
33833,18362,18368,17,15,19,2,6,11,16,38,-22,10,28,12
33834,18362,18368,12,4,19,9,7,3,28,22,6,25,13,34
33835,18362,18368,25,10,19,6,7,6,25,26,-1,19,19,25
33836,18362,18368,56,9,19,8,4,7,22,19,3,20,18,28
33837,18362,18368,35,13,19,3,6,10,12,28,-16,12,26,15
33838,18362,18368,1,6,19,9,3,7,38,27,11,21,17,30
33839,18369,18375,1,8,20,9,3,8,38,29,9,21,19,30
33840,18369,18375,56,7,20,9,4,7,24,20,4,22,18,31
33841,18369,18375,35,13,20,3,7,10,14,30,-16,13,27,16
33842,18369,18375,12,4,20,10,7,3,30,23,7,27,13,37
33843,18369,18375,25,11,20,6,7,7,25,28,-3,19,21,25
33844,18369,18375,17,15,20,2,7,11,17,39,-22,11,29,13
33845,18369,18375,4,3,20,12,3,5,41,30,11,27,13,39
33846,18369,18375,28,12,20,6,2,12,14,36,-22,14,26,20
33847,18369,18375,49,5,20,10,3,7,38,26,12,23,17,33
33848,18369,18375,43,1,20,13,5,2,40,14,26,31,9,44
33849,18369,18375,22,2,20,13,4,3,51,19,32,30,10,43
33850,18369,18375,24,6,20,9,5,6,25,23,2,23,17,32
33851,18369,18375,57,9,20,8,5,7,25,27,-2,21,19,29
33852,18369,18375,45,10,20,6,9,5,30,24,6,21,19,27
33853,18369,18375,15,14,20,4,3,13,22,38,-16,11,29,15
33854,18369,18375,27,16,20,1,4,15,12,40,-28,6,34,7
33855,18250,18256,22,1,4,4,0,0,15,2,13,8,0,12
33856,18250,18256,24,2,4,4,0,0,7,2,5,8,0,12
33857,18250,18256,43,3,4,3,1,0,11,1,10,7,1,10
33858,18250,18256,57,10,4,1,2,1,4,6,-2,4,4,5
33859,18250,18256,4,5,4,3,0,1,6,6,0,6,2,9
33860,18250,18256,45,7,4,1,2,1,7,4,3,4,4,5
33861,18250,18256,27,14,4,0,2,2,2,9,-7,2,6,2
33862,18250,18256,15,16,4,0,0,4,3,11,-8,0,8,0
33863,18250,18256,1,11,4,1,0,3,6,7,-1,2,6,3
33864,18250,18256,28,6,4,2,0,2,3,6,-3,4,4,6
33865,18250,18256,17,15,4,0,0,4,2,8,-6,0,8,0
33866,18250,18256,56,4,4,3,1,0,6,2,4,7,1,10
33867,18250,18256,35,13,4,0,2,2,1,6,-5,2,6,2
33868,18250,18256,49,8,4,1,2,1,8,6,2,4,4,5
33869,18250,18256,25,9,4,1,2,1,2,2,0,4,4,5
33870,18250,18256,12,12,4,0,2,2,4,9,-5,2,6,2
33871,18670,18676,43,1,10,7,2,1,20,8,12,16,4,23
33872,18670,18676,57,4,10,5,4,1,14,10,4,14,6,19
33873,18670,18676,22,9,10,3,4,3,16,14,2,10,10,13
33874,18670,18676,24,12,10,3,1,6,10,18,-8,7,13,10
33875,18670,18676,12,10,10,3,3,4,13,12,1,9,11,12
33876,18670,18676,25,15,10,1,4,5,8,17,-9,6,14,7
33877,18670,18676,4,3,10,6,1,3,22,14,8,13,7,19
33878,18670,18676,42,5,10,4,4,2,24,17,7,12,8,16
33879,18670,18676,17,14,10,1,6,3,6,9,-3,8,12,9
33880,18670,18676,56,7,10,4,2,4,12,10,2,10,10,14
33881,18670,18676,35,8,10,3,4,3,18,16,2,10,10,13
33882,18670,18676,1,2,10,6,4,0,20,9,11,16,4,22
33883,18670,18676,28,16,10,0,2,8,16,31,-15,2,18,2
33884,18670,18676,49,6,10,4,3,3,12,15,-3,11,9,15
33885,18670,18676,16,11,10,3,2,5,11,17,-6,8,12,11
33886,18670,18676,45,13,10,2,4,4,10,15,-5,8,12,10
33887,18607,18613,4,8,3,1,1,1,5,4,1,3,3,4
33888,18607,18613,45,7,3,1,2,0,4,3,1,4,2,5
33889,18607,18613,49,10,3,1,1,1,5,5,0,3,3,4
33890,18607,18613,16,12,3,1,0,2,3,4,-1,2,4,3
33891,18607,18613,28,14,3,0,1,2,6,9,-3,1,5,1
33892,18635,18641,1,3,6,3,3,0,13,6,7,9,3,12
33893,18635,18641,42,8,6,2,3,1,12,10,2,7,5,9
33894,18635,18641,17,14,6,0,4,2,4,6,-2,4,8,4
33895,18635,18641,45,12,6,1,3,2,7,10,-3,5,7,6
33896,18635,18641,4,1,6,4,1,1,12,7,5,9,3,13
33897,18635,18641,57,2,6,4,1,1,10,7,3,9,3,13
33898,18635,18641,43,4,6,3,2,1,10,6,4,8,4,11
33899,18635,18641,24,6,6,3,1,2,8,8,0,7,5,10
33900,18635,18641,22,9,6,2,3,1,11,9,2,7,5,9
33901,18635,18641,28,15,6,0,1,5,9,19,-10,1,11,1
33902,18635,18641,49,5,6,3,2,1,10,7,3,8,4,11
33903,18635,18641,16,7,6,3,0,3,8,7,1,6,6,9
33904,18635,18641,12,13,6,1,2,3,4,6,-2,4,8,5
33905,18635,18641,25,16,6,0,1,5,4,15,-11,1,11,1
33906,18635,18641,56,10,6,2,2,2,8,6,2,6,6,8
33907,18635,18641,35,11,6,1,3,2,9,10,-1,5,7,6
33908,19069,19075,12,3,16,9,3,4,27,19,8,21,11,30
33909,19069,19075,16,8,16,6,6,4,32,25,7,18,14,24
33910,19069,19075,49,9,16,7,2,7,28,24,4,16,16,23
33911,19069,19075,45,2,16,9,3,4,27,18,9,21,11,30
33912,19069,19075,27,14,16,4,3,9,15,30,-15,11,21,15
33913,19069,19075,10,16,16,2,5,9,15,32,-17,9,23,11
33914,19069,19075,4,10,16,5,5,6,20,25,-5,15,17,20
33915,19069,19075,43,1,16,10,4,2,36,14,22,24,8,34
33916,19069,19075,22,4,16,7,7,2,29,20,9,21,11,28
33917,19069,19075,24,11,16,5,4,7,25,26,-1,14,18,19
33918,19069,19075,57,15,16,3,2,11,20,35,-15,8,24,11
33919,19069,19075,42,7,16,7,3,6,30,31,-1,17,15,24
33920,19069,19075,17,13,16,3,7,6,18,26,-8,13,19,16
33921,19069,19075,56,6,16,7,4,5,18,14,4,18,14,25
33922,19069,19075,35,12,16,5,2,9,21,28,-7,12,20,17
33923,19069,19075,1,5,16,7,4,5,37,31,6,18,14,25
33924,19111,19131,42,7,22,9,4,9,37,42,-5,22,22,31
33925,19111,19131,17,15,22,3,9,10,23,43,-20,15,29,18
33926,19111,19131,56,8,22,8,5,9,24,23,1,21,23,29
33927,19111,19131,35,14,22,5,3,14,23,45,-22,13,31,18
33928,19111,19131,43,1,22,16,4,2,57,20,37,36,8,52
33929,19111,19131,22,6,22,9,9,4,43,33,10,27,17,36
33930,19111,19131,24,9,22,8,5,9,31,31,0,21,23,29
33931,19111,19131,57,16,22,3,5,14,26,47,-21,11,33,14
33932,19111,19131,45,2,22,13,5,4,36,23,13,31,13,44
33933,19111,19131,27,11,22,7,3,12,22,40,-18,17,27,24
33934,19111,19131,10,13,22,5,7,10,22,37,-15,17,27,22
33935,19111,19131,1,4,22,11,6,5,51,34,17,28,16,39
33936,19111,19131,49,5,22,12,2,8,45,28,17,26,18,38
33937,19111,19131,16,10,22,6,10,6,39,34,5,22,22,28
33938,19111,19131,12,3,22,12,4,6,41,30,11,28,16,40
33939,19111,19131,4,12,22,5,7,10,24,34,-10,17,27,22
33940,19139,19145,4,13,24,5,9,10,24,34,-10,19,29,24
33941,19139,19145,12,3,24,13,4,7,47,34,13,30,18,43
33942,19139,19145,49,5,24,13,3,8,47,28,19,29,19,42
33943,19139,19145,16,10,24,6,10,8,41,42,-1,22,26,28
33944,19139,19145,1,4,24,12,7,5,54,34,20,31,17,43
33945,19139,19145,57,16,24,3,5,16,27,52,-25,11,37,14
33946,19139,19145,45,2,24,15,5,4,39,23,16,35,13,50
33947,19139,19145,27,11,24,8,3,13,25,44,-19,19,29,27
33948,19139,19145,10,12,24,6,8,10,24,37,-13,20,28,26
33949,19139,19145,43,1,24,17,4,3,59,21,38,38,10,55
33950,19139,19145,22,6,24,10,9,5,47,36,11,29,19,39
33951,19139,19145,24,7,24,10,5,9,36,34,2,25,23,35
33952,19139,19145,56,8,24,9,5,10,28,25,3,23,25,32
33953,19139,19145,35,14,24,5,4,15,23,49,-26,14,34,19
33954,19139,19145,42,9,24,9,5,10,39,45,-6,23,25,32
33955,19139,19145,17,15,24,3,10,11,23,45,-22,16,32,19
33956,19426,19439,56,7,15,8,1,6,21,17,4,17,13,25
33957,19426,19439,45,3,15,9,5,1,31,21,10,23,7,32
33958,19426,19439,27,11,15,3,6,6,17,22,-5,12,18,15
33959,19426,19439,10,15,15,1,6,8,11,22,-11,8,22,9
33960,19426,19439,17,12,15,4,2,9,11,25,-14,10,20,14
33961,19426,19439,42,16,15,0,3,12,11,28,-17,3,27,3
33962,19426,19439,22,2,15,10,2,3,28,13,15,22,8,32
33963,19426,19439,43,4,15,10,1,4,38,17,21,21,9,31
33964,19426,19439,57,8,15,5,5,5,15,22,-7,15,15,20
33965,19426,19439,24,10,15,4,4,7,20,27,-7,12,18,16
33966,19426,19439,1,5,15,9,3,3,22,14,8,21,9,30
33967,19426,19439,4,9,15,4,6,5,17,22,-5,14,16,18
33968,19426,19439,9,14,15,3,3,9,11,25,-14,9,21,12
33969,19426,19439,49,1,15,10,4,1,29,9,20,24,6,34
33970,19426,19439,16,13,15,3,5,7,19,26,-7,11,19,14
33971,18012,18025,1,2,19,12,3,4,36,24,12,27,11,39
33972,18012,18025,25,10,19,5,5,9,19,28,-9,15,23,20
33973,18012,18025,12,15,18,2,3,13,12,29,-17,7,29,9
33974,18012,18025,43,1,19,14,3,2,38,16,22,31,7,45
33975,18012,18025,24,9,19,8,1,10,26,36,-10,17,21,25
33976,18012,18025,22,11,18,4,7,7,21,22,-1,15,21,19
33977,18012,18025,57,13,18,3,5,10,24,32,-8,11,25,14
33978,18012,18025,51,14,18,3,3,12,21,42,-21,9,27,12
33979,18012,18025,28,7,19,8,4,7,26,26,0,20,18,28
33980,18012,18025,4,3,19,11,3,5,37,22,15,25,13,36
33981,18068,18074,4,3,25,12,6,7,44,28,16,30,20,42
33982,18068,18074,43,1,25,19,3,3,54,19,35,41,9,60
33983,18068,18074,24,8,26,11,2,13,33,44,-11,24,28,35
33984,18068,18074,22,10,25,8,9,8,32,27,5,25,25,33
33985,18068,18074,57,11,25,9,5,11,40,37,3,23,27,32
33986,18068,18074,51,14,25,4,5,16,28,55,-27,13,37,17
33987,18068,18074,1,2,25,15,5,5,46,31,15,35,15,50
33988,18068,18074,49,7,26,10,8,8,37,31,6,28,24,38
33989,18068,18074,45,5,25,10,9,6,37,29,8,29,21,39
33990,18068,18074,27,13,26,5,7,14,27,43,-16,17,35,22
33991,18068,18074,28,6,25,11,5,9,31,31,0,27,23,38
33992,18068,18074,25,12,25,7,7,11,26,32,-6,21,29,28
33993,18068,18074,12,15,25,4,3,18,20,47,-27,11,39,15
33994,18068,18074,56,4,25,11,7,7,34,27,7,29,21,40
33995,18068,18074,35,9,25,9,7,9,28,36,-8,25,25,34
33996,17893,17906,56,10,4,1,2,1,4,5,-1,4,4,5
33997,17893,17906,35,11,5,0,3,2,4,7,-3,3,7,3
33998,17893,17906,49,7,5,1,4,0,10,6,4,6,4,7
33999,17893,17906,28,2,5,3,2,0,8,4,4,8,2,11
34000,17893,17906,4,3,5,3,1,1,10,5,5,7,3,10
34001,17893,17906,1,4,5,3,1,1,10,7,3,7,3,10
34002,17893,17906,27,6,5,2,2,1,6,4,2,6,4,8
34003,17893,17906,45,9,5,1,3,1,7,8,-1,5,5,6
34004,17893,17906,43,1,5,4,1,0,11,3,8,9,1,13
34005,17893,17906,24,5,5,3,0,2,10,7,3,6,4,9
34006,17893,17906,22,8,4,1,3,0,5,4,1,5,3,6
34007,17893,17906,57,12,4,0,1,3,7,11,-4,1,7,1
34008,17893,17906,51,14,4,0,1,3,4,11,-7,1,7,1
34009,17893,17906,12,13,4,0,1,3,3,9,-6,1,7,1
34010,17893,17906,25,15,5,0,1,4,3,11,-8,1,9,1
34011,18446,18452,1,4,28,15,4,9,56,34,22,34,22,49
34012,18446,18452,4,3,28,16,6,6,56,39,17,38,18,54
34013,18446,18452,22,1,28,18,7,3,63,25,38,43,13,61
34014,18446,18452,43,2,28,18,7,3,54,17,37,43,13,61
34015,18446,18452,24,6,28,12,8,8,31,29,2,32,24,44
34016,18446,18452,57,8,28,11,6,11,33,32,1,28,28,39
34017,18446,18452,49,7,28,13,4,11,47,38,9,30,26,43
34018,18446,18452,17,15,28,4,10,14,25,57,-32,18,38,22
34019,18446,18452,56,9,28,11,4,13,33,33,0,26,30,37
34020,18446,18452,35,13,28,5,10,13,23,38,-15,20,36,25
34021,18446,18452,12,5,28,12,10,6,40,35,5,34,22,46
34022,18446,18452,25,10,28,10,7,11,37,38,-1,27,29,37
34023,18446,18452,28,12,28,7,5,16,18,48,-30,19,37,26
34024,18446,18452,45,11,28,7,11,10,36,37,-1,25,31,32
34025,18446,18452,15,14,28,5,7,16,27,47,-20,17,39,22
34026,18446,18452,27,16,28,4,6,18,18,50,-32,14,42,18
34027,18285,18291,22,1,9,8,1,0,29,6,23,17,1,25
34028,18285,18291,43,2,9,6,3,0,22,2,20,15,3,21
34029,18285,18291,24,5,9,5,2,2,10,10,0,12,6,17
34030,18285,18291,57,8,9,3,4,2,13,14,-1,10,8,13
34031,18285,18291,28,13,9,2,1,6,5,16,-11,5,13,7
34032,18285,18291,17,14,9,1,2,6,7,17,-10,4,14,5
34033,18285,18291,56,7,9,4,1,4,9,10,-1,9,9,13
34034,18285,18291,35,11,9,3,2,4,8,12,-4,8,10,11
34035,18285,18291,1,6,9,4,1,4,20,12,8,9,9,13
34036,18285,18291,4,3,9,6,1,2,18,14,4,13,5,19
34037,18285,18291,49,4,9,5,2,2,15,9,6,12,6,17
34038,18285,18291,45,12,9,2,4,3,14,15,-1,8,10,10
34039,18285,18291,27,15,9,1,2,6,5,18,-13,4,14,5
34040,18285,18291,15,16,9,0,1,8,3,19,-16,1,17,1
34041,18285,18291,12,9,9,3,3,3,13,16,-3,9,9,12
34042,18285,18291,25,10,9,3,2,4,9,10,-1,8,10,11
34043,18593,18599,4,14,1,0,0,1,0,1,-1,0,2,0
34044,18593,18599,1,1,1,1,0,0,5,0,5,2,0,3
34045,18593,18599,22,2,1,1,0,0,3,1,2,2,0,3
34046,18593,18599,24,3,1,1,0,0,2,1,1,2,0,3
34047,18593,18599,57,5,1,1,0,0,1,0,1,2,0,3
34048,18593,18599,43,12,1,0,0,1,1,2,-1,0,2,0
34049,18593,18599,16,3,1,1,0,0,2,1,1,2,0,3
34050,18593,18599,49,6,1,0,1,0,1,1,0,1,1,1
34051,19426,19439,12,6,15,8,2,5,29,20,9,18,12,26
34052,19461,19467,12,6,19,9,3,7,31,24,7,21,17,30
34053,19461,19467,49,1,19,13,5,1,38,10,28,31,7,44
34054,19461,19467,16,14,19,3,7,9,21,32,-11,13,25,16
34055,19461,19467,4,8,19,7,6,6,24,25,-1,20,18,27
34056,19461,19467,9,10,19,6,3,10,19,28,-9,15,23,21
34057,19461,19467,43,2,19,13,1,5,45,21,24,27,11,40
34058,19461,19467,22,5,19,11,2,6,32,22,10,24,14,35
34059,19461,19467,57,9,19,6,5,8,20,31,-11,17,21,23
34060,19461,19467,24,13,19,4,5,10,21,34,-13,13,25,17
34061,19461,19467,17,12,19,5,2,12,16,38,-22,12,26,17
34062,19461,19467,42,16,19,1,4,14,14,32,-18,6,32,7
34063,19461,19467,1,3,19,12,4,3,32,16,16,28,10,40
34064,19461,19467,45,4,19,11,7,1,39,24,15,29,9,40
34065,19461,19467,27,11,19,4,9,6,22,26,-4,17,21,21
34066,19461,19467,10,15,19,1,8,10,11,26,-15,10,28,11
34067,19461,19467,56,7,19,8,5,6,24,20,4,21,17,29
34068,19517,19523,56,8,25,9,7,9,34,37,-3,25,25,34
34069,19517,19523,12,5,25,13,4,8,43,27,16,30,20,43
34070,19517,19523,1,2,25,15,5,5,42,24,18,35,15,50
34071,19517,19523,17,9,25,9,3,13,32,46,-14,21,29,30
34072,19517,19523,42,16,25,3,4,18,20,45,-25,10,40,13
34073,19517,19523,43,3,25,15,3,7,52,28,24,33,17,48
34074,19517,19523,22,6,25,12,2,11,36,32,4,26,24,38
34075,19517,19523,57,10,25,8,6,11,24,41,-17,22,28,30
34076,19517,19523,24,12,25,7,6,12,30,42,-12,20,30,27
34077,19517,19523,4,7,25,9,7,9,29,31,-2,25,25,34
34078,19517,19523,9,11,25,8,5,12,24,36,-12,21,29,29
34079,19517,19523,45,4,25,12,9,4,43,31,12,33,17,45
34080,19517,19523,27,13,25,6,9,10,28,35,-7,21,29,27
34081,19517,19523,10,15,25,4,10,11,22,32,-10,18,32,22
34082,19517,19523,49,1,25,18,6,1,53,12,41,42,8,60
34083,19517,19523,16,14,25,5,8,12,25,38,-13,18,32,23
34084,19377,19383,49,1,8,8,0,0,18,3,15,16,0,24
34085,19377,19383,16,12,8,1,3,4,7,13,-6,5,11,6
34086,19377,19383,12,4,8,5,1,2,17,11,6,11,5,16
34087,19377,19383,45,3,8,5,2,1,17,13,4,12,4,17
34088,19377,19383,27,9,8,2,3,3,9,12,-3,7,9,9
34089,19377,19383,10,14,8,0,5,3,4,9,-5,5,11,5
34090,19377,19383,4,7,8,3,3,2,9,12,-3,9,7,12
34091,19377,19383,9,15,8,0,3,5,6,15,-9,3,13,3
34092,19377,19383,43,5,8,5,0,3,26,14,12,10,6,15
34093,19377,19383,22,6,8,4,2,2,15,9,6,10,6,14
34094,19377,19383,24,11,8,2,2,4,8,14,-6,6,10,8
34095,19377,19383,57,13,8,1,3,4,5,13,-8,5,11,6
34096,19377,19383,1,2,8,6,2,0,18,6,12,14,2,20
34097,19377,19383,56,8,8,3,1,4,10,11,-1,7,9,10
34098,19377,19383,17,10,8,2,2,4,7,12,-5,6,10,8
34099,19377,19383,42,16,8,0,2,6,6,15,-9,2,14,2
34100,19790,19803,17,16,15,3,3,9,14,27,-13,9,21,12
34101,19790,19803,56,6,15,7,1,7,23,23,0,15,15,22
34102,19790,19803,1,2,15,7,7,1,33,14,19,21,9,28
34103,19790,19803,43,1,15,8,6,1,25,15,10,22,8,30
34104,19790,19803,22,7,15,5,7,3,18,16,2,17,13,22
34105,19790,19803,24,9,15,5,4,6,22,22,0,14,16,19
34106,19790,19803,27,10,15,5,4,6,19,21,-2,14,16,19
34107,19790,19803,45,13,15,4,4,7,20,25,-5,12,18,16
34108,19790,19803,10,14,15,4,2,9,13,22,-9,10,20,14
34109,19790,19803,57,15,15,3,4,8,11,22,-11,10,20,13
34110,19790,19803,12,3,15,7,5,3,27,18,9,19,11,26
34111,19790,19803,25,8,15,5,5,5,25,32,-7,15,15,20
34112,19790,19803,49,5,15,7,3,5,26,23,3,17,13,24
34113,19790,19803,4,4,15,7,5,3,23,15,8,19,11,26
34114,19790,19803,9,11,15,5,3,7,20,22,-2,13,17,18
34115,19790,19803,38,12,15,4,5,6,22,24,-2,13,17,17
34116,19692,19698,38,10,2,1,0,1,2,3,-1,2,2,3
34117,19692,19698,10,14,2,0,0,2,0,3,-3,0,4,0
34118,19692,19698,27,15,2,0,0,2,2,6,-4,0,4,0
34119,19692,19698,43,2,2,2,0,0,5,1,4,4,0,6
34120,19692,19698,24,8,2,1,0,1,4,4,0,2,2,3
34121,19692,19698,49,1,2,2,0,0,6,2,4,4,0,6
34122,19692,19698,57,11,2,0,2,0,1,1,0,2,2,2
34123,19692,19698,22,12,2,0,1,1,2,4,-2,1,3,1
34124,19692,19698,9,16,2,0,0,2,0,4,-4,0,4,0
34125,19692,19698,4,5,2,1,1,0,3,1,2,3,1,4
34126,19692,19698,17,7,2,1,0,1,2,1,1,2,2,3
34127,19692,19698,1,3,2,2,0,0,3,0,3,4,0,6
34128,19692,19698,56,13,2,0,0,2,2,5,-3,0,4,0
34129,19692,19698,25,4,2,2,0,0,4,2,2,4,0,6
34130,19692,19698,12,9,2,1,0,1,2,2,0,2,2,3
34131,18607,18613,1,1,3,2,1,0,9,3,6,5,1,7
34132,18607,18613,42,4,3,1,2,0,6,4,2,4,2,5
34133,18607,18613,17,13,3,0,2,1,2,3,-1,2,4,2
34134,18607,18613,12,15,3,0,1,2,1,4,-3,1,5,1
34135,18607,18613,25,16,3,0,1,2,1,8,-7,1,5,1
34136,18607,18613,56,6,3,1,2,0,3,1,2,4,2,5
34137,18607,18613,35,9,3,1,1,1,6,6,0,3,3,4
34138,18607,18613,43,2,3,2,0,1,5,3,2,4,2,6
34139,18607,18613,24,3,3,2,0,1,5,5,0,4,2,6
34140,18607,18613,22,5,3,1,2,0,5,3,2,4,2,5
34141,18607,18613,57,11,3,1,1,1,2,3,-1,3,3,4
34142,18621,18634,57,2,5,3,1,1,8,6,2,7,3,10
34143,18621,18634,24,3,5,3,1,1,7,6,1,7,3,10
34144,18621,18634,43,8,5,2,2,1,8,6,2,6,4,8
34145,18621,18634,22,10,5,1,3,1,7,6,1,5,5,6
34146,18621,18634,56,6,5,2,2,1,8,4,4,6,4,8
34147,18621,18634,35,11,5,1,3,1,8,8,0,5,5,6
34148,18621,18634,12,13,5,1,1,3,3,5,-2,3,7,4
34149,18621,18634,25,16,5,0,1,4,4,14,-10,1,9,1
34150,18621,18634,42,5,5,2,3,0,11,7,4,7,3,9
34151,18621,18634,17,14,5,0,3,2,3,5,-2,3,7,3
34152,18621,18634,1,4,5,2,3,0,11,5,6,7,3,9
34153,18621,18634,28,15,5,0,1,4,6,15,-9,1,9,1
34154,18621,18634,49,7,5,2,2,1,9,7,2,6,4,8
34155,18621,18634,16,9,5,2,0,3,5,6,-1,4,6,6
34156,18621,18634,45,12,5,1,3,1,6,7,-1,5,5,6
34157,18621,18634,4,1,5,3,1,1,9,6,3,7,3,10
34158,19048,19050,1,2,12,6,4,2,28,19,9,16,8,22
34159,19048,19050,4,7,12,5,4,3,17,14,3,14,10,19
34160,19048,19050,43,3,12,6,4,2,20,12,8,16,8,22
34161,19048,19050,22,4,12,5,7,0,21,13,8,17,7,22
34162,19048,19050,24,9,12,5,2,5,21,17,4,12,12,17
34163,19048,19050,57,16,12,1,1,10,10,28,-18,3,21,4
34164,19048,19050,27,13,12,4,1,7,13,23,-10,9,15,13
34165,19048,19050,10,15,12,1,4,7,11,23,-12,6,18,7
34166,19048,19050,45,1,12,7,1,4,21,16,5,15,9,22
34167,19048,19050,16,6,12,5,5,2,28,19,9,15,9,20
34168,19048,19050,49,10,12,5,1,6,23,22,1,11,13,16
34169,19048,19050,42,11,12,4,3,5,22,23,-1,11,13,15
34170,19048,19050,17,14,12,1,7,4,11,17,-6,9,15,10
34171,19048,19050,56,5,12,6,3,3,14,11,3,15,9,21
34172,19048,19050,35,12,12,4,2,6,16,21,-5,10,14,14
34173,19048,19050,12,8,12,5,3,4,20,18,2,13,11,18
34174,19167,19180,12,6,28,13,8,7,50,37,13,34,22,47
34175,19167,19180,56,9,28,11,5,12,31,29,2,27,29,38
34176,19167,19180,35,15,28,5,5,18,26,57,-31,15,41,20
34177,19167,19180,42,8,28,12,5,11,44,47,-3,29,27,41
34178,19167,19180,17,14,28,4,11,13,27,50,-23,19,37,23
34179,19167,19180,1,4,28,13,9,6,61,42,19,35,21,48
34180,19167,19180,49,5,28,14,5,9,50,31,19,33,23,47
34181,19167,19180,16,10,28,8,11,9,46,47,-1,27,29,35
34182,19167,19180,4,11,28,8,9,11,30,36,-6,25,31,33
34183,19167,19180,45,2,28,18,6,4,45,25,20,42,14,60
34184,19167,19180,27,12,28,9,3,16,26,48,-22,21,35,30
34185,19167,19180,10,13,28,6,9,13,25,44,-19,21,35,27
34186,19167,19180,43,1,28,19,6,3,67,26,41,44,12,63
34187,19167,19180,22,3,28,13,10,5,55,37,18,36,20,49
34188,19167,19180,24,7,28,12,5,11,42,38,4,29,27,41
34189,19167,19180,57,16,28,3,5,20,28,59,-31,11,45,14
34190,18992,19005,4,3,6,3,2,1,9,6,3,8,4,11
34191,18992,19005,43,2,6,3,3,0,10,5,5,9,3,12
34192,18992,19005,22,7,6,2,4,0,11,8,3,8,4,10
34193,18992,19005,24,13,6,1,2,3,10,12,-2,4,8,5
34194,18992,19005,57,16,6,0,1,5,6,16,-10,1,11,1
34195,18992,19005,45,5,6,3,1,2,9,8,1,7,5,10
34196,18992,19005,10,14,6,1,1,4,5,10,-5,3,9,4
34197,18992,19005,27,15,6,1,1,4,6,14,-8,3,9,4
34198,18992,19005,1,1,6,5,1,0,17,8,9,11,1,16
34199,18992,19005,42,8,6,2,2,2,14,12,2,6,6,8
34200,18992,19005,17,11,6,1,4,1,6,5,1,6,6,7
34201,18992,19005,56,6,6,3,1,2,6,6,0,7,5,10
34202,18992,19005,35,10,6,2,1,3,8,9,-1,5,7,7
34203,18992,19005,12,9,6,2,1,3,9,9,0,5,7,7
34204,18992,19005,49,4,6,3,1,2,14,10,4,7,5,10
34205,18992,19005,16,12,6,1,4,1,10,12,-2,6,6,7
34206,19440,19446,22,4,16,10,2,4,28,17,11,22,10,32
34207,19440,19446,43,5,16,10,1,5,39,19,20,21,11,31
34208,19440,19446,57,9,16,5,5,6,17,26,-9,15,17,20
34209,19440,19446,24,12,16,4,4,8,21,30,-9,12,20,16
34210,19440,19446,12,6,16,8,2,6,29,23,6,18,14,26
34211,19440,19446,56,7,16,8,2,6,22,18,4,18,14,26
34212,18593,18599,17,6,1,0,1,0,1,1,0,1,1,1
34213,18593,18599,42,6,1,0,1,0,1,1,0,1,1,1
34214,18593,18599,28,12,1,0,0,1,1,2,-1,0,2,0
34215,18593,18599,12,10,1,0,1,0,0,0,0,1,1,1
34216,18593,18599,25,16,1,0,0,1,0,5,-5,0,2,0
34217,18593,18599,56,6,1,0,1,0,1,1,0,1,1,1
34218,18593,18599,35,15,1,0,0,1,1,3,-2,0,2,0
34219,18593,18599,45,10,1,0,1,0,0,0,0,1,1,1
34220,18733,18742,43,1,18,12,3,3,36,17,19,27,9,39
34221,18733,18742,57,6,18,8,6,4,22,16,6,22,14,30
34222,18733,18742,22,7,18,7,6,5,32,24,8,20,16,27
34223,18733,18742,24,10,18,5,5,8,22,33,-11,15,21,20
34224,18733,18742,45,14,18,2,9,7,19,27,-8,13,23,15
34225,18733,18742,12,12,18,4,7,7,25,28,-3,15,21,19
34226,18733,18742,25,15,18,3,4,11,16,31,-15,10,26,13
34227,18733,18742,42,8,18,7,5,6,34,31,3,19,17,26
34228,18733,18742,17,13,18,3,7,8,14,25,-11,13,23,16
34229,18733,18742,49,4,18,8,7,3,23,21,2,23,13,31
34230,18733,18742,16,11,18,5,4,9,22,32,-10,14,22,19
34231,18733,18742,56,5,18,9,3,6,24,21,3,21,15,30
34232,18733,18742,35,9,18,6,6,6,29,26,3,18,18,24
34233,18733,18742,1,3,18,10,4,4,31,21,10,24,12,34
34234,18733,18742,28,16,18,2,5,11,24,40,-16,9,27,11
34235,18733,18742,4,2,18,11,3,4,39,19,20,25,11,36
34236,19153,19159,43,1,26,18,5,3,63,24,39,41,11,59
34237,19153,19159,22,5,26,12,9,5,53,37,16,33,19,45
34238,19153,19159,24,8,26,11,5,10,39,36,3,27,25,38
34239,19153,19159,57,16,26,3,5,18,28,56,-28,11,41,14
34240,19153,19159,4,12,26,6,9,11,26,36,-10,21,31,27
34241,19153,19159,1,3,26,13,7,6,58,39,19,33,19,46
34242,19153,19159,35,15,26,5,4,17,24,53,-29,14,38,19
34243,19153,19159,49,6,26,13,4,9,49,31,18,30,22,43
34244,19153,19159,16,10,26,7,10,9,43,45,-2,24,28,31
34245,19153,19159,42,9,26,11,5,10,43,45,-2,27,25,38
34246,19153,19159,17,14,26,3,11,12,24,47,-23,17,35,20
34247,19153,19159,12,4,26,13,6,7,49,36,13,32,20,45
34248,19153,19159,56,7,26,11,5,10,31,26,5,27,25,38
34249,19153,19159,45,2,26,16,6,4,42,25,17,38,14,54
34250,19153,19159,27,11,26,9,3,14,26,45,-19,21,31,30
34251,19153,19159,10,13,26,6,8,12,25,42,-17,20,32,26
34252,18978,18984,45,2,4,3,1,0,7,2,5,7,1,10
34253,18978,18984,27,12,4,1,0,3,5,11,-6,2,6,3
34254,18978,18984,10,16,4,0,1,3,2,8,-6,1,7,1
34255,18978,18984,42,8,4,1,2,1,9,7,2,4,4,5
34256,18978,18984,17,13,4,0,3,1,2,4,-2,3,5,3
34257,18978,18984,49,4,4,2,1,1,9,4,5,5,3,7
34258,18978,18984,16,10,4,1,2,1,8,10,-2,4,4,5
34259,18978,18984,56,11,4,1,1,2,3,5,-2,3,5,4
34260,18978,18984,35,15,4,0,1,3,4,9,-5,1,7,1
34261,18978,18984,12,5,4,2,1,1,8,6,2,5,3,7
34262,18978,18984,1,1,4,3,1,0,10,5,5,7,1,10
34263,18978,18984,4,6,4,2,1,1,6,4,2,5,3,7
34264,18978,18984,43,2,4,3,1,0,7,2,5,7,1,10
34265,18978,18984,22,7,4,1,3,0,7,6,1,5,3,6
34266,18978,18984,24,9,4,1,2,1,8,7,1,4,4,5
34267,18978,18984,57,14,4,0,1,3,6,11,-5,1,7,1
34268,19419,19425,22,2,14,10,2,2,28,12,16,22,6,32
34269,19419,19425,43,5,14,9,1,4,37,17,20,19,9,28
34270,19419,19425,57,8,14,4,5,5,12,21,-9,13,15,17
34271,19419,19425,24,9,14,4,4,6,20,23,-3,12,16,16
34272,19419,19425,4,11,14,3,6,5,16,22,-6,12,16,15
34273,19419,19425,9,14,14,2,3,9,9,25,-16,7,21,9
34274,19419,19425,1,3,14,9,2,3,22,14,8,20,8,29
34275,19419,19425,45,4,14,8,5,1,29,21,8,21,7,29
34276,19419,19425,27,10,14,3,6,5,17,21,-4,12,16,15
34277,19419,19425,49,1,14,10,3,1,29,9,20,23,5,33
34278,19419,19425,16,13,14,2,5,7,17,26,-9,9,19,11
34279,19419,19425,56,6,14,8,1,5,20,14,6,17,11,25
34280,19419,19425,17,12,14,4,2,8,11,23,-12,10,18,14
34281,19419,19425,42,16,14,0,3,11,11,26,-15,3,25,3
34282,19419,19425,10,15,14,1,6,7,11,20,-9,8,20,9
34283,19419,19425,12,7,14,7,2,5,25,20,5,16,12,23
34284,19454,19460,12,6,18,9,2,7,31,24,7,20,16,29
34285,19454,19460,45,4,18,10,7,1,36,24,12,27,9,37
34286,19454,19460,27,10,18,4,8,6,20,24,-4,16,20,20
34287,19454,19460,10,15,18,1,7,10,11,26,-15,9,27,10
34288,19454,19460,17,12,18,5,2,11,16,35,-19,12,24,17
34289,19454,19460,42,16,18,1,4,13,13,30,-17,6,30,7
34290,19454,19460,56,7,18,8,4,6,24,20,4,20,16,28
34291,19454,19460,49,1,18,12,5,1,35,9,26,29,7,41
34292,19692,19698,45,6,2,1,0,1,3,2,1,2,2,3
34293,19832,19838,56,3,20,11,1,8,33,28,5,23,17,34
34294,19832,19838,17,16,20,3,5,12,20,41,-21,11,29,14
34295,19832,19838,1,1,20,11,8,1,48,21,27,30,10,41
34296,19832,19838,43,2,20,10,7,3,35,24,11,27,13,37
34297,19832,19838,22,4,20,8,8,4,26,20,6,24,16,32
34298,19832,19838,24,13,20,5,7,8,23,29,-6,17,23,22
34299,19832,19838,57,15,20,4,5,11,13,30,-17,13,27,17
34300,19832,19838,4,6,20,8,7,5,29,19,10,23,17,31
34301,19832,19838,9,9,20,8,4,8,27,28,-1,20,20,28
34302,19832,19838,27,5,20,9,4,7,34,26,8,22,18,31
34303,19832,19838,45,10,20,7,4,9,26,31,-5,18,22,25
34304,19832,19838,10,14,20,6,2,12,20,33,-13,14,26,20
34305,19832,19838,49,7,20,9,3,8,32,32,0,21,19,30
34306,19832,19838,12,8,20,7,8,5,29,22,7,22,18,29
34307,19832,19838,25,12,20,5,8,7,32,41,-9,18,22,23
34308,19832,19838,38,11,20,6,5,9,30,32,-2,17,23,23
34309,19867,19873,38,13,23,6,5,12,31,38,-7,17,29,23
34310,19867,19873,4,3,23,11,7,5,38,23,15,29,17,40
34311,19867,19873,9,9,23,8,5,10,30,39,-9,21,25,29
34312,19867,19873,12,8,23,8,9,6,31,25,6,25,21,33
34313,19867,19873,25,11,23,6,9,8,36,47,-11,21,25,27
34314,19867,19873,49,5,23,11,4,8,37,33,4,26,20,37
34315,19867,19873,27,7,23,10,5,8,37,29,8,25,21,35
34316,19867,19873,45,10,23,8,4,11,31,38,-7,20,26,28
34317,19867,19873,10,15,23,6,3,14,22,38,-16,15,31,21
34318,19867,19873,43,2,23,12,7,4,42,26,16,31,15,43
34319,19867,19873,22,6,23,9,10,4,30,22,8,28,18,37
34320,19867,19873,24,12,23,6,8,9,25,31,-6,20,26,26
34321,19867,19873,1,1,23,13,9,1,58,22,36,35,11,48
34322,19867,19873,57,14,23,6,5,12,16,33,-17,17,29,23
34323,19867,19873,17,16,23,3,6,14,21,51,-30,12,34,15
34324,19867,19873,56,4,23,12,2,9,42,32,10,26,20,38
34325,19881,19887,56,3,25,14,2,9,47,32,15,30,20,44
34326,19881,19887,17,16,25,4,6,15,26,56,-30,14,36,18
34327,19881,19887,43,2,25,13,8,4,44,26,18,34,16,47
34328,19881,19887,22,6,25,10,10,5,31,23,8,30,20,40
34329,19881,19887,24,12,25,6,10,9,27,33,-6,22,28,28
34330,19881,19887,57,14,25,6,5,14,16,36,-20,17,33,23
34331,19881,19887,1,1,25,14,9,2,60,24,36,37,13,51
34332,19881,19887,27,7,25,11,6,8,38,29,9,28,22,39
34333,19881,19887,45,10,25,8,5,12,33,41,-8,21,29,29
34334,19881,19887,10,15,25,6,4,15,24,41,-17,16,34,22
34335,19881,19887,49,5,25,13,4,8,43,35,8,30,20,43
34336,19881,19887,12,8,25,9,10,6,35,28,7,28,22,37
34337,19881,19887,25,9,25,7,9,9,37,51,-14,23,27,30
34338,19881,19887,4,4,25,12,8,5,45,26,19,32,18,44
34339,19881,19887,9,11,25,8,5,12,30,42,-12,21,29,29
34340,19881,19887,38,13,25,6,5,14,31,44,-13,17,33,23
34341,19909,19915,4,3,29,15,9,5,50,28,22,39,19,54
34342,19909,19915,9,10,29,10,5,14,36,51,-15,25,33,35
34343,19909,19915,38,13,29,7,5,17,32,49,-17,19,39,26
34344,19909,19915,12,8,29,10,11,8,38,32,6,31,27,41
34345,19909,19915,25,11,29,8,9,12,41,60,-19,25,33,33
34346,19909,19915,49,5,29,15,5,9,48,39,9,35,23,50
34347,19909,19915,27,7,29,13,7,9,42,31,11,33,25,46
34348,19909,19915,45,12,29,8,7,14,40,50,-10,23,35,31
34349,19909,19915,10,14,29,7,4,18,30,49,-19,18,40,25
34350,19909,19915,43,2,29,16,9,4,50,28,22,41,17,57
34351,19909,19915,22,6,29,13,10,6,38,27,11,36,22,49
34352,19909,19915,24,9,29,9,11,9,34,37,-3,29,29,38
34353,19909,19915,57,15,29,6,6,17,19,42,-23,18,40,24
34354,19909,19915,1,1,29,16,10,3,66,27,39,42,16,58
34355,19909,19915,17,16,29,5,6,18,30,63,-33,16,42,21
34356,19909,19915,56,4,29,16,2,11,54,35,19,34,24,50
34357,20154,20167,56,7,15,5,6,4,14,12,2,16,14,21
34358,20154,20167,1,4,15,9,1,5,28,16,12,19,11,28
34359,20154,20167,45,5,15,7,4,4,29,24,5,18,12,25
34360,20154,20167,27,8,15,5,6,4,17,16,1,16,14,21
34361,20154,20167,10,10,15,5,2,8,21,30,-9,12,18,17
34362,20154,20167,43,3,15,8,5,2,24,11,13,21,9,29
34363,20154,20167,22,9,15,6,2,7,17,19,-2,14,16,20
34364,20154,20167,24,13,15,4,3,8,21,26,-5,11,19,15
34365,20154,20167,12,12,15,4,3,8,15,19,-4,11,19,15
34366,20154,20167,25,16,15,2,6,7,18,29,-11,10,20,12
34367,20154,20167,49,11,15,5,2,8,18,29,-11,12,18,17
34368,20154,20167,16,15,15,3,3,9,14,26,-12,9,21,12
34369,20154,20167,9,1,15,9,4,2,30,16,14,22,8,31
34370,19440,19446,17,11,16,5,2,9,15,27,-12,12,20,17
34371,19440,19446,42,16,16,0,3,13,11,29,-18,3,29,3
34372,19440,19446,1,3,16,10,3,3,25,14,11,23,9,33
34373,19440,19446,4,8,16,5,6,5,19,22,-3,16,16,21
34374,19440,19446,9,13,16,4,3,9,15,25,-10,11,21,15
34375,19440,19446,45,2,16,10,5,1,34,22,12,25,7,35
34376,19440,19446,27,10,16,4,6,6,19,23,-4,14,18,18
34377,19440,19446,10,15,16,1,6,9,11,24,-13,8,24,9
34378,19440,19446,49,1,16,11,4,1,30,9,21,26,6,37
34379,19440,19446,16,14,16,3,6,7,20,27,-7,12,20,15
34380,19447,19453,49,1,17,12,4,1,35,9,26,28,6,40
34381,19447,19453,16,14,17,3,6,8,20,30,-10,12,22,15
34382,19447,19453,45,3,17,10,6,1,35,23,12,26,8,36
34383,19447,19453,27,10,17,4,7,6,19,23,-4,15,19,19
34384,19447,19453,10,15,17,1,7,9,11,24,-13,9,25,10
34385,19447,19453,4,8,17,6,6,5,20,22,-2,18,16,24
34386,19447,19453,9,13,17,4,3,10,15,27,-12,11,23,15
34387,19447,19453,17,11,17,5,2,10,15,32,-17,12,22,17
34388,19447,19453,42,16,17,1,3,13,12,29,-17,5,29,6
34389,19447,19453,56,6,17,8,3,6,23,19,4,19,15,27
34390,19447,19453,12,7,17,8,2,7,29,24,5,18,16,26
34391,19447,19453,1,2,17,11,3,3,27,14,13,25,9,36
34392,19447,19453,22,4,17,11,2,4,31,17,14,24,10,35
34393,19447,19453,43,5,17,11,1,5,41,20,21,23,11,34
34394,19447,19453,57,9,17,5,5,7,18,28,-10,15,19,20
34395,19447,19453,24,12,17,4,4,9,21,31,-10,12,22,16
34396,19538,19544,1,2,28,18,5,5,51,27,24,41,15,59
34397,19538,19544,17,11,28,9,4,15,34,50,-16,22,34,31
34398,19538,19544,42,16,28,5,4,19,25,48,-23,14,42,19
34399,19538,19544,12,5,28,14,5,9,46,30,16,33,23,47
34400,19538,19544,56,8,28,10,7,11,40,42,-2,27,29,37
34401,19538,19544,45,4,28,13,10,5,49,37,12,36,20,49
34402,19538,19544,27,13,28,7,9,12,32,40,-8,23,33,30
34403,19538,19544,10,14,28,6,11,11,27,34,-7,23,33,29
34404,19538,19544,4,7,28,11,8,9,35,35,0,30,26,41
34405,19538,19544,9,9,28,9,6,13,28,42,-14,24,32,33
34406,19538,19544,43,3,28,17,3,8,57,30,27,37,19,54
34407,19538,19544,22,6,28,13,2,13,37,36,1,28,28,41
34408,19538,19544,57,10,28,9,6,13,28,49,-21,24,32,33
34409,19538,19544,24,12,28,8,7,13,34,46,-12,23,33,31
34410,19538,19544,49,1,28,19,6,3,56,16,40,44,12,63
34411,19538,19544,16,15,28,5,9,14,27,44,-17,19,37,24
34412,19776,19779,49,10,12,4,3,5,21,23,-2,11,13,15
34413,19776,19779,38,12,12,3,5,4,18,17,1,11,13,14
34414,19776,19779,4,3,12,5,5,2,18,12,6,15,9,20
34415,19776,19779,9,11,12,4,3,5,15,18,-3,11,13,15
34416,19776,19779,27,9,12,4,3,5,15,16,-1,11,13,15
34417,19776,19779,10,15,12,3,2,7,11,15,-4,8,16,11
34418,19776,19779,45,16,12,2,3,7,14,23,-9,7,17,9
34419,19776,19779,1,2,12,5,6,1,24,13,11,16,8,21
34420,19776,19779,56,8,12,5,1,6,16,20,-4,11,13,16
34421,19776,19779,17,14,12,3,3,6,14,22,-8,9,15,12
34422,19776,19779,25,4,12,5,5,2,24,20,4,15,9,20
34423,19776,19779,12,5,12,5,4,3,18,15,3,14,10,19
34424,19776,19779,43,1,12,6,5,1,19,12,7,17,7,23
34425,19776,19779,22,6,12,4,7,1,15,12,3,15,9,19
34426,19776,19779,24,7,12,5,2,5,20,18,2,12,12,17
34427,19776,19779,57,13,12,3,3,6,10,16,-6,9,15,12
34428,19780,19782,43,1,13,7,5,1,22,14,8,19,7,26
34429,19780,19782,22,5,13,5,7,1,18,12,6,17,9,22
34430,19780,19782,24,7,13,5,3,5,21,19,2,13,13,18
34431,19780,19782,57,13,13,3,3,7,10,17,-7,9,17,12
34432,19780,19782,1,2,13,6,6,1,28,14,14,18,8,24
34433,19780,19782,12,4,13,6,4,3,23,17,6,16,10,22
34434,19780,19782,25,6,13,5,5,3,24,24,0,15,11,20
34435,19780,19782,17,14,13,3,3,7,14,25,-11,9,17,12
34436,19780,19782,56,10,13,5,1,7,18,23,-5,11,15,16
34437,19780,19782,27,11,13,4,3,6,17,21,-4,11,15,15
34438,19780,19782,10,15,13,3,2,8,12,19,-7,8,18,11
34439,19780,19782,45,16,13,2,4,7,15,24,-9,8,18,10
34440,19780,19782,4,3,13,6,5,2,22,13,9,17,9,23
34441,19780,19782,9,8,13,5,3,5,19,18,1,13,13,18
34442,19780,19782,38,12,13,3,5,5,19,21,-2,11,15,14
34443,19780,19782,49,9,13,5,3,5,22,23,-1,13,13,18
34444,19783,19789,49,6,14,6,3,5,24,23,1,15,13,21
34445,19783,19789,38,11,14,4,5,5,22,22,0,13,15,17
34446,19783,19789,4,2,14,7,5,2,23,13,10,19,9,26
34447,19783,19789,9,10,14,5,3,6,19,19,0,13,15,18
34448,19783,19789,27,12,14,4,4,6,17,21,-4,12,16,16
34449,19454,19460,16,14,18,3,7,8,20,30,-10,13,23,16
34450,19454,19460,1,2,18,12,3,3,30,14,16,27,9,39
34451,19454,19460,4,8,18,7,6,5,23,23,0,20,16,27
34452,19454,19460,9,11,18,5,3,10,17,27,-10,13,23,18
34453,19454,19460,43,3,18,12,1,5,43,20,23,25,11,37
34454,19454,19460,22,5,18,11,2,5,31,19,12,24,12,35
34455,19454,19460,57,9,18,5,5,8,18,30,-12,15,21,20
34456,19454,19460,24,13,18,4,4,10,21,34,-13,12,24,16
34457,19524,19530,22,6,26,13,2,11,37,32,5,28,24,41
34458,19524,19530,57,11,26,8,6,12,25,43,-18,22,30,30
34459,19524,19530,24,12,26,7,7,12,31,43,-12,21,31,28
34460,19524,19530,4,7,26,9,8,9,30,32,-2,26,26,35
34461,19524,19530,9,10,26,8,6,12,25,37,-12,22,30,30
34462,19524,19530,1,2,26,16,5,5,45,25,20,37,15,53
34463,19524,19530,49,1,26,19,6,1,54,12,42,44,8,63
34464,19524,19530,16,15,26,5,8,13,25,39,-14,18,34,23
34465,19524,19530,56,8,26,9,7,10,35,40,-5,25,27,34
34466,19524,19530,17,9,26,9,3,14,32,47,-15,21,31,30
34467,19524,19530,42,16,26,3,4,19,20,47,-27,10,42,13
34468,19524,19530,43,3,26,16,3,7,54,28,26,35,17,51
34469,19524,19530,45,4,26,13,9,4,45,32,13,35,17,48
34470,19524,19530,27,13,26,6,9,11,28,36,-8,21,31,27
34471,19524,19530,10,14,26,5,10,11,23,32,-9,20,32,25
34472,19524,19530,12,5,26,13,5,8,44,28,16,31,21,44
34473,19769,19775,12,4,11,5,3,3,16,13,3,13,9,18
34474,19769,19775,25,5,11,4,5,2,22,19,3,13,9,17
34475,19769,19775,38,10,11,3,4,4,16,15,1,10,12,13
34476,19769,19775,27,11,11,3,3,5,13,16,-3,9,13,12
34477,19769,19775,10,14,11,3,2,6,11,14,-3,8,14,11
34478,19769,19775,45,16,11,2,3,6,13,21,-8,7,15,9
34479,19769,19775,49,12,11,3,3,5,19,23,-4,9,13,12
34480,19769,19775,56,6,11,5,1,5,15,18,-3,11,11,16
34481,19769,19775,43,1,11,6,5,0,19,10,9,17,5,23
34482,19769,19775,22,7,11,3,7,1,14,12,2,13,9,16
34483,19769,19775,24,9,11,4,2,5,19,18,1,10,12,14
34484,19769,19775,57,15,11,2,3,6,8,15,-7,7,15,9
34485,19769,19775,17,13,11,3,3,5,14,21,-7,9,13,12
34486,19769,19775,4,3,11,5,4,2,16,10,6,14,8,19
34487,19769,19775,9,8,11,4,3,4,15,16,-1,11,11,15
34488,19769,19775,1,2,11,5,5,1,22,11,11,15,7,20
34489,19804,19810,4,3,16,8,5,3,27,15,12,21,11,29
34490,19804,19810,9,9,16,6,3,7,23,24,-1,15,17,21
34491,19804,19810,1,1,16,8,7,1,37,16,21,23,9,31
34492,19804,19810,56,5,16,8,1,7,26,24,2,17,15,25
34493,19804,19810,49,7,16,7,3,6,28,26,2,17,15,24
34494,19804,19810,17,16,16,3,3,10,15,29,-14,9,23,12
34495,19804,19810,27,8,16,6,4,6,22,22,0,16,16,22
34496,19804,19810,45,13,16,4,4,8,21,28,-7,12,20,16
34497,19804,19810,10,14,16,4,2,10,15,26,-11,10,22,14
34498,19804,19810,43,2,16,8,6,2,26,18,8,22,10,30
34499,19804,19810,22,6,16,6,7,3,21,16,5,19,13,25
34500,19804,19810,24,12,16,5,4,7,22,25,-3,14,18,19
34501,19804,19810,57,15,16,3,4,9,11,26,-15,10,22,13
34502,19804,19810,38,11,16,5,5,6,24,25,-1,15,17,20
34503,19804,19810,12,4,16,7,6,3,27,18,9,20,12,27
34504,19804,19810,25,10,16,5,6,5,25,32,-7,16,16,21
34505,19811,19817,12,5,17,7,7,3,28,19,9,21,13,28
34506,19811,19817,25,10,17,5,6,6,27,35,-8,16,18,21
34507,19811,19817,38,11,17,5,5,7,25,27,-2,15,19,20
34508,19811,19817,43,2,17,8,7,2,28,20,8,23,11,31
34509,19811,19817,22,6,17,7,7,3,22,16,6,21,13,28
34510,19811,19817,24,12,17,5,5,7,22,25,-3,15,19,20
34511,19811,19817,57,16,17,3,4,10,11,27,-16,10,24,13
34512,19811,19817,27,7,17,7,4,6,25,24,1,18,16,25
34513,19811,19817,45,13,17,5,4,8,23,29,-6,14,20,19
34514,19811,19817,10,14,17,5,2,10,17,27,-10,12,22,17
34515,19811,19817,17,15,17,3,4,10,16,30,-14,10,24,13
34516,19811,19817,49,8,17,7,3,7,28,28,0,17,17,24
34517,19811,19817,56,4,17,9,1,7,28,24,4,19,15,28
34518,19811,19817,1,1,17,8,8,1,39,18,21,24,10,32
34519,19811,19817,4,3,17,8,5,4,28,17,11,21,13,29
34520,19811,19817,9,9,17,6,4,7,23,24,-1,16,18,22
34521,19860,19866,1,1,22,12,9,1,55,22,33,33,11,45
34522,19860,19866,56,3,22,12,1,9,42,32,10,25,19,37
34523,19860,19866,49,6,22,10,4,8,35,33,2,24,20,34
34524,19860,19866,4,4,22,10,7,5,35,22,13,27,17,37
34525,19860,19866,9,9,22,8,5,9,29,36,-7,21,23,29
34526,19860,19866,17,16,22,3,5,14,20,50,-30,11,33,14
34527,19860,19866,27,5,22,10,4,8,37,29,8,24,20,34
34528,19860,19866,45,10,22,8,4,10,30,35,-5,20,24,28
34529,19860,19866,10,15,22,6,2,14,21,37,-16,14,30,20
34530,19860,19866,43,2,22,12,7,3,42,24,18,31,13,43
34531,19860,19866,22,7,22,8,10,4,28,22,6,26,18,34
34532,19860,19866,24,11,22,6,8,8,25,30,-5,20,24,26
34533,19860,19866,57,14,22,6,5,11,16,30,-14,17,27,23
34534,19860,19866,38,13,22,6,5,11,31,36,-5,17,27,23
34535,19860,19866,12,8,22,7,9,6,30,25,5,23,21,30
34536,19860,19866,25,12,22,5,9,8,33,46,-13,19,25,24
34537,20049,20055,25,8,1,0,1,0,1,1,0,1,1,1
34538,20049,20055,12,14,1,0,0,1,1,3,-2,0,2,0
34539,20049,20055,22,1,1,1,0,0,3,1,2,2,0,3
34540,20049,20055,43,4,1,1,0,0,3,2,1,2,0,3
34541,20049,20055,24,14,1,0,0,1,1,3,-2,0,2,0
34542,20049,20055,45,1,1,1,0,0,3,1,2,2,0,3
34543,20049,20055,27,5,1,1,0,0,2,1,1,2,0,3
34544,20049,20055,10,10,1,0,0,1,2,3,-1,0,2,0
34545,20049,20055,4,8,1,0,1,0,1,1,0,1,1,1
34546,20049,20055,49,11,1,0,0,1,1,2,-1,0,2,0
34547,20049,20055,16,14,1,0,0,1,1,3,-2,0,2,0
34548,20049,20055,28,5,1,1,0,0,2,1,1,2,0,3
34549,20049,20055,38,11,1,0,0,1,1,2,-1,0,2,0
34550,20049,20055,56,5,1,1,0,0,2,1,1,2,0,3
34551,20049,20055,1,11,1,0,0,1,1,2,-1,0,2,0
34552,20049,20055,9,1,1,1,0,0,3,1,2,2,0,3
34553,20140,20143,43,1,12,7,4,1,21,9,12,18,6,25
34554,20140,20143,22,4,12,6,2,4,15,13,2,14,10,20
34555,20140,20143,24,12,12,3,3,6,18,23,-5,9,15,12
34556,20140,20143,1,6,12,6,1,5,23,16,7,13,11,19
34557,20140,20143,56,9,12,4,4,4,10,9,1,12,12,16
34558,20140,20143,16,13,12,3,3,6,14,19,-5,9,15,12
34559,20140,20143,49,15,12,3,2,7,15,27,-12,8,16,11
34560,20140,20143,9,2,12,7,3,2,23,13,10,17,7,24
34561,20140,20143,4,3,12,6,6,0,22,11,11,18,6,24
34562,20140,20143,45,5,12,6,2,4,21,20,1,14,10,20
34563,20140,20143,10,8,12,5,1,6,19,25,-6,11,13,16
34564,20140,20143,27,10,12,3,5,4,12,14,-2,11,13,14
34565,20140,20143,12,14,12,3,2,7,11,16,-5,8,16,11
34566,20140,20143,25,16,12,2,4,6,14,23,-9,8,16,10
34567,20140,20143,28,7,12,5,2,5,15,14,1,12,12,17
34568,20140,20143,38,11,12,3,4,5,18,19,-1,10,14,13
34569,20245,20251,12,11,25,7,7,11,28,32,-4,21,29,28
34570,20245,20251,25,16,25,5,8,12,29,49,-20,18,32,23
34571,20245,20251,45,6,25,10,7,8,44,42,2,27,23,37
34572,20245,20251,27,7,25,10,7,8,31,29,2,27,23,37
34573,20245,20251,10,13,25,7,5,13,35,48,-13,19,31,26
34574,20245,20251,43,3,25,13,9,3,41,23,18,35,15,48
34575,20245,20251,22,5,25,11,5,9,28,24,4,27,23,38
34576,20245,20251,24,12,25,7,6,12,38,46,-8,20,30,27
34577,20245,20251,49,8,25,10,4,11,33,41,-8,24,26,34
34578,20245,20251,16,14,25,6,6,13,33,44,-11,18,32,24
34579,20245,20251,56,10,25,7,8,10,24,31,-7,22,28,29
34580,20245,20251,28,9,25,8,5,12,26,35,-9,21,29,29
34581,20245,20251,38,15,25,5,8,12,32,42,-10,18,32,23
34582,20245,20251,1,1,25,17,1,7,50,27,23,35,15,52
34583,20245,20251,4,2,25,15,7,3,47,21,26,37,13,52
34584,20245,20251,9,4,25,12,7,6,46,31,15,31,19,43
34585,20063,20069,1,7,3,1,1,1,4,2,2,3,3,4
34586,20063,20069,28,3,3,2,1,0,5,2,3,5,1,7
34587,20063,20069,38,16,3,0,0,3,2,7,-5,0,6,0
34588,20063,20069,56,11,3,1,1,1,3,3,0,3,3,4
34589,20063,20069,24,13,3,1,0,2,4,7,-3,2,4,3
34590,20063,20069,49,4,3,2,0,1,4,3,1,4,2,6
34591,20063,20069,16,15,3,0,0,3,3,8,-5,0,6,0
34592,20063,20069,9,1,3,2,1,0,6,3,3,5,1,7
34593,20063,20069,4,6,3,1,2,0,3,2,1,4,2,5
34594,20063,20069,27,5,3,1,2,0,4,3,1,4,2,5
34595,20063,20069,45,8,3,1,1,1,4,3,1,3,3,4
34596,20063,20069,10,12,3,1,0,2,4,5,-1,2,4,3
34597,20063,20069,43,1,3,2,1,0,6,3,3,5,1,7
34598,20063,20069,22,9,3,1,1,1,3,2,1,3,3,4
34599,20063,20069,25,10,3,1,1,1,5,5,0,3,3,4
34600,20063,20069,12,14,3,0,2,1,3,5,-2,2,4,2
34601,20077,20083,25,12,5,1,2,2,6,7,-1,4,6,5
34602,20077,20083,12,13,5,1,2,2,5,6,-1,4,6,5
34603,20077,20083,28,2,5,3,1,1,8,4,4,7,3,10
34604,20077,20083,38,16,5,0,2,3,6,11,-5,2,8,2
34605,20077,20083,56,14,5,1,2,2,4,5,-1,4,6,5
34606,20077,20083,45,5,5,2,1,2,7,5,2,5,5,7
34607,20077,20083,10,7,5,2,1,2,9,9,0,5,5,7
34608,19783,19789,10,13,14,4,2,8,13,19,-6,10,18,14
34609,19783,19789,45,14,14,3,4,7,17,24,-7,10,18,13
34610,19783,19789,56,8,14,6,1,7,22,23,-1,13,15,19
34611,19783,19789,17,16,14,3,3,8,14,26,-12,9,19,12
34612,19783,19789,12,4,14,6,5,3,24,18,6,17,11,23
34613,19783,19789,25,7,14,5,5,4,25,27,-2,15,13,20
34614,19783,19789,1,3,14,6,7,1,28,14,14,19,9,25
34615,19783,19789,43,1,14,7,6,1,23,15,8,20,8,27
34616,19783,19789,22,5,14,5,7,2,18,14,4,17,11,22
34617,19783,19789,24,9,14,5,3,6,21,21,0,13,15,18
34618,19783,19789,57,15,14,3,3,8,10,21,-11,9,19,12
34619,19818,19824,57,15,18,3,5,10,11,27,-16,11,25,14
34620,19818,19824,1,1,18,9,8,1,41,19,22,26,10,35
34621,19818,19824,12,5,18,7,8,3,28,19,9,22,14,29
34622,19818,19824,25,11,18,5,6,7,28,37,-9,16,20,21
34623,19818,19824,17,16,18,3,4,11,17,32,-15,10,26,13
34624,19818,19824,56,2,18,10,1,7,31,24,7,21,15,31
34625,19818,19824,27,8,18,7,4,7,25,25,0,18,18,25
34626,19818,19824,10,12,18,6,2,10,19,28,-9,14,22,20
34627,19818,19824,45,14,18,5,4,9,24,31,-7,14,22,19
34628,19818,19824,43,3,18,8,7,3,30,24,6,23,13,31
34629,19818,19824,22,6,18,7,8,3,22,16,6,22,14,29
34630,19818,19824,24,13,18,5,5,8,22,28,-6,15,21,20
34631,19818,19824,4,4,18,8,6,4,28,17,11,22,14,30
34632,19818,19824,9,8,18,7,4,7,25,25,0,18,18,25
34633,19818,19824,38,10,18,6,5,7,29,29,0,17,19,23
34634,19818,19824,49,7,18,8,3,7,29,28,1,19,17,27
34635,19720,19733,49,8,6,2,2,2,11,11,0,6,6,8
34636,19720,19733,27,9,6,2,1,3,8,9,-1,5,7,7
34637,19720,19733,45,13,6,1,3,2,8,9,-1,5,7,6
34638,19720,19733,10,15,6,1,2,3,5,7,-2,4,8,5
34639,19720,19733,43,1,6,4,2,0,11,5,6,10,2,14
34640,19720,19733,22,11,6,1,4,1,7,8,-1,6,6,7
34641,19720,19733,24,12,6,2,0,4,8,11,-3,4,8,6
34642,19720,19733,38,2,6,3,2,1,14,8,6,8,4,11
34643,19720,19733,4,3,6,3,1,2,9,6,3,7,5,10
34644,19720,19733,9,4,6,3,1,2,6,5,1,7,5,10
34645,19720,19733,25,5,6,2,4,0,11,9,2,8,4,10
34646,19720,19733,12,7,6,2,2,2,5,4,1,6,6,8
34647,19720,19733,56,10,6,2,1,3,6,9,-3,5,7,7
34648,19720,19733,17,16,6,1,1,4,4,9,-5,3,9,4
34649,19720,19733,1,6,6,2,3,1,8,7,1,7,5,9
34650,19720,19733,57,14,6,1,3,2,3,7,-4,5,7,6
34651,19734,19740,43,1,7,4,3,0,13,7,6,11,3,15
34652,19734,19740,24,8,7,3,0,4,13,13,0,6,8,9
34653,19734,19740,57,9,7,2,3,2,4,7,-3,7,7,9
34654,19734,19740,22,12,7,1,5,1,8,9,-1,7,7,8
34655,19734,19740,1,6,7,2,4,1,9,8,1,8,6,10
34656,19734,19740,17,16,7,1,2,4,6,11,-5,4,10,5
34657,19734,19740,56,14,7,2,1,4,8,12,-4,5,9,7
34658,19734,19740,12,5,7,3,2,2,8,6,2,8,6,11
34659,19734,19740,25,7,7,2,4,1,13,14,-1,8,6,10
34660,19734,19740,4,2,7,4,1,2,10,6,4,9,5,13
34661,19734,19740,9,3,7,4,1,2,11,8,3,9,5,13
34662,19734,19740,38,4,7,3,2,2,14,9,5,8,6,11
34663,19734,19740,10,10,7,2,2,3,9,8,1,6,8,8
34664,19734,19740,27,13,7,2,1,4,8,10,-2,5,9,7
34665,19734,19740,45,15,7,1,3,3,9,13,-4,5,9,6
34666,19734,19740,49,11,7,2,2,3,14,16,-2,6,8,8
34667,20144,20146,10,10,13,5,1,7,19,26,-7,11,15,16
34668,20144,20146,49,11,13,4,2,7,17,28,-11,10,16,14
34669,20144,20146,16,14,13,3,3,7,14,21,-7,9,17,12
34670,20144,20146,28,7,13,5,2,6,15,18,-3,12,14,17
34671,20144,20146,38,12,13,3,5,5,20,21,-1,11,15,14
34672,20144,20146,9,1,13,8,3,2,26,15,11,19,7,27
34673,20144,20146,4,2,13,7,6,0,24,12,12,20,6,27
34674,20144,20146,43,3,13,7,5,1,22,10,12,19,7,26
34675,20144,20146,22,6,13,6,2,5,17,16,1,14,12,20
34676,20144,20146,24,13,13,3,3,7,19,25,-6,9,17,12
34677,20144,20146,45,4,13,7,2,4,25,20,5,16,10,23
34678,20144,20146,27,9,13,4,5,4,13,14,-1,13,13,17
34679,20144,20146,12,15,13,3,2,8,12,18,-6,8,18,11
34680,20144,20146,25,16,13,2,5,6,16,25,-9,9,17,11
34681,20144,20146,56,8,13,4,5,4,11,10,1,13,13,17
34682,20144,20146,1,5,13,7,1,5,25,16,9,15,11,22
34683,20147,20153,1,4,14,8,1,5,27,16,11,17,11,25
34684,20147,20153,56,8,14,4,6,4,13,12,1,14,14,18
34685,20147,20153,12,12,14,4,2,8,14,18,-4,10,18,14
34686,20147,20153,25,16,14,2,5,7,16,27,-11,9,19,11
34687,20147,20153,43,2,14,8,5,1,24,10,14,21,7,29
34688,20154,20167,4,2,15,8,6,1,27,15,12,22,8,30
34689,20154,20167,28,6,15,6,3,6,17,19,-2,15,15,21
34690,20154,20167,38,14,15,3,6,6,22,25,-3,12,18,15
34691,20497,20503,38,11,10,3,1,6,15,20,-5,7,13,10
34692,20497,20503,28,13,10,2,3,5,12,15,-3,7,13,9
34693,20497,20503,49,7,10,4,4,2,15,9,6,12,8,16
34694,20497,20503,4,4,10,5,3,2,17,9,8,13,7,18
34695,20497,20503,9,5,10,5,2,3,15,13,2,12,8,17
34696,20497,20503,1,6,10,5,1,4,13,9,4,11,9,16
34697,20497,20503,43,1,10,6,3,1,19,10,9,15,5,21
34698,20497,20503,22,9,10,4,2,4,13,15,-2,10,10,14
34699,20497,20503,24,10,10,3,3,4,13,13,0,9,11,12
34700,20497,20503,56,8,10,4,3,3,19,17,2,11,9,15
34701,20497,20503,45,2,10,6,2,2,18,10,8,14,6,20
34702,20497,20503,27,3,10,5,4,1,12,8,4,14,6,19
34703,20497,20503,10,14,10,2,3,5,12,17,-5,7,13,9
34704,20497,20503,15,16,10,2,1,7,13,26,-13,5,15,7
34705,20497,20503,12,12,10,3,1,6,8,13,-5,7,13,10
34706,20497,20503,25,15,10,2,2,6,13,23,-10,6,14,8
34707,20532,20538,56,8,15,6,6,3,26,22,4,18,12,24
34708,20532,20538,1,4,15,8,3,4,21,11,10,19,11,27
34709,20532,20538,43,6,15,7,4,4,26,18,8,18,12,25
34710,20532,20538,22,7,15,7,3,5,20,19,1,17,13,24
34711,20532,20538,24,10,15,6,4,5,19,16,3,16,14,22
34712,20532,20538,49,9,15,6,4,5,24,16,8,16,14,22
34713,20532,20538,12,13,15,3,3,9,12,21,-9,9,21,12
34714,20532,20538,25,16,15,2,3,10,15,36,-21,7,23,9
34715,20532,20538,9,2,15,8,4,3,28,18,10,20,10,28
34716,20532,20538,4,3,15,8,3,4,24,14,10,19,11,27
34717,20532,20538,38,14,15,3,2,10,16,27,-11,8,22,11
34718,20532,20538,28,15,15,2,4,9,16,25,-9,8,22,10
34719,20532,20538,45,1,15,10,3,2,27,13,14,23,7,33
34720,20532,20538,27,5,15,7,6,2,19,14,5,20,10,27
34721,20532,20538,15,11,15,4,3,8,23,35,-12,11,19,15
34722,20532,20538,10,12,15,3,5,7,15,26,-11,11,19,14
34723,20567,20573,45,2,20,11,6,3,32,20,12,28,12,39
34724,20567,20573,27,6,20,9,7,4,25,20,5,25,15,34
34725,20567,20573,10,13,20,4,7,9,19,31,-12,15,25,19
34726,20567,20573,15,14,20,4,5,11,29,49,-20,13,27,17
34727,20567,20573,28,12,20,5,4,11,22,30,-8,14,26,19
34728,20567,20573,38,15,20,3,3,14,17,41,-24,9,31,12
34729,20567,20573,9,4,20,10,6,4,38,22,16,26,14,36
34730,20567,20573,4,8,20,9,5,6,31,21,10,23,17,32
34731,20567,20573,12,11,20,6,5,9,20,25,-5,17,23,23
34732,20567,20573,25,16,20,2,6,12,20,45,-25,10,30,12
34733,20567,20573,49,7,20,9,6,5,37,22,15,24,16,33
34734,20567,20573,43,3,20,11,5,4,43,21,22,27,13,38
34735,20567,20573,24,5,20,10,4,6,28,23,5,24,16,34
34736,20567,20573,22,9,20,7,5,8,23,30,-7,19,21,26
34737,20567,20573,1,1,20,12,4,4,38,14,24,28,12,40
34738,20567,20573,56,10,20,6,6,8,28,36,-8,18,22,24
34739,20623,20629,56,10,27,8,6,13,36,50,-14,22,32,30
34740,20623,20629,1,1,27,17,4,6,48,20,28,38,16,55
34741,20623,20629,43,2,27,16,7,4,60,27,33,39,15,55
34742,20623,20629,24,5,27,13,5,9,36,29,7,31,23,44
34743,20623,20629,22,7,27,12,6,9,34,32,2,30,24,42
34744,20623,20629,49,9,27,10,10,7,43,33,10,30,24,40
34745,20623,20629,12,11,27,7,8,12,23,32,-9,22,32,29
34746,20623,20629,25,15,27,5,7,15,31,55,-24,17,37,22
34747,20623,20629,28,14,27,7,5,15,31,44,-13,19,35,26
34748,20623,20629,38,16,27,5,3,19,25,50,-25,13,41,18
34749,20623,20629,9,4,27,13,6,8,46,35,11,32,22,45
34750,20623,20629,4,8,27,11,8,8,36,26,10,30,24,41
34751,20623,20629,45,3,27,14,8,5,44,30,14,36,18,50
34752,20623,20629,27,6,27,12,8,7,32,28,4,32,22,44
34753,20623,20629,15,12,27,7,6,14,36,58,-22,20,34,27
34754,20623,20629,10,13,27,6,9,12,24,36,-12,21,33,27
34755,20476,20482,28,11,8,2,1,5,8,11,-3,5,11,7
34756,20476,20482,38,14,8,2,0,6,9,17,-8,4,12,6
34757,20476,20482,49,3,8,4,3,1,12,5,7,11,5,15
34758,20476,20482,4,4,8,4,3,1,14,8,6,11,5,15
34759,20476,20482,9,8,8,4,1,3,10,9,1,9,7,13
34760,20476,20482,43,2,8,4,3,1,17,10,7,11,5,15
34761,20476,20482,24,9,8,3,3,2,10,8,2,9,7,12
34762,20476,20482,22,10,8,3,1,4,9,12,-3,7,9,10
34763,20476,20482,1,7,8,4,1,3,12,8,4,9,7,13
34764,20476,20482,12,12,8,2,1,5,6,11,-5,5,11,7
34765,20476,20482,25,16,8,1,1,6,10,21,-11,3,13,4
34766,20476,20482,45,1,8,6,1,1,17,6,11,13,3,19
34767,20077,20083,27,11,5,1,3,1,4,5,-1,5,5,6
34768,20077,20083,9,1,5,4,1,0,11,5,6,9,1,13
34769,20077,20083,4,4,5,2,3,0,4,2,2,7,3,9
34770,20077,20083,43,3,5,3,1,1,8,6,2,7,3,10
34771,20077,20083,22,8,5,2,1,2,6,6,0,5,5,7
34772,20077,20083,24,10,5,2,0,3,6,10,-4,4,6,6
34773,20077,20083,49,8,5,2,1,2,6,6,0,5,5,7
34774,20077,20083,16,15,5,1,0,4,6,10,-4,2,8,3
34775,20077,20083,1,6,5,2,1,2,6,5,1,5,5,7
34776,20882,20895,49,9,14,5,4,5,15,18,-3,14,14,19
34777,20882,20895,56,15,14,2,5,7,13,22,-9,9,19,11
34778,20882,20895,43,3,14,7,4,3,20,16,4,18,10,25
34779,20882,20895,22,10,14,4,7,3,20,17,3,15,13,19
34780,20882,20895,21,6,14,5,5,4,21,20,1,15,13,20
34781,20882,20895,4,11,14,4,4,6,17,15,2,12,16,16
34782,20882,20895,9,13,14,4,2,8,20,22,-2,10,18,14
34783,20882,20895,15,16,14,2,4,8,23,39,-16,8,20,10
34784,20882,20895,27,2,14,8,4,2,24,16,8,20,8,28
34785,20882,20895,10,5,14,6,3,5,31,22,9,15,13,21
34786,20882,20895,45,7,14,6,1,7,26,26,0,13,15,19
34787,20882,20895,28,4,14,7,3,4,19,20,-1,17,11,24
34788,20882,20895,38,8,14,5,4,5,21,24,-3,14,14,19
34789,20882,20895,12,12,14,4,4,6,17,21,-4,12,16,16
34790,20882,20895,24,14,14,2,5,7,17,24,-7,9,19,11
34791,20882,20895,1,1,14,11,1,2,30,12,18,23,5,34
34792,20938,20958,1,1,21,17,2,2,53,19,34,36,6,53
34793,20938,20958,43,3,21,12,4,5,31,26,5,28,14,40
34794,20938,20958,22,7,21,6,9,6,29,28,1,21,21,27
34795,20938,20958,24,15,21,4,6,11,21,35,-14,14,28,18
34796,20938,20958,12,12,21,6,6,9,24,31,-7,18,24,24
34797,20938,20958,28,6,21,7,8,6,24,29,-5,22,20,29
34798,20938,20958,38,9,21,7,5,9,29,36,-7,19,23,26
34799,20938,20958,27,2,21,12,6,3,37,20,17,30,12,42
34800,20938,20958,10,11,21,7,4,10,37,37,0,18,24,25
34801,20938,20958,45,14,21,6,2,13,31,40,-9,14,28,20
34802,20938,20958,15,16,21,3,7,11,27,45,-18,13,29,16
34803,20938,20958,21,4,21,9,7,5,30,24,6,25,17,34
34804,20938,20958,4,5,21,9,5,7,27,18,9,23,19,32
34805,20938,20958,9,13,21,6,4,11,26,28,-2,16,26,22
34806,20938,20958,56,8,21,7,5,9,28,34,-6,19,23,26
34807,20938,20958,49,10,21,6,8,7,21,25,-4,20,22,26
34808,21267,21273,28,5,16,7,6,3,27,19,8,20,12,27
34809,21267,21273,56,10,16,5,4,7,22,27,-5,14,18,19
34810,21267,21273,21,2,16,9,5,2,23,13,10,23,9,32
34811,21267,21273,4,7,16,7,3,6,29,28,1,17,15,24
34812,21267,21273,9,11,16,5,3,8,17,30,-13,13,19,18
34813,21267,21273,49,6,16,7,5,4,24,16,8,19,13,26
34814,21267,21273,27,8,16,7,2,7,25,23,2,16,16,23
34815,21267,21273,15,12,16,5,1,10,19,34,-15,11,21,16
34816,21267,21273,45,13,16,4,3,9,26,36,-10,11,21,15
34817,21267,21273,10,15,16,1,8,7,17,24,-7,10,22,11
34818,21267,21273,12,16,16,2,4,10,14,29,-15,8,24,10
34819,21267,21273,38,14,16,3,4,9,12,22,-10,10,22,13
34820,21267,21273,22,1,16,10,5,1,40,17,23,25,7,35
34821,21267,21273,43,4,16,9,3,4,31,20,11,21,11,30
34822,21267,21273,57,9,16,6,4,6,20,27,-7,16,16,22
34823,21267,21273,1,3,16,9,4,3,38,19,19,22,10,31
34824,21288,21294,1,2,19,10,5,4,42,21,21,25,13,35
34825,21288,21294,22,1,19,12,6,1,44,18,26,30,8,42
34826,21288,21294,43,4,19,9,4,6,33,24,9,22,16,31
34827,21288,21294,57,9,19,7,4,8,23,34,-11,18,20,25
34828,21288,21294,28,5,19,8,7,4,31,23,8,23,15,31
34829,21288,21294,38,15,19,3,5,11,12,24,-12,11,27,14
34830,21288,21294,12,16,19,3,5,11,18,32,-14,11,27,14
34831,21288,21294,27,6,19,9,3,7,31,25,6,21,17,30
34832,21288,21294,15,11,19,7,1,11,21,36,-15,15,23,22
34833,21288,21294,49,7,19,8,6,5,29,21,8,22,16,30
34834,21288,21294,21,3,19,10,5,4,27,18,9,25,13,35
34835,21288,21294,4,8,19,8,4,7,33,32,1,20,18,28
34836,21288,21294,9,12,19,6,4,9,19,33,-14,16,22,22
34837,21288,21294,56,10,19,6,6,7,24,28,-4,18,20,24
34838,21288,21294,45,13,19,4,5,10,28,41,-13,13,25,17
34839,21288,21294,10,14,19,3,8,8,21,26,-5,14,24,17
34840,21351,21357,56,9,26,9,7,10,34,37,-3,25,27,34
34841,21351,21357,27,8,26,11,5,10,38,36,2,27,25,38
34842,21351,21357,15,11,26,9,2,15,29,47,-18,20,32,29
34843,21351,21357,45,12,26,7,7,12,41,51,-10,21,31,28
34844,21351,21357,10,15,26,5,10,11,30,38,-8,20,32,25
34845,21351,21357,28,5,26,11,10,5,43,31,12,32,20,43
34846,20147,20153,22,6,14,6,2,6,17,18,-1,14,14,20
34847,20147,20153,24,11,14,4,3,7,21,25,-4,11,17,15
34848,20147,20153,4,1,14,8,6,0,26,12,14,22,6,30
34849,20147,20153,9,3,14,8,4,2,27,16,11,20,8,28
34850,20147,20153,28,7,14,6,2,6,16,18,-2,14,14,20
34851,20147,20153,38,14,14,3,5,6,20,23,-3,11,17,14
34852,20147,20153,49,13,14,4,2,8,17,29,-12,10,18,14
34853,20147,20153,16,15,14,3,3,8,14,23,-9,9,19,12
34854,20147,20153,45,5,14,7,3,4,27,22,5,17,11,24
34855,20147,20153,27,9,14,4,6,4,14,15,-1,14,14,18
34856,20147,20153,10,10,14,5,1,8,19,28,-9,11,17,16
34857,20168,20174,45,5,16,7,4,5,29,27,2,18,14,25
34858,20168,20174,27,6,16,6,6,4,18,16,2,18,14,24
34859,20168,20174,10,10,16,6,2,8,23,31,-8,14,18,20
34860,20168,20174,49,12,16,5,3,8,19,30,-11,13,19,18
34861,20168,20174,16,15,16,3,3,10,15,29,-14,9,23,12
34862,20168,20174,28,9,16,6,3,7,18,21,-3,15,17,21
34863,20168,20174,38,14,16,3,6,7,22,26,-4,12,20,15
34864,20168,20174,4,1,16,9,6,1,32,15,17,24,8,33
34865,20168,20174,9,3,16,9,4,3,31,18,13,22,10,31
34866,20168,20174,43,4,16,8,6,2,25,12,13,22,10,30
34867,20168,20174,22,7,16,7,2,7,20,20,0,16,16,23
34868,20168,20174,24,11,16,5,3,8,23,27,-4,13,19,18
34869,20168,20174,12,13,16,4,4,8,16,20,-4,12,20,16
34870,20168,20174,25,16,16,2,6,8,18,34,-16,10,22,12
34871,20168,20174,56,8,16,5,7,4,15,13,2,17,15,22
34872,20168,20174,1,2,16,10,1,5,31,16,15,21,11,31
34873,20196,20202,1,4,20,12,1,7,38,24,14,25,15,37
34874,20196,20202,56,9,20,6,7,7,20,23,-3,19,21,25
34875,20196,20202,12,12,20,6,6,8,23,24,-1,18,22,24
34876,20196,20202,25,16,20,3,7,10,21,41,-20,13,27,16
34877,20196,20202,43,3,20,10,8,2,33,16,17,28,12,38
34878,20196,20202,22,6,20,8,4,8,23,21,2,20,20,28
34879,20196,20202,24,13,20,6,4,10,29,37,-8,16,24,22
34880,20196,20202,4,1,20,12,7,1,40,17,23,31,9,43
34881,20196,20202,9,2,20,11,5,4,38,22,16,27,13,38
34882,20196,20202,28,10,20,7,3,10,20,28,-8,17,23,24
34883,20196,20202,38,14,20,5,6,9,28,31,-3,16,24,21
34884,20196,20202,45,5,20,8,6,6,36,34,2,22,18,30
34885,20196,20202,27,7,20,7,6,7,23,23,0,20,20,27
34886,20196,20202,10,11,20,7,3,10,26,36,-10,17,23,24
34887,20196,20202,49,8,20,7,4,9,25,36,-11,18,22,25
34888,20196,20202,16,15,20,5,3,12,26,36,-10,13,27,18
34889,20252,20258,49,8,26,10,4,12,33,43,-10,24,28,34
34890,20252,20258,16,15,26,6,7,13,36,47,-11,19,33,25
34891,20252,20258,4,2,26,16,7,3,49,21,28,39,13,55
34892,20252,20258,9,4,26,12,7,7,46,33,13,31,21,43
34893,20252,20258,43,3,26,14,9,3,44,23,21,37,15,51
34894,20252,20258,22,5,26,12,5,9,34,25,9,29,23,41
34895,20252,20258,24,9,26,8,6,12,41,46,-5,22,30,30
34896,20252,20258,27,6,26,10,8,8,32,30,2,28,24,38
34897,20252,20258,45,7,26,10,7,9,44,45,-1,27,25,37
34898,20252,20258,10,13,26,7,5,14,36,54,-18,19,33,26
34899,20252,20258,12,12,26,7,8,11,31,35,-4,22,30,29
34900,20252,20258,25,14,26,6,8,12,31,49,-18,20,32,26
34901,20252,20258,28,11,26,8,5,13,26,38,-12,21,31,29
34902,20252,20258,38,16,26,5,8,13,32,44,-12,18,34,23
34903,20252,20258,56,10,26,7,9,10,25,32,-7,23,29,30
34904,20252,20258,1,1,26,18,1,7,52,27,25,37,15,55
34905,20259,20265,1,1,27,19,1,7,58,27,31,39,15,58
34906,20259,20265,56,10,27,8,9,10,28,32,-4,25,29,33
34907,20259,20265,28,12,27,8,5,14,26,41,-15,21,33,29
34908,20259,20265,38,14,27,6,8,13,35,45,-10,20,34,26
34909,20259,20265,12,11,27,7,9,11,31,35,-4,23,31,30
34910,20259,20265,25,15,27,6,8,13,31,55,-24,20,34,26
34911,20259,20265,27,6,27,10,8,9,32,33,-1,28,26,38
34912,20259,20265,43,3,27,14,9,4,44,24,20,37,17,51
34913,20259,20265,22,5,27,12,6,9,34,25,9,30,24,42
34914,20259,20265,24,9,27,9,6,12,44,48,-4,24,30,33
34915,20259,20265,4,2,27,16,7,4,51,26,25,39,15,55
34916,20259,20265,49,7,27,11,4,12,36,43,-7,26,28,37
34917,20259,20265,16,16,27,6,7,14,37,50,-13,19,35,25
34918,20259,20265,45,8,27,10,7,10,46,48,-2,27,27,37
34919,20259,20265,10,13,27,8,5,14,37,54,-17,21,33,29
34920,20259,20265,9,4,27,13,7,7,51,35,16,33,21,46
34921,20112,20118,43,2,9,5,3,1,13,7,6,13,5,18
34922,20112,20118,22,7,9,4,2,3,11,8,3,10,8,14
34923,20112,20118,24,14,9,2,2,5,11,18,-7,6,12,8
34924,20476,20482,27,5,8,4,3,1,10,7,3,11,5,15
34925,20476,20482,15,13,8,2,1,5,10,18,-8,5,11,7
34926,20476,20482,10,15,8,1,3,4,8,14,-6,5,11,6
34927,20476,20482,56,6,8,4,2,2,15,12,3,10,6,14
34928,20903,20909,56,14,16,3,5,8,16,28,-12,11,21,14
34929,20903,20909,15,16,16,2,4,10,23,41,-18,8,24,10
34930,20903,20909,1,1,16,13,1,2,36,14,22,27,5,40
34931,20903,20909,49,6,16,6,5,5,17,18,-1,17,15,23
34932,20903,20909,12,13,16,4,5,7,17,24,-7,13,19,17
34933,20903,20909,28,4,16,7,4,5,21,23,-2,18,14,25
34934,20903,20909,38,11,16,5,4,7,23,29,-6,14,18,19
34935,20903,20909,21,5,16,6,6,4,22,20,2,18,14,24
34936,20903,20909,4,7,16,6,4,6,23,16,7,16,16,22
34937,20903,20909,9,12,16,5,3,8,21,22,-1,13,19,18
34938,20903,20909,43,3,16,9,4,3,26,17,9,22,10,31
34939,20903,20909,22,8,16,5,7,4,21,19,2,17,15,22
34940,20903,20909,24,15,16,2,6,8,17,26,-9,10,22,12
34941,20903,20909,27,2,16,10,4,2,28,16,12,24,8,34
34942,20903,20909,10,9,16,6,3,7,31,27,4,15,17,21
34943,20903,20909,45,10,16,6,1,9,28,30,-2,13,19,19
34944,20910,20916,43,3,17,10,4,3,28,18,10,24,10,34
34945,20910,20916,22,8,17,5,7,5,23,22,1,17,17,22
34946,20910,20916,24,15,17,3,6,8,20,28,-8,12,22,15
34947,20910,20916,4,5,17,7,4,6,24,16,8,18,16,25
34948,20910,20916,21,6,17,6,7,4,23,21,2,19,15,25
34949,20910,20916,9,12,17,5,4,8,22,23,-1,14,20,19
34950,20910,20916,28,4,17,7,5,5,22,24,-2,19,15,26
34951,20910,20916,38,10,17,5,5,7,24,30,-6,15,19,20
34952,20910,20916,12,13,17,4,5,8,18,26,-8,13,21,17
34953,20910,20916,49,7,17,6,6,5,18,19,-1,18,16,24
34954,20910,20916,1,1,17,13,2,2,38,16,22,28,6,41
34955,20910,20916,27,2,17,10,5,2,29,17,12,25,9,35
34956,20910,20916,10,9,17,6,3,8,32,31,1,15,19,21
34957,20910,20916,45,11,17,6,1,10,28,31,-3,13,21,19
34958,20910,20916,15,16,17,2,5,10,25,43,-18,9,25,11
34959,20910,20916,56,14,17,4,5,8,20,29,-9,13,21,17
34960,20966,20972,56,9,24,8,6,10,32,36,-4,22,26,30
34961,20966,20972,27,2,24,13,7,4,40,22,18,33,15,46
34962,20966,20972,10,8,24,8,6,10,44,42,2,22,26,30
34963,20966,20972,45,12,24,8,3,13,37,43,-6,19,29,27
34964,20966,20972,15,15,24,4,8,12,30,48,-18,16,32,20
34965,20966,20972,28,6,24,8,9,7,28,33,-5,25,23,33
34966,20966,20972,38,11,24,8,5,11,31,41,-10,21,27,29
34967,20966,20972,1,1,24,18,3,3,58,25,33,39,9,57
34968,20966,20972,49,10,24,7,9,8,28,32,-4,23,25,30
34969,20966,20972,12,13,24,7,6,11,28,38,-10,20,28,27
34970,20966,20972,4,4,24,11,6,7,33,19,14,28,20,39
34971,20966,20972,21,5,24,9,10,5,34,28,6,28,20,37
34972,20966,20972,9,14,24,7,4,13,32,35,-3,18,30,25
34973,20966,20972,43,3,24,13,6,5,37,31,6,32,16,45
34974,20966,20972,22,7,24,7,10,7,32,31,1,24,24,31
34975,20966,20972,24,16,24,4,6,14,21,41,-20,14,34,18
34976,20798,20804,22,8,3,1,1,1,9,8,1,3,3,4
34977,20798,20804,43,11,3,1,1,1,1,2,-1,3,3,4
34978,20798,20804,24,12,3,0,3,0,4,4,0,3,3,3
34979,20798,20804,27,2,3,3,0,0,8,2,6,6,0,9
34980,20798,20804,45,3,3,2,0,1,8,2,6,4,2,6
34981,20798,20804,10,7,3,1,2,0,8,5,3,4,2,5
34982,20798,20804,15,16,3,0,0,3,2,10,-8,0,6,0
34983,20798,20804,38,5,3,2,0,1,5,5,0,4,2,6
34984,20798,20804,28,6,3,2,0,1,4,4,0,4,2,6
34985,20798,20804,21,10,3,1,1,1,4,5,-1,3,3,4
34986,20798,20804,4,13,3,0,1,2,3,5,-2,1,5,1
34987,20798,20804,9,14,3,0,0,3,0,5,-5,0,6,0
34988,20798,20804,12,15,3,0,0,3,0,7,-7,0,6,0
34989,20798,20804,49,9,3,1,1,1,3,3,0,3,3,4
34990,20798,20804,1,1,3,3,0,0,9,2,7,6,0,9
34991,20798,20804,56,4,3,2,0,1,3,2,1,4,2,6
34992,21645,21651,56,13,18,4,4,10,24,31,-7,12,24,16
34993,21645,21651,27,5,18,9,6,3,26,16,10,24,12,33
34994,21645,21651,45,6,18,8,4,6,26,21,5,20,16,28
34995,21645,21651,15,12,18,5,4,9,15,29,-14,14,22,19
34996,21645,21651,10,15,18,2,5,11,14,37,-23,9,27,11
34997,21645,21651,1,1,18,13,4,1,38,7,31,30,6,43
34998,21645,21651,49,3,18,10,4,4,35,19,16,24,12,34
34999,21645,21651,21,4,18,10,4,4,37,24,13,24,12,34
35000,21645,21651,9,14,18,4,3,11,20,34,-14,11,25,15
35001,21645,21651,4,2,18,10,5,3,37,20,17,25,11,35
35002,21645,21651,38,9,18,5,8,5,25,24,1,18,18,23
35003,21645,21651,28,10,18,6,4,8,20,31,-11,16,20,22
35004,21351,21357,38,10,26,9,5,12,28,30,-2,23,29,32
35005,21351,21357,21,4,26,13,6,7,36,29,7,32,20,45
35006,21351,21357,4,7,26,11,5,10,44,42,2,27,25,38
35007,21351,21357,9,14,26,6,7,13,25,45,-20,19,33,25
35008,21351,21357,49,3,26,13,7,6,41,28,13,33,19,46
35009,21351,21357,12,16,26,4,5,17,24,48,-24,13,39,17
35010,21351,21357,22,1,26,17,6,3,58,27,31,40,12,57
35011,21351,21357,43,6,26,12,5,9,41,31,10,29,23,41
35012,21351,21357,57,13,26,7,6,13,30,50,-20,20,32,27
35013,21351,21357,1,2,26,14,7,5,56,28,28,35,17,49
35014,21162,21168,1,2,3,3,0,0,9,2,7,6,0,9
35015,21162,21168,12,13,3,0,1,2,3,8,-5,1,5,1
35016,21162,21168,27,9,3,1,0,2,5,4,1,2,4,3
35017,21162,21168,10,12,3,0,2,1,3,6,-3,2,4,2
35018,21162,21168,15,16,3,0,0,3,3,13,-10,0,6,0
35019,21162,21168,45,5,3,1,2,0,7,3,4,4,2,5
35020,21162,21168,21,4,3,2,1,0,2,0,2,5,1,7
35021,21162,21168,4,8,3,1,1,1,7,5,2,3,3,4
35022,21162,21168,9,10,3,1,0,2,4,8,-4,2,4,3
35023,21162,21168,43,1,3,3,0,0,11,4,7,6,0,9
35024,21162,21168,22,3,3,2,1,0,7,1,6,5,1,7
35025,21162,21168,57,6,3,1,2,0,3,2,1,4,2,5
35026,21162,21168,49,6,3,1,2,0,3,2,1,4,2,5
35027,21162,21168,56,14,3,0,1,2,1,7,-6,1,5,1
35028,21162,21168,28,11,3,0,3,0,2,2,0,3,3,3
35029,21162,21168,38,15,3,0,0,3,1,4,-3,0,6,0
35030,21568,21574,56,12,8,2,2,4,14,15,-1,6,10,8
35031,21568,21574,38,4,8,4,3,1,11,8,3,11,5,15
35032,21568,21574,28,10,8,3,2,3,8,11,-3,8,8,11
35033,21568,21574,27,8,8,3,3,2,11,10,1,9,7,12
35034,21568,21574,45,9,8,3,3,2,10,10,0,9,7,12
35035,21568,21574,10,15,8,0,3,5,5,19,-14,3,13,3
35036,21568,21574,15,16,8,0,3,5,4,19,-15,3,13,3
35037,21568,21574,24,6,8,4,2,2,14,11,3,10,6,14
35038,21568,21574,22,7,8,4,1,3,13,10,3,9,7,13
35039,21568,21574,43,13,8,1,2,5,6,11,-5,4,12,5
35040,21568,21574,57,14,8,1,0,7,7,19,-12,2,14,3
35041,21568,21574,21,2,8,6,0,2,19,10,9,12,4,18
35042,21568,21574,4,5,8,4,2,2,20,11,9,10,6,14
35043,21568,21574,9,11,8,3,1,4,11,16,-5,7,9,10
35044,21568,21574,49,1,8,6,0,2,20,6,14,12,4,18
35045,21568,21574,1,3,8,5,3,0,16,3,13,13,3,18
35046,21890,21896,22,2,1,1,0,0,2,1,1,2,0,3
35047,21890,21896,24,7,1,0,1,0,2,2,0,1,1,1
35048,21890,21896,43,7,1,0,1,0,2,2,0,1,1,1
35049,21890,21896,1,16,1,0,0,1,0,1,-1,0,2,0
35050,21890,21896,49,5,1,1,0,0,1,0,1,2,0,3
35051,21890,21896,21,9,1,0,1,0,1,1,0,1,1,1
35052,21890,21896,4,13,1,0,0,1,1,2,-1,0,2,0
35053,21890,21896,9,13,1,0,0,1,1,2,-1,0,2,0
35054,21890,21896,57,16,1,0,0,1,0,1,-1,0,2,0
35055,21890,21896,10,1,1,1,0,0,3,1,2,2,0,3
35056,21890,21896,27,5,1,1,0,0,1,0,1,2,0,3
35057,21890,21896,38,9,1,0,1,0,1,1,0,1,1,1
35058,21890,21896,28,2,1,1,0,0,2,1,1,2,0,3
35059,21890,21896,15,9,1,0,1,0,1,1,0,1,1,1
35060,21890,21896,45,13,1,0,0,1,1,2,-1,0,2,0
35061,21890,21896,56,18,1,0,0,1,1,3,-2,0,2,0
35062,21890,21896,16,9,1,0,1,0,1,1,0,1,1,1
35063,21890,21896,53,2,1,1,0,0,2,1,1,2,0,3
35064,22072,22075,53,6,24,11,3,10,45,46,-1,25,23,36
35065,22072,22075,27,4,24,11,5,8,37,29,8,27,21,38
35066,22072,22075,45,11,24,9,4,11,36,43,-7,22,26,31
35067,22072,22075,15,15,24,5,11,8,27,40,-13,21,27,26
35068,22072,22075,10,18,24,5,5,14,30,52,-22,15,33,20
35069,22072,22075,28,14,24,7,6,11,31,38,-7,20,28,27
35070,22072,22075,38,16,24,6,7,11,22,35,-13,19,29,25
35071,22072,22075,56,13,24,8,6,10,30,34,-4,22,26,30
35072,22072,22075,21,2,24,13,4,7,42,32,10,30,18,43
35073,22072,22075,9,7,24,10,6,8,35,30,5,26,22,36
35074,22072,22075,4,10,24,9,4,11,34,31,3,22,26,31
35075,22072,22075,49,9,24,8,9,7,30,29,1,25,23,33
35076,22072,22075,16,12,24,8,7,9,37,40,-3,23,25,31
35077,22072,22075,1,1,24,17,3,4,51,16,35,37,11,54
35078,22072,22075,22,3,24,12,6,6,48,32,16,30,18,42
35079,22072,22075,43,5,24,9,11,4,33,26,7,29,19,38
35080,22072,22075,24,8,24,9,6,9,36,38,-2,24,24,33
35081,22072,22075,57,17,24,7,1,16,29,42,-13,15,33,22
35082,22100,22106,22,3,29,14,7,8,55,39,16,35,23,49
35083,22100,22106,43,4,29,11,13,5,40,30,10,35,23,46
35084,22100,22106,24,11,29,10,8,11,40,47,-7,28,30,38
35085,20112,20118,9,1,9,6,2,1,19,10,9,14,4,20
35086,20112,20118,4,4,9,4,5,0,14,7,7,13,5,17
35087,20112,20118,28,6,9,4,2,3,12,7,5,10,8,14
35088,20112,20118,38,11,9,2,3,4,12,16,-4,7,11,9
35089,20112,20118,16,13,9,2,2,5,11,15,-4,6,12,8
35090,20112,20118,49,15,9,2,2,5,10,20,-10,6,12,8
35091,20112,20118,45,3,9,5,2,2,17,10,7,12,6,17
35092,20112,20118,27,9,9,2,5,2,7,9,-2,9,9,11
35093,20112,20118,10,10,9,3,1,5,14,23,-9,7,11,10
35094,20112,20118,12,12,9,2,2,5,8,11,-3,6,12,8
35095,20112,20118,25,16,9,1,3,5,10,19,-9,5,13,6
35096,20112,20118,56,8,9,3,3,3,6,6,0,9,9,12
35097,20112,20118,1,5,9,5,1,3,20,9,11,11,7,16
35098,20511,20517,1,5,13,7,2,4,19,10,9,16,10,23
35099,20511,20517,43,2,13,7,3,3,23,14,9,17,9,24
35100,20511,20517,22,7,13,6,2,5,17,18,-1,14,12,20
35101,20511,20517,24,10,13,5,3,5,17,15,2,13,13,18
35102,20511,20517,12,14,13,3,2,8,11,19,-8,8,18,11
35103,20511,20517,25,16,13,2,3,8,14,29,-15,7,19,9
35104,20511,20517,56,8,13,5,5,3,23,20,3,15,11,20
35105,20511,20517,45,1,13,8,3,2,22,10,12,19,7,27
35106,20511,20517,27,4,13,6,6,1,16,11,5,18,8,24
35107,20511,20517,10,11,13,3,4,6,14,23,-9,10,16,13
35108,20511,20517,15,12,13,3,3,7,19,31,-12,9,17,12
35109,20511,20517,9,3,13,7,3,3,22,17,5,17,9,24
35110,20511,20517,4,6,13,6,3,4,20,14,6,15,11,21
35111,20511,20517,49,9,13,5,4,4,21,13,8,14,12,19
35112,20511,20517,38,13,13,3,2,8,15,23,-8,8,18,11
35113,20511,20517,28,15,13,2,4,7,14,20,-6,8,18,10
35114,20546,20552,28,14,17,3,4,10,17,26,-9,10,24,13
35115,20546,20552,38,15,17,3,2,12,16,35,-19,8,26,11
35116,20546,20552,49,7,17,8,4,5,31,18,13,20,14,28
35117,20546,20552,45,1,17,10,4,3,29,18,11,24,10,34
35118,20546,20552,27,6,17,8,6,3,21,17,4,22,12,30
35119,20546,20552,15,12,17,4,4,9,26,39,-13,12,22,16
35120,20546,20552,10,13,17,3,6,8,16,28,-12,12,22,15
35121,20546,20552,56,10,17,6,6,5,27,28,-1,18,16,24
35122,20546,20552,9,4,17,9,4,4,34,20,14,22,12,31
35123,20546,20552,4,5,17,9,4,4,27,14,13,22,12,31
35124,20546,20552,12,11,17,5,3,9,15,22,-7,13,21,18
35125,20546,20552,25,16,17,2,5,10,18,39,-21,9,25,11
35126,20546,20552,43,3,17,9,4,4,36,19,17,22,12,31
35127,20546,20552,24,8,17,7,4,6,21,22,-1,18,16,25
35128,20546,20552,22,9,17,7,3,7,21,27,-6,17,17,24
35129,20546,20552,1,2,17,10,3,4,29,12,17,23,11,33
35130,20574,20594,1,1,21,13,4,4,40,15,25,30,12,43
35131,20574,20594,43,2,21,12,5,4,45,21,24,29,13,41
35132,20574,20594,24,5,21,10,5,6,28,23,5,25,17,35
35133,20574,20594,22,9,21,8,5,8,25,30,-5,21,21,29
35134,20574,20594,12,10,21,6,6,9,20,25,-5,18,24,24
35135,20574,20594,25,15,21,3,6,12,24,46,-22,12,30,15
35136,20574,20594,56,11,21,6,6,9,29,40,-11,18,24,24
35137,20574,20594,45,3,21,11,7,3,32,20,12,29,13,40
35138,20574,20594,27,7,21,9,7,5,25,22,3,25,17,34
35139,20574,20594,15,13,21,5,5,11,32,50,-18,15,27,20
35140,20574,20594,10,14,21,4,8,9,19,31,-12,16,26,20
35141,20574,20594,49,6,21,9,7,5,39,24,15,25,17,34
35142,20574,20594,28,12,21,5,5,11,24,32,-8,15,27,20
35143,20574,20594,38,16,21,3,3,15,18,43,-25,9,33,12
35144,20574,20594,9,4,21,10,6,5,39,25,14,26,16,36
35145,20574,20594,4,8,21,9,5,7,31,23,8,23,19,32
35146,20973,20979,4,4,25,11,7,7,34,20,14,29,21,40
35147,20973,20979,21,5,25,9,10,6,35,30,5,28,22,37
35148,20973,20979,9,14,25,7,5,13,33,36,-3,19,31,26
35149,20973,20979,27,2,25,13,8,4,43,25,18,34,16,47
35150,20973,20979,10,7,25,9,6,10,46,43,3,24,26,33
35151,20973,20979,45,12,25,8,4,13,38,44,-6,20,30,28
35152,20973,20979,15,15,25,4,9,12,31,49,-18,17,33,21
35153,20973,20979,49,9,25,8,9,8,31,32,-1,25,25,33
35154,20973,20979,43,3,25,13,7,5,39,33,6,33,17,46
35155,20973,20979,22,6,25,8,10,7,33,31,2,26,24,34
35156,20973,20979,24,16,25,4,7,14,23,43,-20,15,35,19
35157,20973,20979,56,8,25,9,6,10,34,36,-2,24,26,33
35158,20973,20979,28,10,25,8,9,8,28,35,-7,25,25,33
35159,20973,20979,38,11,25,8,5,12,31,42,-11,21,29,29
35160,20973,20979,12,13,25,7,6,12,28,41,-13,20,30,27
35161,20973,20979,1,1,25,18,4,3,61,28,33,40,10,58
35162,20812,20825,1,1,5,5,0,0,15,3,12,10,0,15
35163,20812,20825,12,9,5,2,0,3,6,9,-3,4,6,6
35164,21645,21651,24,7,18,8,4,6,28,27,1,20,16,28
35165,21645,21651,22,8,18,7,4,7,26,26,0,18,18,25
35166,21645,21651,43,11,18,5,7,6,21,21,0,17,19,22
35167,21645,21651,57,16,18,2,2,14,16,41,-25,6,30,8
35168,21547,21560,24,4,6,3,2,1,11,6,5,8,4,11
35169,21547,21560,22,7,6,3,1,2,9,7,2,7,5,10
35170,21547,21560,43,13,6,1,2,3,4,7,-3,4,8,5
35171,21547,21560,57,14,6,1,0,5,6,14,-8,2,10,3
35172,21547,21560,21,2,6,4,0,2,14,8,6,8,4,12
35173,21547,21560,4,6,6,3,1,2,15,9,6,7,5,10
35174,21547,21560,9,8,6,3,1,2,9,9,0,7,5,10
35175,21547,21560,38,5,6,3,2,1,8,7,1,8,4,11
35176,21547,21560,28,12,6,2,1,3,4,10,-6,5,7,7
35177,21547,21560,49,1,6,4,0,2,13,5,8,8,4,12
35178,21547,21560,1,3,6,3,3,0,12,2,10,9,3,12
35179,21547,21560,45,9,6,3,1,2,7,7,0,7,5,10
35180,21547,21560,27,10,6,2,3,1,9,6,3,7,5,9
35181,21547,21560,15,15,6,0,2,4,3,15,-12,2,10,2
35182,21547,21560,10,16,6,0,1,5,3,17,-14,1,11,1
35183,21547,21560,56,11,6,2,2,2,12,10,2,6,6,8
35184,21974,21980,56,11,11,4,3,4,13,14,-1,11,11,15
35185,21974,21980,53,2,11,7,0,4,28,25,3,14,8,21
35186,21974,21980,27,1,11,7,1,3,18,9,9,15,7,22
35187,21974,21980,15,13,11,2,6,3,11,17,-6,10,12,12
35188,21974,21980,10,14,11,3,1,7,17,26,-9,7,15,10
35189,21974,21980,45,18,11,2,2,7,12,25,-13,6,16,8
35190,21974,21980,28,16,11,2,3,6,13,22,-9,7,15,9
35191,21974,21980,38,17,11,2,3,6,8,17,-9,7,15,9
35192,21974,21980,1,4,11,6,2,3,25,10,15,14,8,20
35193,21974,21980,43,6,11,5,5,1,21,15,6,15,7,20
35194,21974,21980,22,7,11,5,4,2,20,15,5,14,8,19
35195,21974,21980,57,9,11,5,0,6,17,17,0,10,12,15
35196,21974,21980,24,15,11,2,3,6,13,19,-6,7,15,9
35197,21974,21980,49,3,11,6,3,2,14,9,5,15,7,21
35198,21974,21980,16,8,11,5,3,3,19,19,0,13,9,18
35199,21974,21980,21,5,11,6,2,3,21,15,6,14,8,20
35200,21974,21980,9,10,11,4,3,4,15,11,4,11,11,15
35201,21974,21980,4,12,11,4,0,7,19,19,0,8,14,12
35202,21904,21910,49,3,3,2,1,0,3,1,2,5,1,7
35203,21904,21910,21,8,3,1,1,1,3,3,0,3,3,4
35204,21904,21910,9,17,3,0,1,2,1,3,-2,1,5,1
35205,21904,21910,4,18,3,0,0,3,2,5,-3,0,6,0
35206,21904,21910,57,4,3,2,0,1,5,4,1,4,2,6
35207,21904,21910,43,5,3,1,2,0,6,4,2,4,2,5
35208,21904,21910,22,6,3,1,2,0,3,2,1,4,2,5
35209,21904,21910,24,7,3,1,1,1,5,5,0,3,3,4
35210,21904,21910,1,11,3,1,0,2,4,2,2,2,4,3
35211,21904,21910,28,9,3,1,1,1,3,4,-1,3,3,4
35212,21904,21910,38,14,3,0,2,1,2,3,-1,2,4,2
35213,21904,21910,27,2,3,3,0,0,5,1,4,6,0,9
35214,21904,21910,45,12,3,1,0,2,6,6,0,2,4,3
35215,21904,21910,10,13,3,1,0,2,5,7,-2,2,4,3
35216,21904,21910,15,16,3,0,2,1,1,5,-4,2,4,2
35217,21904,21910,53,1,3,3,0,0,6,2,4,6,0,9
35218,21904,21910,56,9,3,1,1,1,3,4,-1,3,3,4
35219,21904,21910,16,15,3,0,2,1,3,5,-2,2,4,2
35220,22324,22330,49,13,11,4,2,5,12,19,-7,10,12,14
35221,22324,22330,21,4,11,6,2,3,21,15,6,14,8,20
35222,22324,22330,9,7,11,5,2,4,16,19,-3,12,10,17
35223,22324,22330,4,12,11,4,2,5,18,13,5,10,12,14
35224,22324,22330,39,1,11,7,1,3,24,11,13,15,7,22
35225,22324,22330,15,3,11,6,2,3,21,14,7,14,8,20
35226,22324,22330,27,9,11,4,5,2,19,13,6,13,9,17
35227,22324,22330,45,15,11,3,3,5,17,24,-7,9,13,12
35228,22324,22330,28,11,11,4,3,4,12,14,-2,11,11,15
35229,22324,22330,56,10,11,4,3,4,14,14,0,11,11,15
35230,22324,22330,13,14,11,4,0,7,15,21,-6,8,14,12
35231,22324,22330,24,5,11,6,1,4,19,19,0,13,9,19
35232,22324,22330,22,6,11,5,2,4,21,17,4,12,10,17
35233,22324,22330,43,8,11,4,5,2,21,14,7,13,9,17
35234,22324,22330,57,17,11,2,2,7,12,18,-6,6,16,8
35235,22324,22330,1,2,11,6,4,1,20,13,7,16,6,22
35236,22324,22330,16,16,11,1,7,3,11,19,-8,9,13,10
35237,22324,22330,53,18,11,0,2,9,7,23,-16,2,20,2
35238,22373,22379,53,18,17,2,3,12,15,31,-16,7,27,9
35239,22373,22379,9,12,17,6,2,9,21,36,-15,14,20,20
35240,22373,22379,43,5,17,7,7,3,34,24,10,21,13,28
35241,22373,22379,24,7,17,8,3,6,29,29,0,19,15,27
35242,22373,22379,22,8,17,6,4,7,31,29,2,16,18,22
35243,22373,22379,57,17,17,4,4,9,20,24,-4,12,22,16
35244,22373,22379,1,3,17,9,6,2,32,23,9,24,10,33
35245,22100,22106,57,17,29,9,2,18,33,46,-13,20,38,29
35246,22100,22106,1,1,29,21,4,4,64,18,46,46,12,67
35247,22100,22106,16,8,29,11,8,10,48,49,-1,30,28,41
35248,22100,22106,49,12,29,9,10,10,38,37,1,28,30,37
35249,22100,22106,21,2,29,15,6,8,48,37,11,36,22,51
35250,22100,22106,9,6,29,12,7,10,42,35,7,31,27,43
35251,22100,22106,4,10,29,11,6,12,41,37,4,28,30,39
35252,22100,22106,56,14,29,9,6,14,36,45,-9,24,34,33
35253,22100,22106,28,15,29,8,8,13,34,42,-8,24,34,32
35254,22100,22106,38,16,29,7,9,13,27,44,-17,23,35,30
35255,22100,22106,27,7,29,11,8,10,40,36,4,30,28,41
35256,22100,22106,45,9,29,12,4,13,45,53,-8,28,30,40
35257,22100,22106,15,13,29,7,13,9,36,46,-10,27,31,34
35258,22100,22106,10,18,29,6,7,16,34,58,-24,19,39,25
35259,22100,22106,53,5,29,13,4,12,53,55,-2,30,28,43
35260,22128,22134,53,6,32,14,5,13,57,59,-2,33,31,47
35261,22128,22134,45,7,32,14,4,14,49,58,-9,32,32,46
35262,22128,22134,27,11,32,11,9,12,44,42,2,31,33,42
35263,22128,22134,15,13,32,9,13,10,41,49,-8,31,33,40
35264,22128,22134,10,18,32,7,7,18,39,65,-26,21,43,28
35265,22128,22134,28,14,32,10,8,14,41,47,-6,28,36,38
35266,22128,22134,38,17,32,7,10,15,28,47,-19,24,40,31
35267,22128,22134,56,15,32,10,6,16,39,50,-11,26,38,36
35268,22128,22134,21,2,32,16,6,10,51,44,7,38,26,54
35269,22128,22134,16,8,32,12,9,11,53,54,-1,33,31,45
35270,22128,22134,49,9,32,11,11,10,45,41,4,33,31,44
35271,22128,22134,9,5,32,14,7,11,46,39,7,35,29,49
35272,22128,22134,4,10,32,12,7,13,44,40,4,31,33,43
35273,22128,22134,1,1,32,23,4,5,68,22,46,50,14,73
35274,22128,22134,22,3,32,15,8,9,61,45,16,38,26,53
35275,22128,22134,43,4,32,13,13,6,48,33,15,39,25,52
35276,22128,22134,24,12,32,11,9,12,46,51,-5,31,33,42
35277,22128,22134,57,16,32,10,2,20,36,50,-14,22,42,32
35278,21939,21945,1,2,7,5,0,2,18,5,13,10,4,15
35279,21939,21945,21,6,7,3,2,2,11,10,1,8,6,11
35280,21939,21945,9,10,7,2,3,2,9,8,1,7,7,9
35281,21939,21945,4,15,7,2,0,5,7,10,-3,4,10,6
35282,21939,21945,43,5,7,3,4,0,15,9,6,10,4,13
35283,21939,21945,57,9,7,3,0,4,9,9,0,6,8,9
35284,21939,21945,22,11,7,2,3,2,11,12,-1,7,7,9
35285,21939,21945,24,13,7,2,1,4,8,10,-2,5,9,7
35286,21939,21945,28,16,7,1,2,4,6,13,-7,4,10,5
35287,21939,21945,38,18,7,0,3,4,3,9,-6,3,11,3
35288,21939,21945,49,4,7,4,2,1,10,5,5,10,4,14
35289,21939,21945,16,7,7,3,2,2,11,11,0,8,6,11
35290,21939,21945,56,8,7,3,1,3,9,9,0,7,7,10
35291,21939,21945,53,3,7,5,0,2,15,12,3,10,4,15
35292,21939,21945,27,1,7,6,1,0,13,3,10,13,1,19
35293,21939,21945,15,12,7,1,5,1,7,10,-3,7,7,8
35294,21939,21945,45,14,7,2,1,4,9,16,-7,5,9,7
35295,21939,21945,10,17,7,1,0,6,11,21,-10,2,12,3
35296,22338,22344,53,18,13,1,2,10,12,27,-15,4,22,5
35297,22338,22344,56,9,13,5,4,4,16,15,1,14,12,19
35298,22338,22344,13,16,13,4,0,9,16,27,-11,8,18,12
35299,22338,22344,49,12,13,4,4,5,14,21,-7,12,14,16
35300,22338,22344,16,14,13,2,8,3,17,22,-5,12,14,14
35301,22338,22344,39,1,13,9,1,3,29,13,16,19,7,28
35302,22338,22344,27,5,13,6,5,2,25,14,11,17,9,23
35303,22338,22344,15,8,13,6,2,5,23,20,3,14,12,20
35304,22338,22344,45,15,13,3,4,6,21,32,-11,10,16,13
35305,22338,22344,28,13,13,4,3,6,14,20,-6,11,15,15
35306,22338,22344,21,3,13,7,3,3,23,16,7,17,9,24
35307,22338,22344,4,10,13,5,2,6,21,15,6,12,14,17
35308,22338,22344,9,11,13,5,2,6,18,24,-6,12,14,17
35309,22338,22344,1,2,13,7,5,1,23,15,8,19,7,26
35310,22338,22344,24,4,13,7,2,4,25,23,2,16,10,23
35311,22338,22344,43,6,13,5,6,2,27,18,9,16,10,21
35312,22338,22344,22,7,13,6,2,5,27,22,5,14,12,20
35313,22338,22344,57,17,13,2,3,8,13,20,-7,7,19,9
35314,22982,22988,22,6,2,1,0,1,4,1,3,2,2,3
35315,22982,22988,57,7,2,1,0,1,2,1,1,2,2,3
35316,22982,22988,43,9,2,1,0,1,1,2,-1,2,2,3
35317,22982,22988,24,13,2,0,1,1,1,2,-1,1,3,1
35318,22982,22988,1,5,2,1,1,0,2,1,1,3,1,4
35319,22982,22988,4,2,2,2,0,0,4,2,2,4,0,6
35320,22982,22988,21,8,2,1,0,1,1,1,0,2,2,3
35321,22982,22988,16,11,2,0,1,1,2,3,-1,1,3,1
35322,22982,22988,49,16,2,0,0,2,0,2,-2,0,4,0
35323,22982,22988,28,3,2,2,0,0,2,0,2,4,0,6
35324,22982,22988,39,1,2,2,0,0,3,0,3,4,0,6
35325,20812,20825,56,8,5,2,1,2,5,5,0,5,5,7
35326,20812,20825,22,7,5,2,1,2,10,9,1,5,5,7
35327,20812,20825,43,11,5,1,2,2,3,5,-2,4,6,5
35328,20812,20825,24,14,5,0,3,2,5,7,-2,3,7,3
35329,20812,20825,27,2,5,5,0,0,12,4,8,10,0,15
35330,20812,20825,45,6,5,3,0,2,14,5,9,6,4,9
35331,20812,20825,10,10,5,1,2,2,10,9,1,4,6,5
35332,20812,20825,15,13,5,1,0,4,4,14,-10,2,8,3
35333,20812,20825,49,12,5,1,1,3,3,11,-8,3,7,4
35334,20812,20825,28,3,5,4,0,1,8,6,2,8,2,12
35335,20812,20825,38,5,5,3,1,1,9,8,1,7,3,10
35336,20812,20825,21,4,5,3,1,1,10,9,1,7,3,10
35337,20812,20825,4,15,5,0,2,3,5,8,-3,2,8,2
35338,20812,20825,9,16,5,0,0,5,4,11,-7,0,10,0
35339,21148,21154,9,5,1,1,0,0,2,1,1,2,0,3
35340,21148,21154,21,6,1,1,0,0,1,0,1,2,0,3
35341,21148,21154,49,4,1,1,0,0,3,2,1,2,0,3
35342,21148,21154,10,7,1,0,1,0,2,2,0,1,1,1
35343,21148,21154,45,7,1,0,1,0,2,2,0,1,1,1
35344,21148,21154,27,13,1,0,0,1,0,1,-1,0,2,0
35345,21148,21154,15,14,1,0,0,1,2,5,-3,0,2,0
35346,21148,21154,22,1,1,1,0,0,4,0,4,2,0,3
35347,21148,21154,43,3,1,1,0,0,4,1,3,2,0,3
35348,21148,21154,57,9,1,0,1,0,0,0,0,1,1,1
35349,21148,21154,56,15,1,0,0,1,1,4,-3,0,2,0
35350,21148,21154,4,11,1,0,0,1,2,3,-1,0,2,0
35351,21148,21154,12,16,1,0,0,1,0,4,-4,0,2,0
35352,21148,21154,28,9,1,0,1,0,0,0,0,1,1,1
35353,21148,21154,38,12,1,0,0,1,1,2,-1,0,2,0
35354,21148,21154,1,2,1,1,0,0,5,2,3,2,0,3
35355,21253,21266,22,1,15,10,5,0,39,15,24,25,5,35
35356,21253,21266,43,4,15,9,3,3,29,16,13,21,9,30
35357,21253,21266,57,9,15,5,4,6,18,26,-8,14,16,19
35358,21253,21266,1,2,15,9,4,2,37,16,21,22,8,31
35359,21253,21266,56,12,15,4,4,7,20,26,-6,12,18,16
35360,21253,21266,28,5,15,6,6,3,23,17,6,18,12,24
35361,21253,21266,38,15,15,2,4,9,10,21,-11,8,22,10
35362,21253,21266,12,16,15,2,4,9,12,25,-13,8,22,10
35363,21253,21266,21,3,15,9,4,2,23,13,10,22,8,31
35364,21253,21266,4,6,15,7,2,6,29,28,1,16,14,23
35365,21253,21266,9,10,15,5,3,7,16,28,-12,13,17,18
35366,21253,21266,49,7,15,6,5,4,21,16,5,17,13,23
35367,21253,21266,27,8,15,6,2,7,21,21,0,14,16,20
35368,21253,21266,15,11,15,5,1,9,19,31,-12,11,19,16
35369,21253,21266,45,13,15,3,3,9,23,35,-12,9,21,12
35370,21253,21266,10,14,15,1,8,6,16,22,-6,10,20,11
35371,21330,21336,28,7,23,9,9,5,36,28,8,27,19,36
35372,21330,21336,38,12,23,6,5,12,20,29,-9,17,29,23
35373,21330,21336,21,3,23,12,6,5,33,26,7,30,16,42
35374,21330,21336,4,6,23,11,4,8,41,37,4,26,20,37
35375,21330,21336,9,14,23,6,5,12,23,41,-18,17,29,23
35376,21330,21336,49,4,23,11,7,5,36,24,12,29,17,40
35377,21330,21336,27,8,23,10,4,9,35,31,4,24,22,34
35378,21330,21336,15,9,23,9,1,13,27,41,-14,19,27,28
35379,21330,21336,45,13,23,6,5,12,37,48,-11,17,29,23
35380,21330,21336,10,15,23,4,10,9,26,33,-7,18,28,22
35381,21330,21336,56,10,23,7,7,9,30,34,-4,21,25,28
35382,21330,21336,12,16,23,3,5,15,20,42,-22,11,35,14
35383,21330,21336,22,1,23,15,6,2,53,23,30,36,10,51
35384,21330,21336,43,5,23,11,4,8,39,29,10,26,20,37
35385,21330,21336,57,11,23,7,5,11,26,42,-16,19,27,26
35386,21330,21336,1,2,23,13,5,5,50,24,26,31,15,44
35387,21183,21196,1,1,6,5,1,0,17,6,11,11,1,16
35388,21183,21196,12,14,6,1,1,4,5,13,-8,3,9,4
35389,21183,21196,28,9,6,1,4,1,7,7,0,6,6,7
35390,21183,21196,38,16,6,0,0,6,2,10,-8,0,12,0
35391,21183,21196,56,13,6,1,2,3,7,12,-5,4,8,5
35392,21183,21196,4,4,6,4,1,1,15,8,7,9,3,13
35393,21183,21196,21,5,6,3,3,0,5,2,3,9,3,12
35394,21183,21196,9,7,6,3,0,3,9,11,-2,6,6,9
35395,21183,21196,49,6,6,3,2,1,10,6,4,8,4,11
35396,21183,21196,27,10,6,2,0,4,9,10,-1,4,8,6
35397,21183,21196,15,11,6,2,0,4,8,17,-9,4,8,6
35398,21183,21196,45,12,6,1,2,3,11,14,-3,4,8,5
35399,21183,21196,10,15,6,0,3,3,7,12,-5,3,9,3
35400,21183,21196,22,2,6,4,2,0,16,7,9,10,2,14
35401,21183,21196,43,3,6,4,1,1,15,7,8,9,3,13
35402,21183,21196,57,8,6,2,2,2,6,7,-1,6,6,8
35403,21211,21217,22,2,9,7,2,0,26,9,17,16,2,23
35404,21211,21217,43,3,9,5,2,2,17,9,8,12,6,17
35405,21211,21217,57,11,9,2,3,4,9,17,-8,7,11,9
35406,22982,22988,15,4,2,1,1,0,3,2,1,3,1,4
35407,22982,22988,27,14,2,0,1,1,1,3,-2,1,3,1
35408,22982,22988,56,15,2,0,0,2,2,4,-2,0,4,0
35409,22982,22988,55,10,2,1,0,1,2,5,-3,2,2,3
35410,22982,22988,25,11,2,0,1,1,2,3,-1,1,3,1
35411,23129,23149,25,11,20,5,6,9,30,35,-5,16,24,21
35412,23129,23149,55,13,20,5,6,9,22,40,-18,16,24,21
35413,23129,23149,56,16,20,2,4,14,12,44,-32,8,32,10
35414,23129,23149,28,8,20,6,9,5,23,29,-6,21,19,27
35415,23129,23149,39,1,20,15,3,2,44,20,24,33,7,48
35416,23129,23149,27,12,20,5,6,9,21,30,-9,16,24,21
35417,23129,23149,15,15,20,4,3,13,21,43,-22,11,29,15
35418,23129,23149,49,9,20,5,8,7,19,29,-10,18,22,23
35419,23129,23149,16,14,20,4,4,12,25,38,-13,12,28,16
35420,23129,23149,4,3,20,10,8,2,36,20,16,28,12,38
35421,23129,23149,21,6,20,8,8,4,37,20,17,24,16,32
35422,23129,23149,1,5,20,9,7,4,38,17,21,25,15,34
35423,23129,23149,43,2,20,12,6,2,39,21,18,30,10,42
35424,23129,23149,22,4,20,9,7,4,41,20,21,25,15,34
35425,23129,23149,57,7,20,10,1,9,25,22,3,21,19,31
35426,23129,23149,24,10,20,6,4,10,20,25,-5,16,24,22
35427,23003,23009,43,2,5,4,0,1,6,4,2,8,2,12
35428,23003,23009,57,6,5,3,0,2,5,2,3,6,4,9
35429,23003,23009,22,8,5,2,2,1,6,2,4,6,4,8
35430,23003,23009,24,9,5,2,1,2,8,5,3,5,5,7
35431,23003,23009,1,3,5,3,2,0,15,3,12,8,2,11
35432,23003,23009,4,4,5,3,2,0,9,5,4,8,2,11
35433,23003,23009,21,7,5,2,2,1,8,2,6,6,4,8
35434,23003,23009,49,13,5,0,2,3,2,5,-3,2,8,2
35435,23003,23009,16,14,5,0,2,3,5,12,-7,2,8,2
35436,23003,23009,39,1,5,4,0,1,11,7,4,8,2,12
35437,23003,23009,15,5,5,3,1,1,9,9,0,7,3,10
35438,23003,23009,27,12,5,0,3,2,3,6,-3,3,7,3
35439,23003,23009,28,10,5,2,1,2,4,5,-1,5,5,7
35440,23003,23009,56,16,5,0,1,4,4,14,-10,1,9,1
35441,23003,23009,55,11,5,2,0,3,6,15,-9,4,6,6
35442,23003,23009,25,15,5,0,1,4,6,11,-5,1,9,1
35443,22373,22379,28,11,17,6,3,8,18,25,-7,15,19,21
35444,22373,22379,39,1,17,12,1,4,43,18,25,25,9,37
35445,22373,22379,27,4,17,8,5,4,31,22,9,21,13,29
35446,22373,22379,15,9,17,6,4,7,27,26,1,16,18,22
35447,22373,22379,45,16,17,4,5,8,27,38,-11,13,21,17
35448,22373,22379,21,2,17,10,3,4,30,18,12,23,11,33
35449,22373,22379,4,6,17,8,3,6,27,17,10,19,15,27
35450,22373,22379,49,13,17,5,5,7,18,29,-11,15,19,20
35451,22373,22379,16,14,17,4,8,5,22,27,-5,16,18,20
35452,22373,22379,56,10,17,5,7,5,20,21,-1,17,17,22
35453,22373,22379,13,15,17,6,1,10,23,31,-8,13,21,19
35454,22394,22414,56,8,21,8,7,6,26,24,2,23,19,31
35455,22394,22414,13,17,21,6,1,14,23,42,-19,13,29,19
35456,22394,22414,49,10,21,7,5,9,23,34,-11,19,23,26
35457,22394,22414,16,11,21,6,8,7,29,34,-5,20,22,26
35458,22394,22414,39,1,21,15,2,4,50,20,30,32,10,47
35459,22394,22414,27,5,21,10,5,6,38,29,9,25,17,35
35460,22394,22414,15,13,21,7,4,10,30,36,-6,18,24,25
35461,22394,22414,45,16,21,6,5,10,31,45,-14,17,25,23
35462,22394,22414,28,14,21,7,3,11,22,31,-9,17,25,24
35463,22394,22414,1,3,21,11,7,3,41,28,13,29,13,40
35464,22394,22414,43,4,21,10,8,3,50,26,24,28,14,38
35465,22394,22414,24,7,21,10,3,8,37,37,0,23,19,33
35466,22394,22414,22,9,21,8,5,8,40,33,7,21,21,29
35467,22394,22414,57,12,21,7,4,10,28,28,0,18,24,25
35468,22394,22414,21,2,21,12,4,5,39,24,15,28,14,40
35469,22394,22414,4,6,21,10,4,7,33,22,11,24,18,34
35470,22394,22414,9,15,21,7,2,12,23,43,-20,16,26,23
35471,22394,22414,53,18,21,2,3,16,15,42,-27,7,35,9
35472,22436,22442,21,2,26,15,5,6,46,28,18,35,17,50
35473,22436,22442,4,6,26,11,7,8,38,27,11,29,23,40
35474,22436,22442,9,14,26,8,4,14,27,49,-22,20,32,28
35475,22436,22442,43,4,26,12,9,5,56,31,25,33,19,45
35476,22436,22442,24,7,26,12,3,11,43,50,-7,27,25,39
35477,22436,22442,22,8,26,11,5,10,52,39,13,27,25,38
35478,22436,22442,57,10,26,10,5,11,36,31,5,25,27,35
35479,22436,22442,1,3,26,13,9,4,47,32,15,35,17,48
35480,22436,22442,28,13,26,9,4,13,29,37,-8,22,30,31
35481,22436,22442,39,1,26,19,3,4,59,21,38,41,11,60
35482,22436,22442,27,5,26,12,7,7,42,33,9,31,21,43
35483,22436,22442,15,15,26,7,6,13,32,45,-13,20,32,27
35484,22436,22442,45,16,26,6,8,12,36,54,-18,20,32,26
35485,22436,22442,53,18,26,3,4,19,25,55,-30,10,42,13
35486,22436,22442,56,11,26,8,10,8,31,32,-1,26,26,34
35487,22436,22442,13,17,26,7,2,17,26,52,-26,16,36,23
35488,22436,22442,16,9,26,9,9,8,41,40,1,27,25,36
35489,22436,22442,49,12,26,8,8,10,30,40,-10,24,28,32
35490,22499,22603,56,13,34,9,10,15,43,48,-5,28,40,37
35491,22499,22603,13,17,34,8,4,22,30,68,-38,20,48,28
35492,22499,22603,53,18,34,4,4,26,33,76,-43,12,56,16
35493,22499,22603,28,9,34,15,6,13,42,40,2,36,32,51
35494,22499,22603,39,1,34,24,5,5,78,27,51,53,15,77
35495,22499,22603,27,6,34,15,9,10,55,46,9,39,29,54
35496,22499,22603,15,15,34,8,8,18,37,61,-24,24,44,32
35497,22499,22603,45,16,34,8,8,18,42,69,-27,24,44,32
35498,22499,22603,43,3,34,18,10,6,72,36,36,46,22,64
35499,22499,22603,24,7,34,15,7,12,57,61,-4,37,31,52
35500,22499,22603,22,8,34,15,6,13,66,47,19,36,32,51
35501,22499,22603,57,10,34,12,9,13,49,46,3,33,35,45
35502,22499,22603,1,2,34,21,9,4,72,37,35,51,17,72
35503,22499,22603,16,11,34,10,11,13,47,58,-11,31,37,41
35504,22499,22603,49,14,34,9,9,16,32,51,-19,27,41,36
35505,22499,22603,21,4,34,19,6,9,55,38,17,44,24,63
35506,22499,22603,4,5,34,18,8,8,56,30,26,44,24,62
35507,22499,22603,9,12,34,10,7,17,34,61,-27,27,41,37
35508,22268,22274,53,18,5,0,1,4,4,10,-6,1,9,1
35509,22268,22274,49,3,5,3,1,1,7,7,0,7,3,10
35510,22268,22274,16,17,5,0,3,2,4,11,-7,3,7,3
35511,22268,22274,28,16,5,1,1,3,4,8,-4,3,7,4
35512,22268,22274,9,6,5,3,0,2,8,9,-1,6,4,9
35513,22268,22274,21,8,5,2,1,2,12,9,3,5,5,7
35514,22268,22274,4,13,5,1,2,2,6,6,0,4,6,5
35515,22268,22274,1,2,5,3,2,0,11,5,6,8,2,11
35516,22268,22274,43,7,5,2,2,1,8,6,2,6,4,8
35517,22268,22274,22,9,5,2,1,2,12,10,2,5,5,7
35518,22268,22274,24,11,5,2,0,3,7,9,-2,4,6,6
35519,22268,22274,57,14,5,1,2,2,5,6,-1,4,6,5
35520,22268,22274,15,1,5,3,2,0,12,6,6,8,2,11
35521,22268,22274,39,4,5,3,0,2,9,5,4,6,4,9
35522,21211,21217,27,9,9,3,2,4,12,12,0,8,10,11
35523,21211,21217,15,10,9,3,1,5,12,20,-8,7,11,10
35524,21211,21217,10,13,9,1,5,3,11,13,-2,7,11,8
35525,21211,21217,45,15,9,1,2,6,12,25,-13,4,14,5
35526,21211,21217,49,5,9,4,3,2,14,9,5,11,7,15
35527,21211,21217,21,4,9,4,4,1,12,7,5,12,6,16
35528,21211,21217,4,6,9,4,2,3,18,16,2,10,8,14
35529,21211,21217,9,8,9,4,1,4,13,16,-3,9,9,13
35530,21211,21217,56,12,9,2,2,5,10,16,-6,6,12,8
35531,21211,21217,28,7,9,3,5,1,11,8,3,11,7,14
35532,21211,21217,38,16,9,1,1,7,3,13,-10,3,15,4
35533,21211,21217,12,14,9,1,2,6,7,17,-10,4,14,5
35534,21211,21217,1,1,9,8,1,0,27,7,20,17,1,25
35535,21512,21518,1,2,1,1,0,0,3,1,2,2,0,3
35536,21512,21518,24,3,1,1,0,0,2,0,2,2,0,3
35537,21512,21518,22,5,1,1,0,0,2,1,1,2,0,3
35538,21512,21518,43,10,1,0,0,1,1,2,-1,0,2,0
35539,21512,21518,57,14,1,0,0,1,0,2,-2,0,2,0
35540,21512,21518,56,10,1,0,0,1,1,2,-1,0,2,0
35541,21512,21518,49,3,1,1,0,0,2,0,2,2,0,3
35542,21512,21518,27,8,1,0,1,0,1,1,0,1,1,1
35543,21512,21518,10,13,1,0,0,1,1,3,-2,0,2,0
35544,21512,21518,45,14,1,0,0,1,0,2,-2,0,2,0
35545,21512,21518,15,16,1,0,0,1,1,4,-3,0,2,0
35546,21512,21518,38,7,1,1,0,0,1,0,1,2,0,3
35547,21512,21518,28,12,1,0,0,1,0,1,-1,0,2,0
35548,21512,21518,21,1,1,1,0,0,4,1,3,2,0,3
35549,21512,21518,9,5,1,1,0,0,2,1,1,2,0,3
35550,21512,21518,4,8,1,0,1,0,1,1,0,1,1,1
35551,21694,21700,4,2,23,13,6,4,47,25,22,32,14,45
35552,21694,21700,21,3,23,13,6,4,43,27,16,32,14,45
35553,21694,21700,9,15,23,5,3,15,23,44,-21,13,33,18
35554,21694,21700,49,5,23,12,5,6,42,26,16,29,17,41
35555,21694,21700,28,10,23,8,5,10,27,39,-12,21,25,29
35556,21694,21700,38,11,23,6,9,8,31,34,-3,21,25,27
35557,21694,21700,27,4,23,12,8,3,38,19,19,32,14,44
35558,21694,21700,45,8,23,9,4,10,32,33,-1,22,24,31
35559,21694,21700,15,13,23,6,5,12,19,35,-16,17,29,23
35560,21694,21700,10,14,23,5,5,13,19,43,-24,15,31,20
35561,21694,21700,56,12,23,6,5,12,30,38,-8,17,29,23
35562,21694,21700,22,6,23,10,4,9,36,34,2,24,22,34
35563,21694,21700,24,7,23,10,4,9,34,36,-2,24,22,34
35564,21694,21700,43,9,23,7,9,7,27,25,2,23,23,30
35565,21694,21700,57,16,23,3,2,18,20,49,-29,8,38,11
35566,21694,21700,1,1,23,16,6,1,50,11,39,38,8,54
35567,21708,21714,1,1,25,17,7,1,51,11,40,41,9,58
35568,21708,21714,56,12,25,8,5,12,35,40,-5,21,29,29
35569,21708,21714,28,10,25,9,5,11,32,42,-10,23,27,32
35570,21708,21714,38,11,25,7,9,9,34,36,-2,23,27,30
35571,21708,21714,27,3,25,13,8,4,42,20,22,34,16,47
35572,21708,21714,45,7,25,10,4,11,37,37,0,24,26,34
35573,21708,21714,15,13,25,7,5,13,22,40,-18,19,31,26
35574,21708,21714,10,15,25,5,5,15,20,50,-30,15,35,20
35575,21708,21714,49,5,25,12,6,7,43,29,14,30,20,42
35576,21708,21714,4,2,25,14,7,4,51,26,25,35,15,49
35577,21708,21714,21,4,25,13,7,5,44,29,15,33,17,46
35578,21708,21714,9,14,25,6,3,16,25,47,-22,15,35,21
35579,21708,21714,22,6,25,11,5,9,38,35,3,27,23,38
35580,21708,21714,24,8,25,10,4,11,36,42,-6,24,26,34
35581,21708,21714,43,9,25,8,10,7,29,26,3,26,24,34
35582,21708,21714,57,16,25,4,2,19,23,52,-29,10,40,14
35583,22016,22022,16,4,16,8,4,4,30,25,5,20,12,28
35584,22016,22022,49,8,16,6,7,3,20,16,4,19,13,25
35585,22016,22022,53,3,16,9,1,6,39,37,2,19,13,28
35586,22016,22022,27,5,16,8,3,5,24,17,7,19,13,27
35587,22016,22022,15,11,16,4,8,4,20,24,-4,16,16,20
35588,22016,22022,10,14,16,5,3,8,24,32,-8,13,19,18
35589,22016,22022,45,14,16,5,3,8,24,32,-8,13,19,18
35590,22016,22022,38,17,16,3,4,9,12,26,-14,10,22,13
35591,22016,22022,28,18,16,2,5,9,18,30,-12,9,23,11
35592,22016,22022,56,10,16,5,5,6,21,24,-3,15,17,20
35593,22016,22022,21,7,16,7,4,5,28,25,3,18,14,25
35594,22016,22022,9,9,16,6,4,6,21,19,2,16,16,22
35595,22016,22022,4,12,16,6,1,9,24,26,-2,13,19,19
35596,22016,22022,22,2,16,9,4,3,35,21,14,22,10,31
35597,22016,22022,43,6,16,6,8,2,26,20,6,20,12,26
35598,22016,22022,57,13,16,6,0,10,22,28,-6,12,20,18
35599,22016,22022,24,16,16,3,5,8,24,31,-7,11,21,14
35600,22016,22022,1,1,16,10,3,3,32,11,21,23,9,33
35601,22058,22061,22,2,21,11,5,5,44,28,16,27,15,38
35602,22268,22274,27,10,5,1,4,0,7,4,3,6,4,7
35603,22268,22274,45,15,5,1,2,2,7,10,-3,4,6,5
35604,22268,22274,56,5,5,3,0,2,6,4,2,6,4,9
35605,22268,22274,13,12,5,2,0,3,5,9,-4,4,6,6
35606,22296,22302,49,8,8,4,1,3,8,12,-4,9,7,13
35607,22296,22302,16,17,8,1,4,3,8,16,-8,6,10,7
35608,22296,22302,21,4,8,4,2,2,17,12,5,10,6,14
35609,22296,22302,9,10,8,4,0,4,11,15,-4,8,8,12
35610,22296,22302,4,14,8,2,2,4,14,11,3,6,10,8
35611,22296,22302,39,2,8,5,1,2,16,7,9,11,5,16
35612,22296,22302,15,5,8,4,2,2,15,10,5,10,6,14
35613,22296,22302,27,9,8,3,4,1,15,9,6,10,6,13
35614,22296,22302,45,16,8,2,2,4,12,16,-4,6,10,8
35615,22296,22302,53,18,8,0,1,7,7,19,-12,1,15,1
35616,22296,22302,56,7,8,4,1,3,10,8,2,9,7,13
35617,22296,22302,13,13,8,3,0,5,8,13,-5,6,10,9
35618,22296,22302,28,11,8,3,1,4,7,10,-3,7,9,10
35619,22296,22302,1,1,8,5,2,1,16,11,5,12,4,17
35620,22296,22302,43,3,8,4,2,2,16,9,7,10,6,14
35621,22296,22302,22,6,8,4,2,2,16,12,4,10,6,14
35622,22296,22302,24,12,8,3,1,4,13,18,-5,7,9,10
35623,22296,22302,57,15,8,2,2,4,10,11,-1,6,10,8
35624,22800,22806,1,4,24,11,8,5,42,29,13,30,18,41
35625,22800,22806,22,1,24,20,2,2,60,22,38,42,6,62
35626,22800,22806,57,9,24,9,7,8,33,33,0,25,23,34
35627,22800,22806,43,10,24,9,4,11,33,32,1,22,26,31
35628,22800,22806,24,12,24,8,5,11,37,42,-5,21,27,29
35629,22800,22806,39,2,24,17,4,3,50,24,26,38,10,55
35630,22800,22806,27,13,24,8,4,12,30,42,-12,20,28,28
35631,22800,22806,15,14,24,6,4,14,30,48,-18,16,32,22
35632,22800,22806,45,16,24,5,5,14,30,52,-22,15,33,20
35633,22800,22806,56,15,24,6,4,14,26,45,-19,16,32,22
35634,22800,22806,13,17,24,5,3,16,23,45,-22,13,35,18
35635,22800,22806,21,3,24,14,5,5,42,23,19,33,15,47
35636,22800,22806,4,5,24,11,5,8,41,27,14,27,21,38
35637,22800,22806,9,18,24,5,3,16,25,53,-28,13,35,18
35638,22800,22806,28,8,24,9,8,7,25,25,0,26,22,35
35639,22800,22806,49,6,24,11,5,8,38,30,8,27,21,38
35640,22800,22806,16,11,24,8,7,9,38,36,2,23,25,31
35641,22800,22806,25,7,24,10,5,9,45,40,5,25,23,35
35642,22639,22645,25,12,6,2,0,4,11,12,-1,4,8,6
35643,22639,22645,21,1,6,6,0,0,14,5,9,12,0,18
35644,22639,22645,16,4,6,4,0,2,11,9,2,8,4,12
35645,22639,22645,49,11,6,2,1,3,9,12,-3,5,7,7
35646,22639,22645,4,5,6,3,2,1,10,7,3,8,4,11
35647,22639,22645,9,13,6,2,0,4,7,10,-3,4,8,6
35648,22639,22645,39,6,6,3,1,2,8,10,-2,7,5,10
35649,22639,22645,28,9,6,2,3,1,6,6,0,7,5,9
35650,22639,22645,56,17,6,1,1,4,3,7,-4,3,9,4
35651,22639,22645,13,18,6,1,0,5,4,12,-8,2,10,3
35652,22639,22645,27,8,6,3,0,3,9,9,0,6,6,9
35653,22639,22645,15,14,6,2,0,4,7,12,-5,4,8,6
35654,22639,22645,45,15,6,1,2,3,6,10,-4,4,8,5
35655,22639,22645,22,2,6,5,0,1,19,8,11,10,2,15
35656,22639,22645,43,7,6,3,0,3,9,5,4,6,6,9
35657,22639,22645,24,10,6,2,1,3,10,11,-1,5,7,7
35658,22639,22645,57,16,6,1,2,3,3,7,-4,4,8,5
35659,22639,22645,1,3,6,4,1,1,13,7,6,9,3,13
35660,22646,22652,1,3,7,5,1,1,17,7,10,11,3,16
35661,22646,22652,22,2,7,5,1,1,19,8,11,11,3,16
35662,22646,22652,43,8,7,3,1,3,11,7,4,7,7,10
35663,22646,22652,24,11,7,2,1,4,12,14,-2,5,9,7
35664,22646,22652,57,18,7,1,2,4,3,11,-8,4,10,5
35665,22646,22652,39,5,7,4,1,2,11,11,0,9,5,13
35666,22646,22652,27,6,7,4,0,3,11,10,1,8,6,12
35667,22646,22652,15,15,7,2,0,5,7,13,-6,4,10,6
35668,22646,22652,45,17,7,1,2,4,7,13,-6,4,10,5
35669,22646,22652,56,12,7,2,1,4,4,7,-3,5,9,7
35670,22646,22652,13,16,7,2,0,5,7,14,-7,4,10,6
35671,22646,22652,28,10,7,2,4,1,6,6,0,8,6,10
35672,22646,22652,21,1,7,7,0,0,17,5,12,14,0,21
35673,22646,22652,4,7,7,3,2,2,11,9,2,8,6,11
35674,22646,22652,9,14,7,2,0,5,7,11,-4,4,10,6
35675,22646,22652,16,4,7,4,1,2,13,11,2,9,5,13
35676,22646,22652,49,9,7,3,1,3,10,12,-2,7,7,10
35677,22646,22652,25,13,7,2,0,5,11,15,-4,4,10,6
35678,23094,23100,4,3,15,7,7,1,24,16,8,21,9,28
35679,23094,23100,21,5,15,6,6,3,30,13,17,18,12,24
35680,23094,23100,56,16,15,2,3,10,10,32,-22,7,23,9
35681,23094,23100,49,8,15,5,5,5,16,21,-5,15,15,20
35682,23094,23100,16,14,15,3,3,9,20,30,-10,9,21,12
35683,22058,22061,43,5,21,8,9,4,30,24,6,25,17,33
35684,22058,22061,24,12,21,7,5,9,32,36,-4,19,23,26
35685,22058,22061,57,17,21,7,1,13,28,36,-8,15,27,22
35686,22058,22061,1,1,21,14,3,4,44,14,30,31,11,45
35687,22058,22061,21,3,21,10,4,7,35,29,6,24,18,34
35688,22058,22061,9,7,21,9,5,7,29,25,4,23,19,32
35689,22058,22061,4,10,21,9,1,11,31,28,3,19,23,28
35690,22058,22061,56,13,21,7,5,9,26,31,-5,19,23,26
35691,22058,22061,53,6,21,10,2,9,43,44,-1,22,20,32
35692,22058,22061,49,8,21,8,7,6,26,23,3,23,19,31
35693,22058,22061,16,9,21,8,5,8,35,37,-2,21,21,29
35694,22058,22061,27,4,21,10,3,8,32,26,6,23,19,33
35695,22058,22061,45,11,21,8,3,10,31,38,-7,19,23,27
35696,22058,22061,15,14,21,5,9,7,24,35,-11,19,23,24
35697,22058,22061,10,18,21,5,5,11,26,44,-18,15,27,20
35698,22058,22061,28,15,21,6,5,10,26,34,-8,17,25,23
35699,22058,22061,38,16,21,6,5,10,20,30,-10,17,25,23
35700,22079,22085,28,13,26,8,6,12,34,40,-6,22,30,30
35701,22079,22085,38,16,26,6,8,12,23,40,-17,20,32,26
35702,22079,22085,21,2,26,14,5,7,44,33,11,33,19,47
35703,22079,22085,9,5,26,11,6,9,39,33,6,28,24,39
35704,22079,22085,4,11,26,10,5,11,39,32,7,25,27,35
35705,22079,22085,27,6,26,11,6,9,38,33,5,28,24,39
35706,22079,22085,45,12,26,10,4,12,40,47,-7,24,28,34
35707,22079,22085,15,15,26,6,11,9,30,42,-12,23,29,29
35708,22079,22085,10,17,26,6,6,14,32,53,-21,18,34,24
35709,22079,22085,16,7,26,10,7,9,43,43,0,27,25,37
35710,22079,22085,49,8,26,9,10,7,35,30,5,28,24,37
35711,22079,22085,53,9,26,11,3,12,47,51,-4,25,27,36
35712,22079,22085,56,14,26,8,6,12,31,39,-8,22,30,30
35713,22079,22085,1,1,26,18,4,4,54,18,36,40,12,58
35714,22079,22085,22,3,26,12,7,7,50,36,14,31,21,43
35715,22079,22085,43,4,26,10,12,4,36,26,10,32,20,42
35716,22079,22085,24,10,26,10,6,10,38,43,-5,26,26,36
35717,22079,22085,57,18,26,7,2,17,29,43,-14,16,36,23
35718,22135,22141,22,3,33,16,8,9,65,45,20,40,26,56
35719,22135,22141,43,4,33,14,13,6,50,34,16,41,25,55
35720,22135,22141,24,10,33,12,9,12,50,53,-3,33,33,45
35721,22135,22141,57,16,33,11,2,20,39,50,-11,24,42,35
35722,22135,22141,1,1,33,23,4,6,69,24,45,50,16,73
35723,22135,22141,21,2,33,17,6,10,54,46,8,40,26,57
35724,22135,22141,9,5,33,15,7,11,48,40,8,37,29,52
35725,22135,22141,4,9,33,13,7,13,48,40,8,33,33,46
35726,22135,22141,53,6,33,14,5,14,58,61,-3,33,33,47
35727,22135,22141,56,14,33,11,6,16,43,53,-10,28,38,39
35728,22135,22141,49,7,33,12,11,10,49,41,8,35,31,47
35729,22135,22141,16,11,33,12,9,12,53,57,-4,33,33,45
35730,22135,22141,45,8,33,14,4,15,51,62,-11,32,34,46
35731,22135,22141,27,12,33,11,9,13,44,46,-2,31,35,42
35732,22135,22141,15,13,33,9,13,11,41,53,-12,31,35,40
35733,22135,22141,10,18,33,7,7,19,42,69,-27,21,45,28
35734,22135,22141,28,15,33,10,8,15,41,51,-10,28,38,38
35735,22135,22141,38,17,33,7,10,16,30,50,-20,24,42,31
35736,22142,22239,28,15,34,10,8,16,41,52,-11,28,40,38
35737,22142,22239,38,18,34,7,10,17,32,54,-22,24,44,31
35738,22142,22239,9,5,34,15,8,11,49,41,8,38,30,53
35739,22142,22239,4,7,34,14,7,13,55,42,13,35,33,49
35740,22142,22239,45,10,34,14,4,16,53,69,-16,32,36,46
35741,22142,22239,15,12,34,10,13,11,44,55,-11,33,35,43
35742,22142,22239,27,13,34,11,9,14,46,49,-3,31,37,42
35743,22142,22239,10,17,34,8,7,19,44,70,-26,23,45,31
35744,22142,22239,49,6,34,13,11,10,52,41,11,37,31,50
35745,22142,22239,53,9,34,14,5,15,58,64,-6,33,35,47
35746,22142,22239,21,2,34,18,6,10,57,48,9,42,26,60
35747,22142,22239,56,14,34,11,6,17,44,57,-13,28,40,39
35748,22142,22239,16,11,34,12,9,13,54,59,-5,33,35,45
35749,22142,22239,1,1,34,24,4,6,73,26,47,52,16,76
35750,22142,22239,43,3,34,15,13,6,51,34,17,43,25,58
35751,22142,22239,22,4,34,16,8,10,67,48,19,40,28,56
35752,22142,22239,24,8,34,13,9,12,54,54,0,35,33,48
35753,22142,22239,57,16,34,11,3,20,40,51,-11,25,43,36
35754,21960,21966,57,6,9,5,0,4,16,12,4,10,8,15
35755,21960,21966,43,9,9,3,5,1,17,14,3,11,7,14
35756,21960,21966,22,10,9,3,4,2,14,14,0,10,8,13
35757,21960,21966,24,14,9,2,1,6,10,16,-6,5,13,7
35758,21960,21966,1,1,9,6,1,2,22,6,16,13,5,19
35759,21960,21966,56,8,9,4,2,3,11,10,1,10,8,14
35760,21960,21966,21,5,9,5,2,2,18,12,6,12,6,17
35761,23094,23100,28,9,15,4,7,4,18,24,-6,15,15,19
35762,23094,23100,39,1,15,11,2,2,35,16,19,24,6,35
35763,23094,23100,27,12,15,4,4,7,17,25,-8,12,18,16
35764,23094,23100,15,13,15,4,2,9,18,32,-14,10,20,14
35765,23094,23100,55,11,15,4,5,6,18,27,-9,13,17,17
35766,23094,23100,25,15,15,2,5,8,20,29,-9,9,21,11
35767,23094,23100,43,2,15,9,4,2,29,16,13,22,8,31
35768,23094,23100,57,4,15,8,1,6,18,14,4,17,13,25
35769,23094,23100,22,6,15,6,6,3,28,15,13,18,12,24
35770,23094,23100,24,10,15,5,3,7,16,19,-3,13,17,18
35771,23094,23100,1,7,15,6,5,4,27,15,12,17,13,23
35772,23157,23160,1,3,22,11,7,4,45,18,27,29,15,40
35773,23157,23160,43,2,22,12,8,2,42,24,18,32,12,44
35774,23157,23160,22,5,22,9,9,4,43,22,21,27,17,36
35775,23157,23160,57,7,22,10,3,9,27,24,3,23,21,33
35776,23157,23160,24,8,22,8,4,10,25,27,-2,20,24,28
35777,23157,23160,25,11,22,5,7,10,32,40,-8,17,27,22
35778,23157,23160,55,14,22,5,6,11,23,44,-21,16,28,21
35779,23157,23160,39,1,22,16,4,2,48,23,25,36,8,52
35780,23157,23160,15,12,22,6,3,13,23,43,-20,15,29,21
35781,23157,23160,28,9,22,6,10,6,25,32,-7,22,22,28
35782,23157,23160,49,10,22,5,9,8,20,31,-11,19,25,24
35783,23157,23160,16,15,22,4,6,12,26,39,-13,14,30,18
35784,23157,23160,27,13,22,5,6,11,23,38,-15,16,28,21
35785,23157,23160,56,16,22,3,5,14,13,44,-31,11,33,14
35786,23157,23160,4,4,22,10,9,3,39,24,15,29,15,39
35787,23157,23160,21,6,22,9,8,5,41,22,19,26,18,35
35788,23192,23198,21,4,28,13,9,6,53,26,27,35,21,48
35789,23192,23198,4,7,28,11,10,7,47,37,10,32,24,43
35790,23192,23198,56,16,28,5,6,17,21,56,-35,16,40,21
35791,23192,23198,49,10,28,7,10,11,29,40,-11,24,32,31
35792,23192,23198,16,13,28,6,8,14,32,44,-12,20,36,26
35793,23192,23198,28,9,28,9,10,9,33,44,-11,28,28,37
35794,23192,23198,39,1,28,21,5,2,61,29,32,47,9,68
35795,23192,23198,27,12,28,7,7,14,26,43,-17,21,35,28
35796,23192,23198,15,15,28,6,3,19,23,54,-31,15,41,21
35797,23192,23198,25,11,28,7,8,13,40,50,-10,22,34,29
35798,23192,23198,55,14,28,5,8,15,31,60,-29,18,38,23
35799,23192,23198,43,2,28,17,9,2,55,29,26,43,13,60
35800,23192,23198,57,5,28,13,4,11,40,34,6,30,26,43
35801,23192,23198,22,6,28,11,10,7,49,30,19,32,24,43
35802,23192,23198,24,8,28,12,6,10,36,32,4,30,26,42
35803,23192,23198,1,3,28,13,9,6,58,26,32,35,21,48
35804,21960,21966,9,11,9,3,3,3,12,10,2,9,9,12
35805,21960,21966,4,13,9,3,0,6,14,16,-2,6,12,9
35806,21960,21966,53,3,9,6,0,3,22,20,2,12,6,18
35807,21960,21966,27,2,9,6,1,2,15,7,8,13,5,19
35808,21960,21966,15,12,9,2,5,2,10,12,-2,9,9,11
35809,21960,21966,10,15,9,2,1,6,14,22,-8,5,13,7
35810,21960,21966,45,16,9,2,1,6,11,21,-10,5,13,7
35811,21960,21966,28,17,9,1,3,5,9,19,-10,5,13,6
35812,21960,21966,38,18,9,0,3,6,3,14,-11,3,15,3
35813,21960,21966,49,4,9,5,3,1,13,7,6,13,5,18
35814,21960,21966,16,7,9,4,3,2,15,14,1,11,7,15
35815,22247,22253,27,2,2,1,1,0,3,0,3,3,1,4
35816,22247,22253,39,7,2,1,0,1,3,2,1,2,2,3
35817,22247,22253,15,11,2,0,2,0,3,3,0,2,2,2
35818,22247,22253,45,15,2,0,1,1,2,3,-1,1,3,1
35819,22247,22253,9,10,2,1,0,1,4,6,-2,2,2,3
35820,22247,22253,4,14,2,0,1,1,3,4,-1,1,3,1
35821,22247,22253,21,18,2,0,0,2,2,4,-2,0,4,0
35822,22247,22253,28,5,2,1,1,0,2,1,1,3,1,4
35823,22247,22253,53,15,2,0,1,1,2,3,-1,1,3,1
35824,22247,22253,49,3,2,1,1,0,3,2,1,3,1,4
35825,22247,22253,16,12,2,0,2,0,2,2,0,2,2,2
35826,22247,22253,56,1,2,2,0,0,3,0,3,4,0,6
35827,22247,22253,13,9,2,1,0,1,1,2,-1,2,2,3
35828,22247,22253,1,3,2,1,1,0,3,2,1,3,1,4
35829,22247,22253,57,5,2,1,1,0,2,1,1,3,1,4
35830,22247,22253,24,8,2,1,0,1,3,3,0,2,2,3
35831,22247,22253,22,13,2,0,1,1,4,5,-1,1,3,1
35832,22247,22253,43,17,2,0,1,1,2,4,-2,1,3,1
35833,22821,22827,22,1,27,21,3,3,65,25,40,45,9,66
35834,22821,22827,57,8,27,9,10,8,37,37,0,28,26,37
35835,22821,22827,43,9,27,10,6,11,40,37,3,26,28,36
35836,22821,22827,24,12,27,9,6,12,42,46,-4,24,30,33
35837,22821,22827,1,4,27,12,10,5,47,32,15,34,20,46
35838,22821,22827,49,7,27,12,6,9,44,36,8,30,24,42
35839,22821,22827,16,13,27,8,9,10,39,39,0,25,29,33
35840,22821,22827,9,17,27,5,5,17,26,57,-31,15,39,20
35841,22821,22827,25,6,27,12,6,9,53,45,8,30,24,42
35842,22821,22827,28,11,27,9,8,10,26,30,-4,26,28,35
35843,22821,22827,56,14,27,7,6,14,33,50,-17,20,34,27
35844,22821,22827,13,18,27,5,4,18,24,51,-27,14,40,19
35845,22821,22827,21,3,27,16,6,5,46,24,22,38,16,54
35846,22821,22827,4,5,27,12,6,9,46,32,14,30,24,42
35847,22821,22827,39,2,27,17,5,5,55,33,22,39,15,56
35848,22821,22827,27,10,27,10,5,12,34,42,-8,25,29,35
35849,22821,22827,15,15,27,7,5,15,34,53,-19,19,35,26
35850,22821,22827,45,16,27,5,8,14,35,57,-22,18,36,23
35851,23115,23121,28,8,18,5,8,5,21,28,-7,18,18,23
35852,23115,23121,39,1,18,14,2,2,41,18,23,30,6,44
35853,23115,23121,27,12,18,4,6,8,18,28,-10,14,22,18
35854,23115,23121,15,14,18,4,3,11,20,38,-18,11,25,15
35855,23115,23121,55,10,18,5,6,7,21,31,-10,16,20,21
35856,23115,23121,25,13,18,4,5,9,25,33,-8,13,23,17
35857,23115,23121,4,3,18,8,8,2,30,20,10,24,12,32
35858,23115,23121,21,4,18,8,7,3,35,15,20,23,13,31
35859,23115,23121,49,9,18,5,7,6,18,25,-7,17,19,22
35860,23115,23121,16,15,18,3,4,11,22,34,-12,10,26,13
35861,23115,23121,56,16,18,2,4,12,12,39,-27,8,28,10
35862,23115,23121,1,6,18,8,6,4,31,15,16,22,14,30
35863,23115,23121,43,2,18,10,6,2,35,20,15,26,10,36
35864,23115,23121,22,5,18,8,7,3,37,18,19,23,13,31
35865,23115,23121,57,7,18,9,1,8,22,20,2,19,17,28
35866,23115,23121,24,11,18,5,4,9,16,22,-6,14,22,19
35867,23164,23170,43,2,24,13,9,2,45,26,19,35,13,48
35868,23164,23170,57,6,24,11,3,10,33,29,4,25,23,36
35869,23164,23170,22,7,24,9,9,6,44,25,19,27,21,36
35870,23164,23170,24,8,24,9,5,10,28,29,-1,23,25,32
35871,23164,23170,1,3,24,11,8,5,49,23,26,30,18,41
35872,23164,23170,49,11,24,5,10,9,22,34,-12,20,28,25
35873,23164,23170,16,12,24,6,6,12,31,40,-9,18,30,24
35874,23164,23170,21,4,24,11,8,5,44,23,21,30,18,41
35875,23164,23170,4,5,24,10,9,5,40,29,11,29,19,39
35876,23164,23170,25,10,24,6,7,11,36,45,-9,19,29,25
35877,23164,23170,55,14,24,5,7,12,27,49,-22,17,31,22
35878,23164,23170,39,1,24,18,4,2,52,25,27,40,8,58
35879,23164,23170,27,13,24,6,6,12,24,39,-15,18,30,24
35880,23164,23170,15,15,24,6,3,15,23,45,-22,15,33,21
35881,23164,23170,56,16,24,4,6,14,17,47,-30,14,34,18
35882,23164,23170,28,9,24,7,10,7,30,37,-7,24,24,31
35883,23171,23177,28,8,25,8,10,7,31,37,-6,26,24,34
35884,23171,23177,56,16,25,4,6,15,17,48,-31,14,36,18
35885,23171,23177,39,1,25,18,5,2,54,27,27,41,9,59
35886,23171,23177,27,13,25,6,6,13,25,42,-17,18,32,24
35887,23171,23177,15,15,25,6,3,16,23,49,-26,15,35,21
35888,23171,23177,25,11,25,6,8,11,38,47,-9,20,30,26
35889,23171,23177,55,14,25,5,7,13,27,53,-26,17,33,22
35890,23171,23177,21,4,25,12,8,5,48,23,25,32,18,44
35891,23171,23177,4,6,25,10,9,6,41,31,10,29,21,39
35892,23171,23177,49,10,25,6,10,9,23,34,-11,22,28,28
35893,23171,23177,16,12,25,6,6,13,31,41,-10,18,32,24
35894,23171,23177,1,3,25,12,8,5,53,23,30,32,18,44
35895,23171,23177,43,2,25,14,9,2,48,27,21,37,13,51
35896,23171,23177,57,5,25,12,3,10,35,30,5,27,23,39
35897,23171,23177,22,7,25,9,10,6,45,26,19,28,22,37
35898,23171,23177,24,9,25,9,6,10,29,30,-1,24,26,33
